,suite_name,suite_id,exp_name,run,workload_info.name,workload.rep,allocation,composition,workload_mode,workload_profit,workload.mechanism_mix,workload.sub_mix,workload.pa_mix,budget.mode,budget.ModeConfig.Unlocking.slack,request_info.mechanism.name,allocation_status_all,profit_elephant_all,profit_hare_all,profit_mice_all,profit_elephant_accepted,profit_hare_accepted,profit_mice_accepted,profit_elephant_rejected,profit_hare_rejected,profit_mice_rejected,n_requests_elephant_all,n_requests_hare_all,n_requests_mice_all,n_requests_elephant_accepted,n_requests_hare_accepted,n_requests_mice_accepted,n_requests_elephant_rejected,n_requests_hare_rejected,n_requests_mice_rejected,workload_composition_mode
0,sp_workloads,1690805680,wl_big_mem,0,mixed:GM-LM-RR-LSVT-SGD-PATE-sub25100-defpa,0,ilp,block-composition-pa,poisson,ncd,mixed:GM-LM-RR-LSVT-SGD-PATE,sub25100,defpa,Unlocking,0.2,GaussianMechanism,"{'Optimal': 39, 'TimeLimit': 1}",3326864,216518,19768,1925376,143953,15546,1401488,72565,4222,1098,1121,1112,587,754,886,511,367,226,poisson-block-composition-pa
1,sp_workloads,1690805680,wl_big_mem,0,mixed:GM-LM-RR-LSVT-SGD-PATE-sub25100-defpa,0,ilp,block-composition-pa,poisson,ncd,mixed:GM-LM-RR-LSVT-SGD-PATE,sub25100,defpa,Unlocking,0.2,LaplaceMechanism,"{'Optimal': 39, 'TimeLimit': 1}",3160262,214484,19740,556951,68523,16132,2603311,145961,3608,1133,1141,1092,315,438,908,818,703,184,poisson-block-composition-pa
2,sp_workloads,1690805680,wl_big_mem,0,mixed:GM-LM-RR-LSVT-SGD-PATE-sub25100-defpa,0,ilp,block-composition-pa,poisson,ncd,mixed:GM-LM-RR-LSVT-SGD-PATE,sub25100,defpa,Unlocking,0.2,MLNoisySGDMechanism,"{'Optimal': 39, 'TimeLimit': 1}",3049683,202901,20644,477852,25395,6959,2571831,177506,13685,1124,1132,1148,163,156,433,961,976,715,poisson-block-composition-pa
3,sp_workloads,1690805680,wl_big_mem,0,mixed:GM-LM-RR-LSVT-SGD-PATE-sub25100-defpa,0,ilp,block-composition-pa,poisson,ncd,mixed:GM-LM-RR-LSVT-SGD-PATE,sub25100,defpa,Unlocking,0.2,MLPateGaussianMechanism,"{'Optimal': 39, 'TimeLimit': 1}",3104776,219595,19804,288872,27551,7627,2815904,192044,12177,1159,1162,1108,116,190,485,1043,972,623,poisson-block-composition-pa
4,sp_workloads,1690805680,wl_big_mem,0,mixed:GM-LM-RR-LSVT-SGD-PATE-sub25100-defpa,0,ilp,block-composition-pa,poisson,ncd,mixed:GM-LM-RR-LSVT-SGD-PATE,sub25100,defpa,Unlocking,0.2,RandResponseMechanism,"{'Optimal': 39, 'TimeLimit': 1}",3027994,204361,19932,33190,7133,4968,2994804,197228,14964,1129,1138,1140,19,43,312,1110,1095,828,poisson-block-composition-pa
5,sp_workloads,1690805680,wl_big_mem,0,mixed:GM-LM-RR-LSVT-SGD-PATE-sub25100-defpa,0,ilp,block-composition-pa,poisson,ncd,mixed:GM-LM-RR-LSVT-SGD-PATE,sub25100,defpa,Unlocking,0.2,SVTLaplaceMechanism,"{'Optimal': 39, 'TimeLimit': 1}",3254745,215442,20539,30233,6493,4446,3224512,208949,16093,1155,1111,1125,16,32,274,1139,1079,851,poisson-block-composition-pa
6,sp_workloads,1690805680,wl_big_mem,1,mixed:GM-LM-RR-LSVT-SGD-PATE-sub25100-defpa,0,ilp,block-composition-pa,poisson,ncd,mixed:GM-LM-RR-LSVT-SGD-PATE,sub25100,defpa,Unlocking,0.4,GaussianMechanism,"{'Optimal': 39, 'TimeLimit': 1}",3326864,216518,19768,1896856,161338,16517,1430008,55180,3251,1098,1121,1112,602,803,939,496,318,173,poisson-block-composition-pa
7,sp_workloads,1690805680,wl_big_mem,1,mixed:GM-LM-RR-LSVT-SGD-PATE-sub25100-defpa,0,ilp,block-composition-pa,poisson,ncd,mixed:GM-LM-RR-LSVT-SGD-PATE,sub25100,defpa,Unlocking,0.4,LaplaceMechanism,"{'Optimal': 39, 'TimeLimit': 1}",3160262,214484,19740,862107,80192,16759,2298155,134292,2981,1133,1141,1092,392,495,937,741,646,155,poisson-block-composition-pa
8,sp_workloads,1690805680,wl_big_mem,1,mixed:GM-LM-RR-LSVT-SGD-PATE-sub25100-defpa,0,ilp,block-composition-pa,poisson,ncd,mixed:GM-LM-RR-LSVT-SGD-PATE,sub25100,defpa,Unlocking,0.4,MLNoisySGDMechanism,"{'Optimal': 39, 'TimeLimit': 1}",3049683,202901,20644,459596,36915,7639,2590087,165986,13005,1124,1132,1148,170,197,473,954,935,675,poisson-block-composition-pa
9,sp_workloads,1690805680,wl_big_mem,1,mixed:GM-LM-RR-LSVT-SGD-PATE-sub25100-defpa,0,ilp,block-composition-pa,poisson,ncd,mixed:GM-LM-RR-LSVT-SGD-PATE,sub25100,defpa,Unlocking,0.4,MLPateGaussianMechanism,"{'Optimal': 39, 'TimeLimit': 1}",3104776,219595,19804,305403,33779,8094,2799373,185816,11710,1159,1162,1108,147,229,514,1012,933,594,poisson-block-composition-pa
10,sp_workloads,1690805680,wl_big_mem,1,mixed:GM-LM-RR-LSVT-SGD-PATE-sub25100-defpa,0,ilp,block-composition-pa,poisson,ncd,mixed:GM-LM-RR-LSVT-SGD-PATE,sub25100,defpa,Unlocking,0.4,RandResponseMechanism,"{'Optimal': 39, 'TimeLimit': 1}",3027994,204361,19932,64540,7447,5351,2963454,196914,14581,1129,1138,1140,22,39,329,1107,1099,811,poisson-block-composition-pa
11,sp_workloads,1690805680,wl_big_mem,1,mixed:GM-LM-RR-LSVT-SGD-PATE-sub25100-defpa,0,ilp,block-composition-pa,poisson,ncd,mixed:GM-LM-RR-LSVT-SGD-PATE,sub25100,defpa,Unlocking,0.4,SVTLaplaceMechanism,"{'Optimal': 39, 'TimeLimit': 1}",3254745,215442,20539,60076,4957,4343,3194669,210485,16196,1155,1111,1125,24,31,265,1131,1080,860,poisson-block-composition-pa
12,sp_workloads,1690805680,wl_big_mem,4,mixed:GM-LM-RR-LSVT-SGD-PATE-sub25100-defpa,0,ilp,block-composition-pa,poisson,equal-ncd,mixed:GM-LM-RR-LSVT-SGD-PATE,sub25100,defpa,Unlocking,0.2,GaussianMechanism,"{'Optimal': 39, 'TimeLimit': 1}",1098,1121,1112,511,1078,1112,587,43,0,1098,1121,1112,511,1078,1112,587,43,0,poisson-block-composition-pa
13,sp_workloads,1690805680,wl_big_mem,4,mixed:GM-LM-RR-LSVT-SGD-PATE-sub25100-defpa,0,ilp,block-composition-pa,poisson,equal-ncd,mixed:GM-LM-RR-LSVT-SGD-PATE,sub25100,defpa,Unlocking,0.2,LaplaceMechanism,"{'Optimal': 39, 'TimeLimit': 1}",1133,1141,1092,345,706,1092,788,435,0,1133,1141,1092,345,706,1092,788,435,0,poisson-block-composition-pa
14,sp_workloads,1690805680,wl_big_mem,4,mixed:GM-LM-RR-LSVT-SGD-PATE-sub25100-defpa,0,ilp,block-composition-pa,poisson,equal-ncd,mixed:GM-LM-RR-LSVT-SGD-PATE,sub25100,defpa,Unlocking,0.2,MLNoisySGDMechanism,"{'Optimal': 39, 'TimeLimit': 1}",1124,1132,1148,229,719,1148,895,413,0,1124,1132,1148,229,719,1148,895,413,0,poisson-block-composition-pa
15,sp_workloads,1690805680,wl_big_mem,4,mixed:GM-LM-RR-LSVT-SGD-PATE-sub25100-defpa,0,ilp,block-composition-pa,poisson,equal-ncd,mixed:GM-LM-RR-LSVT-SGD-PATE,sub25100,defpa,Unlocking,0.2,MLPateGaussianMechanism,"{'Optimal': 39, 'TimeLimit': 1}",1159,1162,1108,166,713,1108,993,449,0,1159,1162,1108,166,713,1108,993,449,0,poisson-block-composition-pa
16,sp_workloads,1690805680,wl_big_mem,4,mixed:GM-LM-RR-LSVT-SGD-PATE-sub25100-defpa,0,ilp,block-composition-pa,poisson,equal-ncd,mixed:GM-LM-RR-LSVT-SGD-PATE,sub25100,defpa,Unlocking,0.2,RandResponseMechanism,"{'Optimal': 39, 'TimeLimit': 1}",1129,1138,1140,13,185,1140,1116,953,0,1129,1138,1140,13,185,1140,1116,953,0,poisson-block-composition-pa
17,sp_workloads,1690805680,wl_big_mem,4,mixed:GM-LM-RR-LSVT-SGD-PATE-sub25100-defpa,0,ilp,block-composition-pa,poisson,equal-ncd,mixed:GM-LM-RR-LSVT-SGD-PATE,sub25100,defpa,Unlocking,0.2,SVTLaplaceMechanism,"{'Optimal': 39, 'TimeLimit': 1}",1155,1111,1125,22,170,1125,1133,941,0,1155,1111,1125,22,170,1125,1133,941,0,poisson-block-composition-pa
18,sp_workloads,1690805680,wl_big_mem,5,mixed:GM-LM-RR-LSVT-SGD-PATE-sub25100-defpa,0,ilp,block-composition-pa,poisson,equal-ncd,mixed:GM-LM-RR-LSVT-SGD-PATE,sub25100,defpa,Unlocking,0.4,GaussianMechanism,"{'Optimal': 39, 'TimeLimit': 1}",1098,1121,1112,490,1073,1112,608,48,0,1098,1121,1112,490,1073,1112,608,48,0,poisson-block-composition-pa
19,sp_workloads,1690805680,wl_big_mem,5,mixed:GM-LM-RR-LSVT-SGD-PATE-sub25100-defpa,0,ilp,block-composition-pa,poisson,equal-ncd,mixed:GM-LM-RR-LSVT-SGD-PATE,sub25100,defpa,Unlocking,0.4,LaplaceMechanism,"{'Optimal': 39, 'TimeLimit': 1}",1133,1141,1092,347,731,1092,786,410,0,1133,1141,1092,347,731,1092,786,410,0,poisson-block-composition-pa
20,sp_workloads,1690805680,wl_big_mem,5,mixed:GM-LM-RR-LSVT-SGD-PATE-sub25100-defpa,0,ilp,block-composition-pa,poisson,equal-ncd,mixed:GM-LM-RR-LSVT-SGD-PATE,sub25100,defpa,Unlocking,0.4,MLNoisySGDMechanism,"{'Optimal': 39, 'TimeLimit': 1}",1124,1132,1148,219,738,1148,905,394,0,1124,1132,1148,219,738,1148,905,394,0,poisson-block-composition-pa
21,sp_workloads,1690805680,wl_big_mem,5,mixed:GM-LM-RR-LSVT-SGD-PATE-sub25100-defpa,0,ilp,block-composition-pa,poisson,equal-ncd,mixed:GM-LM-RR-LSVT-SGD-PATE,sub25100,defpa,Unlocking,0.4,MLPateGaussianMechanism,"{'Optimal': 39, 'TimeLimit': 1}",1159,1162,1108,165,714,1108,994,448,0,1159,1162,1108,165,714,1108,994,448,0,poisson-block-composition-pa
22,sp_workloads,1690805680,wl_big_mem,5,mixed:GM-LM-RR-LSVT-SGD-PATE-sub25100-defpa,0,ilp,block-composition-pa,poisson,equal-ncd,mixed:GM-LM-RR-LSVT-SGD-PATE,sub25100,defpa,Unlocking,0.4,RandResponseMechanism,"{'Optimal': 39, 'TimeLimit': 1}",1129,1138,1140,14,176,1140,1115,962,0,1129,1138,1140,14,176,1140,1115,962,0,poisson-block-composition-pa
23,sp_workloads,1690805680,wl_big_mem,5,mixed:GM-LM-RR-LSVT-SGD-PATE-sub25100-defpa,0,ilp,block-composition-pa,poisson,equal-ncd,mixed:GM-LM-RR-LSVT-SGD-PATE,sub25100,defpa,Unlocking,0.4,SVTLaplaceMechanism,"{'Optimal': 39, 'TimeLimit': 1}",1155,1111,1125,23,176,1125,1132,935,0,1155,1111,1125,23,176,1125,1132,935,0,poisson-block-composition-pa
24,sp_workloads,1690805680,wl_big_mem,8,mixed:GM-LM-RR-LSVT-SGD-PATE-sub25100-defpa,1,ilp,block-composition-pa,poisson,ncd,mixed:GM-LM-RR-LSVT-SGD-PATE,sub25100,defpa,Unlocking,0.2,GaussianMechanism,{'Optimal': 40},3139319,215782,21216,1741176,152782,17664,1398143,63000,3552,1075,1140,1126,549,792,957,526,348,169,poisson-block-composition-pa
25,sp_workloads,1690805680,wl_big_mem,8,mixed:GM-LM-RR-LSVT-SGD-PATE-sub25100-defpa,1,ilp,block-composition-pa,poisson,ncd,mixed:GM-LM-RR-LSVT-SGD-PATE,sub25100,defpa,Unlocking,0.2,LaplaceMechanism,{'Optimal': 40},3080200,239601,21344,578603,83734,17504,2501597,155867,3840,1140,1163,1130,337,467,947,803,696,183,poisson-block-composition-pa
26,sp_workloads,1690805680,wl_big_mem,8,mixed:GM-LM-RR-LSVT-SGD-PATE-sub25100-defpa,1,ilp,block-composition-pa,poisson,ncd,mixed:GM-LM-RR-LSVT-SGD-PATE,sub25100,defpa,Unlocking,0.2,MLNoisySGDMechanism,{'Optimal': 40},3197047,217314,22128,532119,32976,8512,2664928,184338,13616,1145,1089,1161,196,186,494,949,903,667,poisson-block-composition-pa
27,sp_workloads,1690805680,wl_big_mem,8,mixed:GM-LM-RR-LSVT-SGD-PATE-sub25100-defpa,1,ilp,block-composition-pa,poisson,ncd,mixed:GM-LM-RR-LSVT-SGD-PATE,sub25100,defpa,Unlocking,0.2,MLPateGaussianMechanism,{'Optimal': 40},3203621,231498,21632,292060,41717,8816,2911561,189781,12816,1163,1144,1138,138,246,528,1025,898,610,poisson-block-composition-pa
28,sp_workloads,1690805680,wl_big_mem,8,mixed:GM-LM-RR-LSVT-SGD-PATE-sub25100-defpa,1,ilp,block-composition-pa,poisson,ncd,mixed:GM-LM-RR-LSVT-SGD-PATE,sub25100,defpa,Unlocking,0.2,RandResponseMechanism,{'Optimal': 40},3122577,243521,22560,44104,9057,6288,3078473,234464,16272,1093,1164,1181,25,44,357,1068,1120,824,poisson-block-composition-pa
29,sp_workloads,1690805680,wl_big_mem,8,mixed:GM-LM-RR-LSVT-SGD-PATE-sub25100-defpa,1,ilp,block-composition-pa,poisson,ncd,mixed:GM-LM-RR-LSVT-SGD-PATE,sub25100,defpa,Unlocking,0.2,SVTLaplaceMechanism,{'Optimal': 40},3189411,227364,20784,65179,6955,5456,3124232,220409,15328,1178,1127,1089,28,41,315,1150,1086,774,poisson-block-composition-pa
30,sp_workloads,1690805680,wl_big_mem,9,mixed:GM-LM-RR-LSVT-SGD-PATE-sub25100-defpa,1,ilp,block-composition-pa,poisson,ncd,mixed:GM-LM-RR-LSVT-SGD-PATE,sub25100,defpa,Unlocking,0.4,GaussianMechanism,"{'Optimal': 39, 'TimeLimit': 1}",3139319,215782,21216,1629326,158887,17296,1509993,56895,3920,1075,1140,1126,553,813,938,522,327,188,poisson-block-composition-pa
31,sp_workloads,1690805680,wl_big_mem,9,mixed:GM-LM-RR-LSVT-SGD-PATE-sub25100-defpa,1,ilp,block-composition-pa,poisson,ncd,mixed:GM-LM-RR-LSVT-SGD-PATE,sub25100,defpa,Unlocking,0.4,LaplaceMechanism,"{'Optimal': 39, 'TimeLimit': 1}",3080200,239601,21344,960341,99876,17920,2119859,139725,3424,1140,1163,1130,422,513,968,718,650,162,poisson-block-composition-pa
32,sp_workloads,1690805680,wl_big_mem,9,mixed:GM-LM-RR-LSVT-SGD-PATE-sub25100-defpa,1,ilp,block-composition-pa,poisson,ncd,mixed:GM-LM-RR-LSVT-SGD-PATE,sub25100,defpa,Unlocking,0.4,MLNoisySGDMechanism,"{'Optimal': 39, 'TimeLimit': 1}",3197047,217314,22128,456060,36111,9824,2740987,181203,12304,1145,1089,1161,179,211,567,966,878,594,poisson-block-composition-pa
33,sp_workloads,1690805680,wl_big_mem,9,mixed:GM-LM-RR-LSVT-SGD-PATE-sub25100-defpa,1,ilp,block-composition-pa,poisson,ncd,mixed:GM-LM-RR-LSVT-SGD-PATE,sub25100,defpa,Unlocking,0.4,MLPateGaussianMechanism,"{'Optimal': 39, 'TimeLimit': 1}",3203621,231498,21632,357388,45928,9264,2846233,185570,12368,1163,1144,1138,167,283,552,996,861,586,poisson-block-composition-pa
34,sp_workloads,1690805680,wl_big_mem,9,mixed:GM-LM-RR-LSVT-SGD-PATE-sub25100-defpa,1,ilp,block-composition-pa,poisson,ncd,mixed:GM-LM-RR-LSVT-SGD-PATE,sub25100,defpa,Unlocking,0.4,RandResponseMechanism,"{'Optimal': 39, 'TimeLimit': 1}",3122577,243521,22560,59603,12230,7296,3062974,231291,15264,1093,1164,1181,33,54,416,1060,1110,765,poisson-block-composition-pa
35,sp_workloads,1690805680,wl_big_mem,9,mixed:GM-LM-RR-LSVT-SGD-PATE-sub25100-defpa,1,ilp,block-composition-pa,poisson,ncd,mixed:GM-LM-RR-LSVT-SGD-PATE,sub25100,defpa,Unlocking,0.4,SVTLaplaceMechanism,"{'Optimal': 39, 'TimeLimit': 1}",3189411,227364,20784,48274,8517,6272,3141137,218847,14512,1178,1127,1089,27,45,360,1151,1082,729,poisson-block-composition-pa
36,sp_workloads,1690805680,wl_big_mem,12,mixed:GM-LM-RR-LSVT-SGD-PATE-sub25100-defpa,1,ilp,block-composition-pa,poisson,equal-ncd,mixed:GM-LM-RR-LSVT-SGD-PATE,sub25100,defpa,Unlocking,0.2,GaussianMechanism,"{'Optimal': 39, 'TimeLimit': 1}",1075,1140,1126,510,1109,1126,565,31,0,1075,1140,1126,510,1109,1126,565,31,0,poisson-block-composition-pa
37,sp_workloads,1690805680,wl_big_mem,12,mixed:GM-LM-RR-LSVT-SGD-PATE-sub25100-defpa,1,ilp,block-composition-pa,poisson,equal-ncd,mixed:GM-LM-RR-LSVT-SGD-PATE,sub25100,defpa,Unlocking,0.2,LaplaceMechanism,"{'Optimal': 39, 'TimeLimit': 1}",1140,1163,1130,367,693,1130,773,470,0,1140,1163,1130,367,693,1130,773,470,0,poisson-block-composition-pa
38,sp_workloads,1690805680,wl_big_mem,12,mixed:GM-LM-RR-LSVT-SGD-PATE-sub25100-defpa,1,ilp,block-composition-pa,poisson,equal-ncd,mixed:GM-LM-RR-LSVT-SGD-PATE,sub25100,defpa,Unlocking,0.2,MLNoisySGDMechanism,"{'Optimal': 39, 'TimeLimit': 1}",1145,1089,1161,215,703,1161,930,386,0,1145,1089,1161,215,703,1161,930,386,0,poisson-block-composition-pa
39,sp_workloads,1690805680,wl_big_mem,12,mixed:GM-LM-RR-LSVT-SGD-PATE-sub25100-defpa,1,ilp,block-composition-pa,poisson,equal-ncd,mixed:GM-LM-RR-LSVT-SGD-PATE,sub25100,defpa,Unlocking,0.2,MLPateGaussianMechanism,"{'Optimal': 39, 'TimeLimit': 1}",1163,1144,1138,157,706,1138,1006,438,0,1163,1144,1138,157,706,1138,1006,438,0,poisson-block-composition-pa
40,sp_workloads,1690805680,wl_big_mem,12,mixed:GM-LM-RR-LSVT-SGD-PATE-sub25100-defpa,1,ilp,block-composition-pa,poisson,equal-ncd,mixed:GM-LM-RR-LSVT-SGD-PATE,sub25100,defpa,Unlocking,0.2,RandResponseMechanism,"{'Optimal': 39, 'TimeLimit': 1}",1093,1164,1181,20,174,1180,1073,990,1,1093,1164,1181,20,174,1180,1073,990,1,poisson-block-composition-pa
41,sp_workloads,1690805680,wl_big_mem,12,mixed:GM-LM-RR-LSVT-SGD-PATE-sub25100-defpa,1,ilp,block-composition-pa,poisson,equal-ncd,mixed:GM-LM-RR-LSVT-SGD-PATE,sub25100,defpa,Unlocking,0.2,SVTLaplaceMechanism,"{'Optimal': 39, 'TimeLimit': 1}",1178,1127,1089,17,163,1089,1161,964,0,1178,1127,1089,17,163,1089,1161,964,0,poisson-block-composition-pa
42,sp_workloads,1690805680,wl_big_mem,13,mixed:GM-LM-RR-LSVT-SGD-PATE-sub25100-defpa,1,ilp,block-composition-pa,poisson,equal-ncd,mixed:GM-LM-RR-LSVT-SGD-PATE,sub25100,defpa,Unlocking,0.4,GaussianMechanism,"{'Optimal': 39, 'TimeLimit': 1}",1075,1140,1126,492,1096,1126,583,44,0,1075,1140,1126,492,1096,1126,583,44,0,poisson-block-composition-pa
43,sp_workloads,1690805680,wl_big_mem,13,mixed:GM-LM-RR-LSVT-SGD-PATE-sub25100-defpa,1,ilp,block-composition-pa,poisson,equal-ncd,mixed:GM-LM-RR-LSVT-SGD-PATE,sub25100,defpa,Unlocking,0.4,LaplaceMechanism,"{'Optimal': 39, 'TimeLimit': 1}",1140,1163,1130,381,746,1130,759,417,0,1140,1163,1130,381,746,1130,759,417,0,poisson-block-composition-pa
44,sp_workloads,1690805680,wl_big_mem,13,mixed:GM-LM-RR-LSVT-SGD-PATE-sub25100-defpa,1,ilp,block-composition-pa,poisson,equal-ncd,mixed:GM-LM-RR-LSVT-SGD-PATE,sub25100,defpa,Unlocking,0.4,MLNoisySGDMechanism,"{'Optimal': 39, 'TimeLimit': 1}",1145,1089,1161,208,698,1154,937,391,7,1145,1089,1161,208,698,1154,937,391,7,poisson-block-composition-pa
45,sp_workloads,1690805680,wl_big_mem,13,mixed:GM-LM-RR-LSVT-SGD-PATE-sub25100-defpa,1,ilp,block-composition-pa,poisson,equal-ncd,mixed:GM-LM-RR-LSVT-SGD-PATE,sub25100,defpa,Unlocking,0.4,MLPateGaussianMechanism,"{'Optimal': 39, 'TimeLimit': 1}",1163,1144,1138,153,687,1135,1010,457,3,1163,1144,1138,153,687,1135,1010,457,3,poisson-block-composition-pa
46,sp_workloads,1690805680,wl_big_mem,13,mixed:GM-LM-RR-LSVT-SGD-PATE-sub25100-defpa,1,ilp,block-composition-pa,poisson,equal-ncd,mixed:GM-LM-RR-LSVT-SGD-PATE,sub25100,defpa,Unlocking,0.4,RandResponseMechanism,"{'Optimal': 39, 'TimeLimit': 1}",1093,1164,1181,23,173,1177,1070,991,4,1093,1164,1181,23,173,1177,1070,991,4,poisson-block-composition-pa
47,sp_workloads,1690805680,wl_big_mem,13,mixed:GM-LM-RR-LSVT-SGD-PATE-sub25100-defpa,1,ilp,block-composition-pa,poisson,equal-ncd,mixed:GM-LM-RR-LSVT-SGD-PATE,sub25100,defpa,Unlocking,0.4,SVTLaplaceMechanism,"{'Optimal': 39, 'TimeLimit': 1}",1178,1127,1089,22,171,1089,1156,956,0,1178,1127,1089,22,171,1089,1156,956,0,poisson-block-composition-pa
48,sp_workloads,1690805680,wl_big_mem,16,mixed:GM-LM-RR-LSVT-SGD-PATE-sub25100-defpa,2,ilp,block-composition-pa,poisson,ncd,mixed:GM-LM-RR-LSVT-SGD-PATE,sub25100,defpa,Unlocking,0.2,GaussianMechanism,"{'Optimal': 39, 'TimeLimit': 1}",3297557,222693,20889,1981075,143765,16948,1316482,78928,3941,1107,1156,1159,600,768,956,507,388,203,poisson-block-composition-pa
49,sp_workloads,1690805680,wl_big_mem,16,mixed:GM-LM-RR-LSVT-SGD-PATE-sub25100-defpa,2,ilp,block-composition-pa,poisson,ncd,mixed:GM-LM-RR-LSVT-SGD-PATE,sub25100,defpa,Unlocking,0.2,LaplaceMechanism,"{'Optimal': 39, 'TimeLimit': 1}",2847135,226653,20024,574114,76985,16156,2273021,149668,3868,1061,1136,1112,292,428,916,769,708,196,poisson-block-composition-pa
50,sp_workloads,1690805680,wl_big_mem,16,mixed:GM-LM-RR-LSVT-SGD-PATE-sub25100-defpa,2,ilp,block-composition-pa,poisson,ncd,mixed:GM-LM-RR-LSVT-SGD-PATE,sub25100,defpa,Unlocking,0.2,MLNoisySGDMechanism,"{'Optimal': 39, 'TimeLimit': 1}",3065470,217531,20600,462162,28943,8609,2603308,188588,11991,1088,1113,1144,155,154,527,933,959,617,poisson-block-composition-pa
51,sp_workloads,1690805680,wl_big_mem,16,mixed:GM-LM-RR-LSVT-SGD-PATE-sub25100-defpa,2,ilp,block-composition-pa,poisson,ncd,mixed:GM-LM-RR-LSVT-SGD-PATE,sub25100,defpa,Unlocking,0.2,MLPateGaussianMechanism,"{'Optimal': 39, 'TimeLimit': 1}",3183074,228777,19443,290542,31850,8242,2892532,196927,11201,1123,1178,1085,111,233,526,1012,945,559,poisson-block-composition-pa
52,sp_workloads,1690805680,wl_big_mem,16,mixed:GM-LM-RR-LSVT-SGD-PATE-sub25100-defpa,2,ilp,block-composition-pa,poisson,ncd,mixed:GM-LM-RR-LSVT-SGD-PATE,sub25100,defpa,Unlocking,0.2,RandResponseMechanism,"{'Optimal': 39, 'TimeLimit': 1}",3253029,217115,19830,39196,5481,5152,3213833,211634,14678,1136,1135,1114,26,34,320,1110,1101,794,poisson-block-composition-pa
53,sp_workloads,1690805680,wl_big_mem,16,mixed:GM-LM-RR-LSVT-SGD-PATE-sub25100-defpa,2,ilp,block-composition-pa,poisson,ncd,mixed:GM-LM-RR-LSVT-SGD-PATE,sub25100,defpa,Unlocking,0.2,SVTLaplaceMechanism,"{'Optimal': 39, 'TimeLimit': 1}",3041723,217557,19755,24841,6599,4659,3016882,210958,15096,1106,1092,1109,15,35,285,1091,1057,824,poisson-block-composition-pa
54,sp_workloads,1690805680,wl_big_mem,17,mixed:GM-LM-RR-LSVT-SGD-PATE-sub25100-defpa,2,ilp,block-composition-pa,poisson,ncd,mixed:GM-LM-RR-LSVT-SGD-PATE,sub25100,defpa,Unlocking,0.4,GaussianMechanism,"{'Optimal': 39, 'TimeLimit': 1}",3297557,222693,20889,1971382,162869,17464,1326175,59824,3425,1107,1156,1159,621,836,984,486,320,175,poisson-block-composition-pa
55,sp_workloads,1690805680,wl_big_mem,17,mixed:GM-LM-RR-LSVT-SGD-PATE-sub25100-defpa,2,ilp,block-composition-pa,poisson,ncd,mixed:GM-LM-RR-LSVT-SGD-PATE,sub25100,defpa,Unlocking,0.4,LaplaceMechanism,"{'Optimal': 39, 'TimeLimit': 1}",2847135,226653,20024,820385,84570,17043,2026750,142083,2981,1061,1136,1112,363,484,957,698,652,155,poisson-block-composition-pa
56,sp_workloads,1690805680,wl_big_mem,17,mixed:GM-LM-RR-LSVT-SGD-PATE-sub25100-defpa,2,ilp,block-composition-pa,poisson,ncd,mixed:GM-LM-RR-LSVT-SGD-PATE,sub25100,defpa,Unlocking,0.4,MLNoisySGDMechanism,"{'Optimal': 39, 'TimeLimit': 1}",3065470,217531,20600,435081,35006,8741,2630389,182525,11859,1088,1113,1144,160,197,523,928,916,621,poisson-block-composition-pa
57,sp_workloads,1690805680,wl_big_mem,17,mixed:GM-LM-RR-LSVT-SGD-PATE-sub25100-defpa,2,ilp,block-composition-pa,poisson,ncd,mixed:GM-LM-RR-LSVT-SGD-PATE,sub25100,defpa,Unlocking,0.4,MLPateGaussianMechanism,"{'Optimal': 39, 'TimeLimit': 1}",3183074,228777,19443,313914,39362,8493,2869160,189415,10950,1123,1178,1085,137,265,531,986,913,554,poisson-block-composition-pa
58,sp_workloads,1690805680,wl_big_mem,17,mixed:GM-LM-RR-LSVT-SGD-PATE-sub25100-defpa,2,ilp,block-composition-pa,poisson,ncd,mixed:GM-LM-RR-LSVT-SGD-PATE,sub25100,defpa,Unlocking,0.4,RandResponseMechanism,"{'Optimal': 39, 'TimeLimit': 1}",3253029,217115,19830,86558,6637,5845,3166471,210478,13985,1136,1135,1114,37,45,363,1099,1090,751,poisson-block-composition-pa
59,sp_workloads,1690805680,wl_big_mem,17,mixed:GM-LM-RR-LSVT-SGD-PATE-sub25100-defpa,2,ilp,block-composition-pa,poisson,ncd,mixed:GM-LM-RR-LSVT-SGD-PATE,sub25100,defpa,Unlocking,0.4,SVTLaplaceMechanism,"{'Optimal': 39, 'TimeLimit': 1}",3041723,217557,19755,51138,6868,5581,2990585,210689,14174,1106,1092,1109,21,36,339,1085,1056,770,poisson-block-composition-pa
60,sp_workloads,1690805680,wl_big_mem,20,mixed:GM-LM-RR-LSVT-SGD-PATE-sub25100-defpa,2,ilp,block-composition-pa,poisson,equal-ncd,mixed:GM-LM-RR-LSVT-SGD-PATE,sub25100,defpa,Unlocking,0.2,GaussianMechanism,"{'Optimal': 39, 'TimeLimit': 1}",1107,1156,1159,541,1111,1159,566,45,0,1107,1156,1159,541,1111,1159,566,45,0,poisson-block-composition-pa
61,sp_workloads,1690805680,wl_big_mem,20,mixed:GM-LM-RR-LSVT-SGD-PATE-sub25100-defpa,2,ilp,block-composition-pa,poisson,equal-ncd,mixed:GM-LM-RR-LSVT-SGD-PATE,sub25100,defpa,Unlocking,0.2,LaplaceMechanism,"{'Optimal': 39, 'TimeLimit': 1}",1061,1136,1112,339,667,1112,722,469,0,1061,1136,1112,339,667,1112,722,469,0,poisson-block-composition-pa
62,sp_workloads,1690805680,wl_big_mem,20,mixed:GM-LM-RR-LSVT-SGD-PATE-sub25100-defpa,2,ilp,block-composition-pa,poisson,equal-ncd,mixed:GM-LM-RR-LSVT-SGD-PATE,sub25100,defpa,Unlocking,0.2,MLNoisySGDMechanism,"{'Optimal': 39, 'TimeLimit': 1}",1088,1113,1144,203,699,1144,885,414,0,1088,1113,1144,203,699,1144,885,414,0,poisson-block-composition-pa
63,sp_workloads,1690805680,wl_big_mem,20,mixed:GM-LM-RR-LSVT-SGD-PATE-sub25100-defpa,2,ilp,block-composition-pa,poisson,equal-ncd,mixed:GM-LM-RR-LSVT-SGD-PATE,sub25100,defpa,Unlocking,0.2,MLPateGaussianMechanism,"{'Optimal': 39, 'TimeLimit': 1}",1123,1178,1085,166,733,1085,957,445,0,1123,1178,1085,166,733,1085,957,445,0,poisson-block-composition-pa
64,sp_workloads,1690805680,wl_big_mem,20,mixed:GM-LM-RR-LSVT-SGD-PATE-sub25100-defpa,2,ilp,block-composition-pa,poisson,equal-ncd,mixed:GM-LM-RR-LSVT-SGD-PATE,sub25100,defpa,Unlocking,0.2,RandResponseMechanism,"{'Optimal': 39, 'TimeLimit': 1}",1136,1135,1114,15,170,1114,1121,965,0,1136,1135,1114,15,170,1114,1121,965,0,poisson-block-composition-pa
65,sp_workloads,1690805680,wl_big_mem,20,mixed:GM-LM-RR-LSVT-SGD-PATE-sub25100-defpa,2,ilp,block-composition-pa,poisson,equal-ncd,mixed:GM-LM-RR-LSVT-SGD-PATE,sub25100,defpa,Unlocking,0.2,SVTLaplaceMechanism,"{'Optimal': 39, 'TimeLimit': 1}",1106,1092,1109,14,151,1109,1092,941,0,1106,1092,1109,14,151,1109,1092,941,0,poisson-block-composition-pa
66,sp_workloads,1690805680,wl_big_mem,21,mixed:GM-LM-RR-LSVT-SGD-PATE-sub25100-defpa,2,ilp,block-composition-pa,poisson,equal-ncd,mixed:GM-LM-RR-LSVT-SGD-PATE,sub25100,defpa,Unlocking,0.4,GaussianMechanism,"{'Optimal': 39, 'TimeLimit': 1}",1107,1156,1159,533,1109,1159,574,47,0,1107,1156,1159,533,1109,1159,574,47,0,poisson-block-composition-pa
67,sp_workloads,1690805680,wl_big_mem,21,mixed:GM-LM-RR-LSVT-SGD-PATE-sub25100-defpa,2,ilp,block-composition-pa,poisson,equal-ncd,mixed:GM-LM-RR-LSVT-SGD-PATE,sub25100,defpa,Unlocking,0.4,LaplaceMechanism,"{'Optimal': 39, 'TimeLimit': 1}",1061,1136,1112,314,702,1112,747,434,0,1061,1136,1112,314,702,1112,747,434,0,poisson-block-composition-pa
68,sp_workloads,1690805680,wl_big_mem,21,mixed:GM-LM-RR-LSVT-SGD-PATE-sub25100-defpa,2,ilp,block-composition-pa,poisson,equal-ncd,mixed:GM-LM-RR-LSVT-SGD-PATE,sub25100,defpa,Unlocking,0.4,MLNoisySGDMechanism,"{'Optimal': 39, 'TimeLimit': 1}",1088,1113,1144,200,696,1144,888,417,0,1088,1113,1144,200,696,1144,888,417,0,poisson-block-composition-pa
69,sp_workloads,1690805680,wl_big_mem,21,mixed:GM-LM-RR-LSVT-SGD-PATE-sub25100-defpa,2,ilp,block-composition-pa,poisson,equal-ncd,mixed:GM-LM-RR-LSVT-SGD-PATE,sub25100,defpa,Unlocking,0.4,MLPateGaussianMechanism,"{'Optimal': 39, 'TimeLimit': 1}",1123,1178,1085,171,737,1085,952,441,0,1123,1178,1085,171,737,1085,952,441,0,poisson-block-composition-pa
70,sp_workloads,1690805680,wl_big_mem,21,mixed:GM-LM-RR-LSVT-SGD-PATE-sub25100-defpa,2,ilp,block-composition-pa,poisson,equal-ncd,mixed:GM-LM-RR-LSVT-SGD-PATE,sub25100,defpa,Unlocking,0.4,RandResponseMechanism,"{'Optimal': 39, 'TimeLimit': 1}",1136,1135,1114,18,177,1114,1118,958,0,1136,1135,1114,18,177,1114,1118,958,0,poisson-block-composition-pa
71,sp_workloads,1690805680,wl_big_mem,21,mixed:GM-LM-RR-LSVT-SGD-PATE-sub25100-defpa,2,ilp,block-composition-pa,poisson,equal-ncd,mixed:GM-LM-RR-LSVT-SGD-PATE,sub25100,defpa,Unlocking,0.4,SVTLaplaceMechanism,"{'Optimal': 39, 'TimeLimit': 1}",1106,1092,1109,15,156,1107,1091,936,2,1106,1092,1109,15,156,1107,1091,936,2,poisson-block-composition-pa
72,sp_workloads,1690805680,wl_big_mem,24,mixed:GM-LM-RR-LSVT-SGD-PATE-sub25100-defpa,3,ilp,block-composition-pa,poisson,ncd,mixed:GM-LM-RR-LSVT-SGD-PATE,sub25100,defpa,Unlocking,0.2,GaussianMechanism,"{'Optimal': 39, 'TimeLimit': 1}",3014106,221031,21056,1713624,152786,17056,1300482,68245,4000,1094,1113,1104,566,755,914,528,358,190,poisson-block-composition-pa
73,sp_workloads,1690805680,wl_big_mem,24,mixed:GM-LM-RR-LSVT-SGD-PATE-sub25100-defpa,3,ilp,block-composition-pa,poisson,ncd,mixed:GM-LM-RR-LSVT-SGD-PATE,sub25100,defpa,Unlocking,0.2,LaplaceMechanism,"{'Optimal': 39, 'TimeLimit': 1}",3356641,218178,20864,655141,74325,17472,2701500,143853,3392,1169,1154,1119,349,495,952,820,659,167,poisson-block-composition-pa
74,sp_workloads,1690805680,wl_big_mem,24,mixed:GM-LM-RR-LSVT-SGD-PATE-sub25100-defpa,3,ilp,block-composition-pa,poisson,ncd,mixed:GM-LM-RR-LSVT-SGD-PATE,sub25100,defpa,Unlocking,0.2,MLNoisySGDMechanism,"{'Optimal': 39, 'TimeLimit': 1}",2886113,212328,21728,473338,37740,8512,2412775,174588,13216,1057,1087,1124,164,186,493,893,901,631,poisson-block-composition-pa
75,sp_workloads,1690805680,wl_big_mem,24,mixed:GM-LM-RR-LSVT-SGD-PATE-sub25100-defpa,3,ilp,block-composition-pa,poisson,ncd,mixed:GM-LM-RR-LSVT-SGD-PATE,sub25100,defpa,Unlocking,0.2,MLPateGaussianMechanism,"{'Optimal': 39, 'TimeLimit': 1}",3286989,218751,22304,278577,35896,9600,3008412,182855,12704,1114,1105,1168,126,215,562,988,890,606,poisson-block-composition-pa
76,sp_workloads,1690805680,wl_big_mem,24,mixed:GM-LM-RR-LSVT-SGD-PATE-sub25100-defpa,3,ilp,block-composition-pa,poisson,ncd,mixed:GM-LM-RR-LSVT-SGD-PATE,sub25100,defpa,Unlocking,0.2,RandResponseMechanism,"{'Optimal': 39, 'TimeLimit': 1}",3304405,225397,21760,52739,5976,6240,3251666,219421,15520,1160,1175,1154,19,33,355,1141,1142,799,poisson-block-composition-pa
77,sp_workloads,1690805680,wl_big_mem,24,mixed:GM-LM-RR-LSVT-SGD-PATE-sub25100-defpa,3,ilp,block-composition-pa,poisson,ncd,mixed:GM-LM-RR-LSVT-SGD-PATE,sub25100,defpa,Unlocking,0.2,SVTLaplaceMechanism,"{'Optimal': 39, 'TimeLimit': 1}",2975196,221951,22352,60220,8390,5776,2914976,213561,16576,1080,1132,1168,29,44,328,1051,1088,840,poisson-block-composition-pa
78,sp_workloads,1690805680,wl_big_mem,25,mixed:GM-LM-RR-LSVT-SGD-PATE-sub25100-defpa,3,ilp,block-composition-pa,poisson,ncd,mixed:GM-LM-RR-LSVT-SGD-PATE,sub25100,defpa,Unlocking,0.4,GaussianMechanism,"{'Optimal': 38, 'TimeLimit': 2}",3014106,221031,21056,1716519,154237,17424,1297587,66794,3632,1094,1113,1104,588,763,934,506,350,170,poisson-block-composition-pa
79,sp_workloads,1690805680,wl_big_mem,25,mixed:GM-LM-RR-LSVT-SGD-PATE-sub25100-defpa,3,ilp,block-composition-pa,poisson,ncd,mixed:GM-LM-RR-LSVT-SGD-PATE,sub25100,defpa,Unlocking,0.4,LaplaceMechanism,"{'Optimal': 38, 'TimeLimit': 2}",3356641,218178,20864,970647,81843,17584,2385994,136335,3280,1169,1154,1119,405,532,958,764,622,161,poisson-block-composition-pa
80,sp_workloads,1690805680,wl_big_mem,25,mixed:GM-LM-RR-LSVT-SGD-PATE-sub25100-defpa,3,ilp,block-composition-pa,poisson,ncd,mixed:GM-LM-RR-LSVT-SGD-PATE,sub25100,defpa,Unlocking,0.4,MLNoisySGDMechanism,"{'Optimal': 38, 'TimeLimit': 2}",2886113,212328,21728,420358,40063,8144,2465755,172265,13584,1057,1087,1124,146,200,472,911,887,652,poisson-block-composition-pa
81,sp_workloads,1690805680,wl_big_mem,25,mixed:GM-LM-RR-LSVT-SGD-PATE-sub25100-defpa,3,ilp,block-composition-pa,poisson,ncd,mixed:GM-LM-RR-LSVT-SGD-PATE,sub25100,defpa,Unlocking,0.4,MLPateGaussianMechanism,"{'Optimal': 38, 'TimeLimit': 2}",3286989,218751,22304,281088,37656,9360,3005901,181095,12944,1114,1105,1168,135,221,545,979,884,623,poisson-block-composition-pa
82,sp_workloads,1690805680,wl_big_mem,25,mixed:GM-LM-RR-LSVT-SGD-PATE-sub25100-defpa,3,ilp,block-composition-pa,poisson,ncd,mixed:GM-LM-RR-LSVT-SGD-PATE,sub25100,defpa,Unlocking,0.4,RandResponseMechanism,"{'Optimal': 38, 'TimeLimit': 2}",3304405,225397,21760,119792,8102,6624,3184613,217295,15136,1160,1175,1154,32,42,384,1128,1133,770,poisson-block-composition-pa
83,sp_workloads,1690805680,wl_big_mem,25,mixed:GM-LM-RR-LSVT-SGD-PATE-sub25100-defpa,3,ilp,block-composition-pa,poisson,ncd,mixed:GM-LM-RR-LSVT-SGD-PATE,sub25100,defpa,Unlocking,0.4,SVTLaplaceMechanism,"{'Optimal': 38, 'TimeLimit': 2}",2975196,221951,22352,72689,7824,6688,2902507,214127,15664,1080,1132,1168,29,49,379,1051,1083,789,poisson-block-composition-pa
84,sp_workloads,1690805680,wl_big_mem,28,mixed:GM-LM-RR-LSVT-SGD-PATE-sub25100-defpa,3,ilp,block-composition-pa,poisson,equal-ncd,mixed:GM-LM-RR-LSVT-SGD-PATE,sub25100,defpa,Unlocking,0.2,GaussianMechanism,"{'Optimal': 39, 'TimeLimit': 1}",1094,1113,1104,542,1073,1104,552,40,0,1094,1113,1104,542,1073,1104,552,40,0,poisson-block-composition-pa
85,sp_workloads,1690805680,wl_big_mem,28,mixed:GM-LM-RR-LSVT-SGD-PATE-sub25100-defpa,3,ilp,block-composition-pa,poisson,equal-ncd,mixed:GM-LM-RR-LSVT-SGD-PATE,sub25100,defpa,Unlocking,0.2,LaplaceMechanism,"{'Optimal': 39, 'TimeLimit': 1}",1169,1154,1119,346,694,1119,823,460,0,1169,1154,1119,346,694,1119,823,460,0,poisson-block-composition-pa
86,sp_workloads,1690805680,wl_big_mem,28,mixed:GM-LM-RR-LSVT-SGD-PATE-sub25100-defpa,3,ilp,block-composition-pa,poisson,equal-ncd,mixed:GM-LM-RR-LSVT-SGD-PATE,sub25100,defpa,Unlocking,0.2,MLNoisySGDMechanism,"{'Optimal': 39, 'TimeLimit': 1}",1057,1087,1124,213,710,1124,844,377,0,1057,1087,1124,213,710,1124,844,377,0,poisson-block-composition-pa
87,sp_workloads,1690805680,wl_big_mem,28,mixed:GM-LM-RR-LSVT-SGD-PATE-sub25100-defpa,3,ilp,block-composition-pa,poisson,equal-ncd,mixed:GM-LM-RR-LSVT-SGD-PATE,sub25100,defpa,Unlocking,0.2,MLPateGaussianMechanism,"{'Optimal': 39, 'TimeLimit': 1}",1114,1105,1168,161,659,1168,953,446,0,1114,1105,1168,161,659,1168,953,446,0,poisson-block-composition-pa
88,sp_workloads,1690805680,wl_big_mem,28,mixed:GM-LM-RR-LSVT-SGD-PATE-sub25100-defpa,3,ilp,block-composition-pa,poisson,equal-ncd,mixed:GM-LM-RR-LSVT-SGD-PATE,sub25100,defpa,Unlocking,0.2,RandResponseMechanism,"{'Optimal': 39, 'TimeLimit': 1}",1160,1175,1154,16,172,1154,1144,1003,0,1160,1175,1154,16,172,1154,1144,1003,0,poisson-block-composition-pa
89,sp_workloads,1690805680,wl_big_mem,28,mixed:GM-LM-RR-LSVT-SGD-PATE-sub25100-defpa,3,ilp,block-composition-pa,poisson,equal-ncd,mixed:GM-LM-RR-LSVT-SGD-PATE,sub25100,defpa,Unlocking,0.2,SVTLaplaceMechanism,"{'Optimal': 39, 'TimeLimit': 1}",1080,1132,1168,15,183,1168,1065,949,0,1080,1132,1168,15,183,1168,1065,949,0,poisson-block-composition-pa
90,sp_workloads,1690805680,wl_big_mem,29,mixed:GM-LM-RR-LSVT-SGD-PATE-sub25100-defpa,3,ilp,block-composition-pa,poisson,equal-ncd,mixed:GM-LM-RR-LSVT-SGD-PATE,sub25100,defpa,Unlocking,0.4,GaussianMechanism,"{'Optimal': 39, 'TimeLimit': 1}",1094,1113,1104,532,1057,1104,562,56,0,1094,1113,1104,532,1057,1104,562,56,0,poisson-block-composition-pa
91,sp_workloads,1690805680,wl_big_mem,29,mixed:GM-LM-RR-LSVT-SGD-PATE-sub25100-defpa,3,ilp,block-composition-pa,poisson,equal-ncd,mixed:GM-LM-RR-LSVT-SGD-PATE,sub25100,defpa,Unlocking,0.4,LaplaceMechanism,"{'Optimal': 39, 'TimeLimit': 1}",1169,1154,1119,345,736,1119,824,418,0,1169,1154,1119,345,736,1119,824,418,0,poisson-block-composition-pa
92,sp_workloads,1690805680,wl_big_mem,29,mixed:GM-LM-RR-LSVT-SGD-PATE-sub25100-defpa,3,ilp,block-composition-pa,poisson,equal-ncd,mixed:GM-LM-RR-LSVT-SGD-PATE,sub25100,defpa,Unlocking,0.4,MLNoisySGDMechanism,"{'Optimal': 39, 'TimeLimit': 1}",1057,1087,1124,206,697,1124,851,390,0,1057,1087,1124,206,697,1124,851,390,0,poisson-block-composition-pa
93,sp_workloads,1690805680,wl_big_mem,29,mixed:GM-LM-RR-LSVT-SGD-PATE-sub25100-defpa,3,ilp,block-composition-pa,poisson,equal-ncd,mixed:GM-LM-RR-LSVT-SGD-PATE,sub25100,defpa,Unlocking,0.4,MLPateGaussianMechanism,"{'Optimal': 39, 'TimeLimit': 1}",1114,1105,1168,160,664,1168,954,441,0,1114,1105,1168,160,664,1168,954,441,0,poisson-block-composition-pa
94,sp_workloads,1690805680,wl_big_mem,29,mixed:GM-LM-RR-LSVT-SGD-PATE-sub25100-defpa,3,ilp,block-composition-pa,poisson,equal-ncd,mixed:GM-LM-RR-LSVT-SGD-PATE,sub25100,defpa,Unlocking,0.4,RandResponseMechanism,"{'Optimal': 39, 'TimeLimit': 1}",1160,1175,1154,18,176,1154,1142,999,0,1160,1175,1154,18,176,1154,1142,999,0,poisson-block-composition-pa
95,sp_workloads,1690805680,wl_big_mem,29,mixed:GM-LM-RR-LSVT-SGD-PATE-sub25100-defpa,3,ilp,block-composition-pa,poisson,equal-ncd,mixed:GM-LM-RR-LSVT-SGD-PATE,sub25100,defpa,Unlocking,0.4,SVTLaplaceMechanism,"{'Optimal': 39, 'TimeLimit': 1}",1080,1132,1168,24,180,1167,1056,952,1,1080,1132,1168,24,180,1167,1056,952,1,poisson-block-composition-pa
96,sp_workloads,1690805680,wl_big_mem,32,mixed:GM-LM-RR-LSVT-SGD-PATE-sub25100-defpa,4,ilp,block-composition-pa,poisson,ncd,mixed:GM-LM-RR-LSVT-SGD-PATE,sub25100,defpa,Unlocking,0.2,GaussianMechanism,"{'Optimal': 39, 'TimeLimit': 1}",3164159,212016,19356,1725945,140244,16066,1438214,71772,3290,1113,1088,1060,563,732,894,550,356,166,poisson-block-composition-pa
97,sp_workloads,1690805680,wl_big_mem,32,mixed:GM-LM-RR-LSVT-SGD-PATE-sub25100-defpa,4,ilp,block-composition-pa,poisson,ncd,mixed:GM-LM-RR-LSVT-SGD-PATE,sub25100,defpa,Unlocking,0.2,LaplaceMechanism,"{'Optimal': 39, 'TimeLimit': 1}",2854575,215653,19585,575379,76172,16252,2279196,139481,3333,1062,1115,1087,306,452,916,756,663,171,poisson-block-composition-pa
98,sp_workloads,1690805680,wl_big_mem,32,mixed:GM-LM-RR-LSVT-SGD-PATE-sub25100-defpa,4,ilp,block-composition-pa,poisson,ncd,mixed:GM-LM-RR-LSVT-SGD-PATE,sub25100,defpa,Unlocking,0.2,MLNoisySGDMechanism,"{'Optimal': 39, 'TimeLimit': 1}",3215801,221736,20277,579082,37749,7713,2636719,183987,12564,1144,1128,1131,189,203,479,955,925,652,poisson-block-composition-pa
99,sp_workloads,1690805680,wl_big_mem,32,mixed:GM-LM-RR-LSVT-SGD-PATE-sub25100-defpa,4,ilp,block-composition-pa,poisson,ncd,mixed:GM-LM-RR-LSVT-SGD-PATE,sub25100,defpa,Unlocking,0.2,MLPateGaussianMechanism,"{'Optimal': 39, 'TimeLimit': 1}",3246364,219077,18914,337888,33567,7922,2908476,185510,10992,1154,1099,1070,141,209,510,1013,890,560,poisson-block-composition-pa
100,sp_workloads,1690805680,wl_big_mem,32,mixed:GM-LM-RR-LSVT-SGD-PATE-sub25100-defpa,4,ilp,block-composition-pa,poisson,ncd,mixed:GM-LM-RR-LSVT-SGD-PATE,sub25100,defpa,Unlocking,0.2,RandResponseMechanism,"{'Optimal': 39, 'TimeLimit': 1}",3086084,218125,20774,35449,5228,5829,3050635,212897,14945,1149,1123,1162,23,36,363,1126,1087,799,poisson-block-composition-pa
101,sp_workloads,1690805680,wl_big_mem,32,mixed:GM-LM-RR-LSVT-SGD-PATE-sub25100-defpa,4,ilp,block-composition-pa,poisson,ncd,mixed:GM-LM-RR-LSVT-SGD-PATE,sub25100,defpa,Unlocking,0.2,SVTLaplaceMechanism,"{'Optimal': 39, 'TimeLimit': 1}",3076541,223346,21123,22051,6948,5309,3054490,216398,15814,1073,1134,1197,19,44,339,1054,1090,858,poisson-block-composition-pa
102,sp_workloads,1690805680,wl_big_mem,33,mixed:GM-LM-RR-LSVT-SGD-PATE-sub25100-defpa,4,ilp,block-composition-pa,poisson,ncd,mixed:GM-LM-RR-LSVT-SGD-PATE,sub25100,defpa,Unlocking,0.4,GaussianMechanism,"{'Optimal': 39, 'TimeLimit': 1}",3164159,212016,19356,1709126,151817,16267,1455033,60199,3089,1113,1088,1060,605,775,901,508,313,159,poisson-block-composition-pa
103,sp_workloads,1690805680,wl_big_mem,33,mixed:GM-LM-RR-LSVT-SGD-PATE-sub25100-defpa,4,ilp,block-composition-pa,poisson,ncd,mixed:GM-LM-RR-LSVT-SGD-PATE,sub25100,defpa,Unlocking,0.4,LaplaceMechanism,"{'Optimal': 39, 'TimeLimit': 1}",2854575,215653,19585,847798,86274,16926,2006777,129379,2659,1062,1115,1087,376,494,946,686,621,141,poisson-block-composition-pa
104,sp_workloads,1690805680,wl_big_mem,33,mixed:GM-LM-RR-LSVT-SGD-PATE-sub25100-defpa,4,ilp,block-composition-pa,poisson,ncd,mixed:GM-LM-RR-LSVT-SGD-PATE,sub25100,defpa,Unlocking,0.4,MLNoisySGDMechanism,"{'Optimal': 39, 'TimeLimit': 1}",3215801,221736,20277,535063,37793,7979,2680738,183943,12298,1144,1128,1131,182,207,485,962,921,646,poisson-block-composition-pa
105,sp_workloads,1690805680,wl_big_mem,33,mixed:GM-LM-RR-LSVT-SGD-PATE-sub25100-defpa,4,ilp,block-composition-pa,poisson,ncd,mixed:GM-LM-RR-LSVT-SGD-PATE,sub25100,defpa,Unlocking,0.4,MLPateGaussianMechanism,"{'Optimal': 39, 'TimeLimit': 1}",3246364,219077,18914,336211,38278,7974,2910153,180799,10940,1154,1099,1070,151,234,506,1003,865,564,poisson-block-composition-pa
106,sp_workloads,1690805680,wl_big_mem,33,mixed:GM-LM-RR-LSVT-SGD-PATE-sub25100-defpa,4,ilp,block-composition-pa,poisson,ncd,mixed:GM-LM-RR-LSVT-SGD-PATE,sub25100,defpa,Unlocking,0.4,RandResponseMechanism,"{'Optimal': 39, 'TimeLimit': 1}",3086084,218125,20774,63261,6084,5737,3022823,212041,15037,1149,1123,1162,29,44,359,1120,1079,803,poisson-block-composition-pa
107,sp_workloads,1690805680,wl_big_mem,33,mixed:GM-LM-RR-LSVT-SGD-PATE-sub25100-defpa,4,ilp,block-composition-pa,poisson,ncd,mixed:GM-LM-RR-LSVT-SGD-PATE,sub25100,defpa,Unlocking,0.4,SVTLaplaceMechanism,"{'Optimal': 39, 'TimeLimit': 1}",3076541,223346,21123,64731,8716,5716,3011810,214630,15407,1073,1134,1197,30,52,348,1043,1082,849,poisson-block-composition-pa
108,sp_workloads,1690805680,wl_big_mem,36,mixed:GM-LM-RR-LSVT-SGD-PATE-sub25100-defpa,4,ilp,block-composition-pa,poisson,equal-ncd,mixed:GM-LM-RR-LSVT-SGD-PATE,sub25100,defpa,Unlocking,0.2,GaussianMechanism,"{'Optimal': 38, 'TimeLimit': 2}",1113,1088,1060,536,1055,1060,577,33,0,1113,1088,1060,536,1055,1060,577,33,0,poisson-block-composition-pa
109,sp_workloads,1690805680,wl_big_mem,36,mixed:GM-LM-RR-LSVT-SGD-PATE-sub25100-defpa,4,ilp,block-composition-pa,poisson,equal-ncd,mixed:GM-LM-RR-LSVT-SGD-PATE,sub25100,defpa,Unlocking,0.2,LaplaceMechanism,"{'Optimal': 38, 'TimeLimit': 2}",1062,1115,1087,321,683,1087,741,432,0,1062,1115,1087,321,683,1087,741,432,0,poisson-block-composition-pa
110,sp_workloads,1690805680,wl_big_mem,36,mixed:GM-LM-RR-LSVT-SGD-PATE-sub25100-defpa,4,ilp,block-composition-pa,poisson,equal-ncd,mixed:GM-LM-RR-LSVT-SGD-PATE,sub25100,defpa,Unlocking,0.2,MLNoisySGDMechanism,"{'Optimal': 38, 'TimeLimit': 2}",1144,1128,1131,215,721,1131,929,407,0,1144,1128,1131,215,721,1131,929,407,0,poisson-block-composition-pa
111,sp_workloads,1690805680,wl_big_mem,36,mixed:GM-LM-RR-LSVT-SGD-PATE-sub25100-defpa,4,ilp,block-composition-pa,poisson,equal-ncd,mixed:GM-LM-RR-LSVT-SGD-PATE,sub25100,defpa,Unlocking,0.2,MLPateGaussianMechanism,"{'Optimal': 38, 'TimeLimit': 2}",1154,1099,1070,157,653,1069,997,446,1,1154,1099,1070,157,653,1069,997,446,1,poisson-block-composition-pa
112,sp_workloads,1690805680,wl_big_mem,36,mixed:GM-LM-RR-LSVT-SGD-PATE-sub25100-defpa,4,ilp,block-composition-pa,poisson,equal-ncd,mixed:GM-LM-RR-LSVT-SGD-PATE,sub25100,defpa,Unlocking,0.2,RandResponseMechanism,"{'Optimal': 38, 'TimeLimit': 2}",1149,1123,1162,20,171,1162,1129,952,0,1149,1123,1162,20,171,1162,1129,952,0,poisson-block-composition-pa
113,sp_workloads,1690805680,wl_big_mem,36,mixed:GM-LM-RR-LSVT-SGD-PATE-sub25100-defpa,4,ilp,block-composition-pa,poisson,equal-ncd,mixed:GM-LM-RR-LSVT-SGD-PATE,sub25100,defpa,Unlocking,0.2,SVTLaplaceMechanism,"{'Optimal': 38, 'TimeLimit': 2}",1073,1134,1197,22,167,1197,1051,967,0,1073,1134,1197,22,167,1197,1051,967,0,poisson-block-composition-pa
114,sp_workloads,1690805680,wl_big_mem,37,mixed:GM-LM-RR-LSVT-SGD-PATE-sub25100-defpa,4,ilp,block-composition-pa,poisson,equal-ncd,mixed:GM-LM-RR-LSVT-SGD-PATE,sub25100,defpa,Unlocking,0.4,GaussianMechanism,"{'Optimal': 38, 'TimeLimit': 2}",1113,1088,1060,528,1040,1060,585,48,0,1113,1088,1060,528,1040,1060,585,48,0,poisson-block-composition-pa
115,sp_workloads,1690805680,wl_big_mem,37,mixed:GM-LM-RR-LSVT-SGD-PATE-sub25100-defpa,4,ilp,block-composition-pa,poisson,equal-ncd,mixed:GM-LM-RR-LSVT-SGD-PATE,sub25100,defpa,Unlocking,0.4,LaplaceMechanism,"{'Optimal': 38, 'TimeLimit': 2}",1062,1115,1087,345,729,1087,717,386,0,1062,1115,1087,345,729,1087,717,386,0,poisson-block-composition-pa
116,sp_workloads,1690805680,wl_big_mem,37,mixed:GM-LM-RR-LSVT-SGD-PATE-sub25100-defpa,4,ilp,block-composition-pa,poisson,equal-ncd,mixed:GM-LM-RR-LSVT-SGD-PATE,sub25100,defpa,Unlocking,0.4,MLNoisySGDMechanism,"{'Optimal': 38, 'TimeLimit': 2}",1144,1128,1131,199,717,1131,945,411,0,1144,1128,1131,199,717,1131,945,411,0,poisson-block-composition-pa
117,sp_workloads,1690805680,wl_big_mem,37,mixed:GM-LM-RR-LSVT-SGD-PATE-sub25100-defpa,4,ilp,block-composition-pa,poisson,equal-ncd,mixed:GM-LM-RR-LSVT-SGD-PATE,sub25100,defpa,Unlocking,0.4,MLPateGaussianMechanism,"{'Optimal': 38, 'TimeLimit': 2}",1154,1099,1070,144,651,1070,1010,448,0,1154,1099,1070,144,651,1070,1010,448,0,poisson-block-composition-pa
118,sp_workloads,1690805680,wl_big_mem,37,mixed:GM-LM-RR-LSVT-SGD-PATE-sub25100-defpa,4,ilp,block-composition-pa,poisson,equal-ncd,mixed:GM-LM-RR-LSVT-SGD-PATE,sub25100,defpa,Unlocking,0.4,RandResponseMechanism,"{'Optimal': 38, 'TimeLimit': 2}",1149,1123,1162,25,170,1162,1124,953,0,1149,1123,1162,25,170,1162,1124,953,0,poisson-block-composition-pa
119,sp_workloads,1690805680,wl_big_mem,37,mixed:GM-LM-RR-LSVT-SGD-PATE-sub25100-defpa,4,ilp,block-composition-pa,poisson,equal-ncd,mixed:GM-LM-RR-LSVT-SGD-PATE,sub25100,defpa,Unlocking,0.4,SVTLaplaceMechanism,"{'Optimal': 38, 'TimeLimit': 2}",1073,1134,1197,23,175,1197,1050,959,0,1073,1134,1197,23,175,1197,1050,959,0,poisson-block-composition-pa
120,sp_workloads,1690805680,wl_big_mem,40,basic:GM-LM-RR-LSVT-sub25100-defpa,0,ilp,block-composition-pa,poisson,ncd,basic:GM-LM-RR-LSVT,sub25100,defpa,Unlocking,0.2,GaussianMechanism,"{'Optimal': 38, 'TimeLimit': 2}",4847751,317174,28905,2650255,187088,23094,2197496,130086,5811,1760,1618,1607,845,1013,1306,915,605,301,poisson-block-composition-pa
121,sp_workloads,1690805680,wl_big_mem,40,basic:GM-LM-RR-LSVT-sub25100-defpa,0,ilp,block-composition-pa,poisson,ncd,basic:GM-LM-RR-LSVT,sub25100,defpa,Unlocking,0.2,LaplaceMechanism,"{'Optimal': 38, 'TimeLimit': 2}",4580618,310999,29482,1159433,99662,24567,3421185,211337,4915,1690,1679,1654,475,660,1401,1215,1019,253,poisson-block-composition-pa
122,sp_workloads,1690805680,wl_big_mem,40,basic:GM-LM-RR-LSVT-sub25100-defpa,0,ilp,block-composition-pa,poisson,ncd,basic:GM-LM-RR-LSVT,sub25100,defpa,Unlocking,0.2,RandResponseMechanism,"{'Optimal': 38, 'TimeLimit': 2}",4834309,320190,30099,84594,6560,9442,4749715,313630,20657,1752,1677,1693,30,56,590,1722,1621,1103,poisson-block-composition-pa
123,sp_workloads,1690805680,wl_big_mem,40,basic:GM-LM-RR-LSVT-sub25100-defpa,0,ilp,block-composition-pa,poisson,ncd,basic:GM-LM-RR-LSVT,sub25100,defpa,Unlocking,0.2,SVTLaplaceMechanism,"{'Optimal': 38, 'TimeLimit': 2}",4502539,307841,30348,70735,8970,8452,4431804,298871,21896,1685,1652,1684,32,50,524,1653,1602,1160,poisson-block-composition-pa
124,sp_workloads,1690805680,wl_big_mem,41,basic:GM-LM-RR-LSVT-sub25100-defpa,0,ilp,block-composition-pa,poisson,ncd,basic:GM-LM-RR-LSVT,sub25100,defpa,Unlocking,0.4,GaussianMechanism,"{'Optimal': 39, 'TimeLimit': 1}",4847751,317174,28905,2475714,213214,24882,2372037,103960,4023,1760,1618,1607,881,1093,1390,879,525,217,poisson-block-composition-pa
125,sp_workloads,1690805680,wl_big_mem,41,basic:GM-LM-RR-LSVT-sub25100-defpa,0,ilp,block-composition-pa,poisson,ncd,basic:GM-LM-RR-LSVT,sub25100,defpa,Unlocking,0.4,LaplaceMechanism,"{'Optimal': 39, 'TimeLimit': 1}",4580618,310999,29482,1649531,115775,25244,2931087,195224,4238,1690,1679,1654,596,712,1428,1094,967,226,poisson-block-composition-pa
126,sp_workloads,1690805680,wl_big_mem,41,basic:GM-LM-RR-LSVT-sub25100-defpa,0,ilp,block-composition-pa,poisson,ncd,basic:GM-LM-RR-LSVT,sub25100,defpa,Unlocking,0.4,RandResponseMechanism,"{'Optimal': 39, 'TimeLimit': 1}",4834309,320190,30099,134247,7304,10699,4700062,312886,19400,1752,1677,1693,50,59,677,1702,1618,1016,poisson-block-composition-pa
127,sp_workloads,1690805680,wl_big_mem,41,basic:GM-LM-RR-LSVT-sub25100-defpa,0,ilp,block-composition-pa,poisson,ncd,basic:GM-LM-RR-LSVT,sub25100,defpa,Unlocking,0.4,SVTLaplaceMechanism,"{'Optimal': 39, 'TimeLimit': 1}",4502539,307841,30348,134197,5185,10374,4368342,302656,19974,1685,1652,1684,54,38,650,1631,1614,1034,poisson-block-composition-pa
128,sp_workloads,1690805680,wl_big_mem,44,basic:GM-LM-RR-LSVT-sub25100-defpa,0,ilp,block-composition-pa,poisson,equal-ncd,basic:GM-LM-RR-LSVT,sub25100,defpa,Unlocking,0.2,GaussianMechanism,"{'Optimal': 39, 'TimeLimit': 1}",1760,1618,1607,857,1574,1607,903,44,0,1760,1618,1607,857,1574,1607,903,44,0,poisson-block-composition-pa
129,sp_workloads,1690805680,wl_big_mem,44,basic:GM-LM-RR-LSVT-sub25100-defpa,0,ilp,block-composition-pa,poisson,equal-ncd,basic:GM-LM-RR-LSVT,sub25100,defpa,Unlocking,0.2,LaplaceMechanism,"{'Optimal': 39, 'TimeLimit': 1}",1690,1679,1654,583,1086,1654,1107,593,0,1690,1679,1654,583,1086,1654,1107,593,0,poisson-block-composition-pa
130,sp_workloads,1690805680,wl_big_mem,44,basic:GM-LM-RR-LSVT-sub25100-defpa,0,ilp,block-composition-pa,poisson,equal-ncd,basic:GM-LM-RR-LSVT,sub25100,defpa,Unlocking,0.2,RandResponseMechanism,"{'Optimal': 39, 'TimeLimit': 1}",1752,1677,1693,37,275,1692,1715,1402,1,1752,1677,1693,37,275,1692,1715,1402,1,poisson-block-composition-pa
131,sp_workloads,1690805680,wl_big_mem,44,basic:GM-LM-RR-LSVT-sub25100-defpa,0,ilp,block-composition-pa,poisson,equal-ncd,basic:GM-LM-RR-LSVT,sub25100,defpa,Unlocking,0.2,SVTLaplaceMechanism,"{'Optimal': 39, 'TimeLimit': 1}",1685,1652,1684,33,287,1684,1652,1365,0,1685,1652,1684,33,287,1684,1652,1365,0,poisson-block-composition-pa
132,sp_workloads,1690805680,wl_big_mem,45,basic:GM-LM-RR-LSVT-sub25100-defpa,0,ilp,block-composition-pa,poisson,equal-ncd,basic:GM-LM-RR-LSVT,sub25100,defpa,Unlocking,0.4,GaussianMechanism,"{'Optimal': 38, 'TimeLimit': 2}",1760,1618,1607,860,1571,1607,900,47,0,1760,1618,1607,860,1571,1607,900,47,0,poisson-block-composition-pa
133,sp_workloads,1690805680,wl_big_mem,45,basic:GM-LM-RR-LSVT-sub25100-defpa,0,ilp,block-composition-pa,poisson,equal-ncd,basic:GM-LM-RR-LSVT,sub25100,defpa,Unlocking,0.4,LaplaceMechanism,"{'Optimal': 38, 'TimeLimit': 2}",1690,1679,1654,583,1119,1654,1107,560,0,1690,1679,1654,583,1119,1654,1107,560,0,poisson-block-composition-pa
134,sp_workloads,1690805680,wl_big_mem,45,basic:GM-LM-RR-LSVT-sub25100-defpa,0,ilp,block-composition-pa,poisson,equal-ncd,basic:GM-LM-RR-LSVT,sub25100,defpa,Unlocking,0.4,RandResponseMechanism,"{'Optimal': 38, 'TimeLimit': 2}",1752,1677,1693,35,297,1693,1717,1380,0,1752,1677,1693,35,297,1693,1717,1380,0,poisson-block-composition-pa
135,sp_workloads,1690805680,wl_big_mem,45,basic:GM-LM-RR-LSVT-sub25100-defpa,0,ilp,block-composition-pa,poisson,equal-ncd,basic:GM-LM-RR-LSVT,sub25100,defpa,Unlocking,0.4,SVTLaplaceMechanism,"{'Optimal': 38, 'TimeLimit': 2}",1685,1652,1684,39,291,1684,1646,1361,0,1685,1652,1684,39,291,1684,1646,1361,0,poisson-block-composition-pa
136,sp_workloads,1690805680,wl_big_mem,48,basic:GM-LM-RR-LSVT-sub25100-defpa,1,ilp,block-composition-pa,poisson,ncd,basic:GM-LM-RR-LSVT,sub25100,defpa,Unlocking,0.2,GaussianMechanism,"{'Optimal': 39, 'TimeLimit': 1}",4674135,351804,29818,2392171,216279,24025,2281964,135525,5793,1725,1745,1670,782,1139,1367,943,606,303,poisson-block-composition-pa
137,sp_workloads,1690805680,wl_big_mem,48,basic:GM-LM-RR-LSVT-sub25100-defpa,1,ilp,block-composition-pa,poisson,ncd,basic:GM-LM-RR-LSVT,sub25100,defpa,Unlocking,0.2,LaplaceMechanism,"{'Optimal': 39, 'TimeLimit': 1}",4701336,316959,30901,1101467,105113,26465,3599869,211846,4436,1705,1659,1707,454,662,1471,1251,997,236,poisson-block-composition-pa
138,sp_workloads,1690805680,wl_big_mem,48,basic:GM-LM-RR-LSVT-sub25100-defpa,1,ilp,block-composition-pa,poisson,ncd,basic:GM-LM-RR-LSVT,sub25100,defpa,Unlocking,0.2,RandResponseMechanism,"{'Optimal': 39, 'TimeLimit': 1}",4751311,334074,30363,55114,11334,9897,4696197,322740,20466,1634,1678,1701,24,67,615,1610,1611,1086,poisson-block-composition-pa
139,sp_workloads,1690805680,wl_big_mem,48,basic:GM-LM-RR-LSVT-sub25100-defpa,1,ilp,block-composition-pa,poisson,ncd,basic:GM-LM-RR-LSVT,sub25100,defpa,Unlocking,0.2,SVTLaplaceMechanism,"{'Optimal': 39, 'TimeLimit': 1}",4658717,301226,29963,102337,8978,9663,4556380,292248,20300,1700,1628,1669,33,64,593,1667,1564,1076,poisson-block-composition-pa
140,sp_workloads,1690805680,wl_big_mem,49,basic:GM-LM-RR-LSVT-sub25100-defpa,1,ilp,block-composition-pa,poisson,ncd,basic:GM-LM-RR-LSVT,sub25100,defpa,Unlocking,0.4,GaussianMechanism,"{'Optimal': 38, 'TimeLimit': 2}",4674135,351804,29818,2428118,227938,25004,2246017,123866,4814,1725,1745,1670,857,1195,1412,868,550,258,poisson-block-composition-pa
141,sp_workloads,1690805680,wl_big_mem,49,basic:GM-LM-RR-LSVT-sub25100-defpa,1,ilp,block-composition-pa,poisson,ncd,basic:GM-LM-RR-LSVT,sub25100,defpa,Unlocking,0.4,LaplaceMechanism,"{'Optimal': 38, 'TimeLimit': 2}",4701336,316959,30901,1609632,101239,27595,3091704,215720,3306,1705,1659,1707,560,661,1525,1145,998,182,poisson-block-composition-pa
142,sp_workloads,1690805680,wl_big_mem,49,basic:GM-LM-RR-LSVT-sub25100-defpa,1,ilp,block-composition-pa,poisson,ncd,basic:GM-LM-RR-LSVT,sub25100,defpa,Unlocking,0.4,RandResponseMechanism,"{'Optimal': 38, 'TimeLimit': 2}",4751311,334074,30363,89304,8449,11448,4662007,325625,18915,1634,1678,1701,44,59,712,1590,1619,989,poisson-block-composition-pa
143,sp_workloads,1690805680,wl_big_mem,49,basic:GM-LM-RR-LSVT-sub25100-defpa,1,ilp,block-composition-pa,poisson,ncd,basic:GM-LM-RR-LSVT,sub25100,defpa,Unlocking,0.4,SVTLaplaceMechanism,"{'Optimal': 38, 'TimeLimit': 2}",4658717,301226,29963,116120,8278,10142,4542597,292948,19821,1700,1628,1669,41,57,626,1659,1571,1043,poisson-block-composition-pa
144,sp_workloads,1690805680,wl_big_mem,52,basic:GM-LM-RR-LSVT-sub25100-defpa,1,ilp,block-composition-pa,poisson,equal-ncd,basic:GM-LM-RR-LSVT,sub25100,defpa,Unlocking,0.2,GaussianMechanism,"{'Optimal': 39, 'TimeLimit': 1}",1725,1745,1670,847,1690,1670,878,55,0,1725,1745,1670,847,1690,1670,878,55,0,poisson-block-composition-pa
145,sp_workloads,1690805680,wl_big_mem,52,basic:GM-LM-RR-LSVT-sub25100-defpa,1,ilp,block-composition-pa,poisson,equal-ncd,basic:GM-LM-RR-LSVT,sub25100,defpa,Unlocking,0.2,LaplaceMechanism,"{'Optimal': 39, 'TimeLimit': 1}",1705,1659,1707,551,1071,1707,1154,588,0,1705,1659,1707,551,1071,1707,1154,588,0,poisson-block-composition-pa
146,sp_workloads,1690805680,wl_big_mem,52,basic:GM-LM-RR-LSVT-sub25100-defpa,1,ilp,block-composition-pa,poisson,equal-ncd,basic:GM-LM-RR-LSVT,sub25100,defpa,Unlocking,0.2,RandResponseMechanism,"{'Optimal': 39, 'TimeLimit': 1}",1634,1678,1701,37,282,1701,1597,1396,0,1634,1678,1701,37,282,1701,1597,1396,0,poisson-block-composition-pa
147,sp_workloads,1690805680,wl_big_mem,52,basic:GM-LM-RR-LSVT-sub25100-defpa,1,ilp,block-composition-pa,poisson,equal-ncd,basic:GM-LM-RR-LSVT,sub25100,defpa,Unlocking,0.2,SVTLaplaceMechanism,"{'Optimal': 39, 'TimeLimit': 1}",1700,1628,1669,36,285,1669,1664,1343,0,1700,1628,1669,36,285,1669,1664,1343,0,poisson-block-composition-pa
148,sp_workloads,1690805680,wl_big_mem,53,basic:GM-LM-RR-LSVT-sub25100-defpa,1,ilp,block-composition-pa,poisson,equal-ncd,basic:GM-LM-RR-LSVT,sub25100,defpa,Unlocking,0.4,GaussianMechanism,"{'Optimal': 39, 'TimeLimit': 1}",1725,1745,1670,851,1681,1670,874,64,0,1725,1745,1670,851,1681,1670,874,64,0,poisson-block-composition-pa
149,sp_workloads,1690805680,wl_big_mem,53,basic:GM-LM-RR-LSVT-sub25100-defpa,1,ilp,block-composition-pa,poisson,equal-ncd,basic:GM-LM-RR-LSVT,sub25100,defpa,Unlocking,0.4,LaplaceMechanism,"{'Optimal': 39, 'TimeLimit': 1}",1705,1659,1707,528,1130,1707,1177,529,0,1705,1659,1707,528,1130,1707,1177,529,0,poisson-block-composition-pa
150,sp_workloads,1690805680,wl_big_mem,53,basic:GM-LM-RR-LSVT-sub25100-defpa,1,ilp,block-composition-pa,poisson,equal-ncd,basic:GM-LM-RR-LSVT,sub25100,defpa,Unlocking,0.4,RandResponseMechanism,"{'Optimal': 39, 'TimeLimit': 1}",1634,1678,1701,39,289,1701,1595,1389,0,1634,1678,1701,39,289,1701,1595,1389,0,poisson-block-composition-pa
151,sp_workloads,1690805680,wl_big_mem,53,basic:GM-LM-RR-LSVT-sub25100-defpa,1,ilp,block-composition-pa,poisson,equal-ncd,basic:GM-LM-RR-LSVT,sub25100,defpa,Unlocking,0.4,SVTLaplaceMechanism,"{'Optimal': 39, 'TimeLimit': 1}",1700,1628,1669,38,306,1669,1662,1322,0,1700,1628,1669,38,306,1669,1662,1322,0,poisson-block-composition-pa
152,sp_workloads,1690805680,wl_big_mem,56,basic:GM-LM-RR-LSVT-sub25100-defpa,2,ilp,block-composition-pa,poisson,ncd,basic:GM-LM-RR-LSVT,sub25100,defpa,Unlocking,0.2,GaussianMechanism,"{'Optimal': 39, 'TimeLimit': 1}",4344073,336565,33248,2325552,213552,26160,2018521,123013,7088,1647,1671,1731,737,1107,1391,910,564,340,poisson-block-composition-pa
153,sp_workloads,1690805680,wl_big_mem,56,basic:GM-LM-RR-LSVT-sub25100-defpa,2,ilp,block-composition-pa,poisson,ncd,basic:GM-LM-RR-LSVT,sub25100,defpa,Unlocking,0.2,LaplaceMechanism,"{'Optimal': 39, 'TimeLimit': 1}",4548967,333299,30800,1186838,137164,25536,3362129,196135,5264,1660,1661,1646,490,715,1373,1170,946,273,poisson-block-composition-pa
154,sp_workloads,1690805680,wl_big_mem,56,basic:GM-LM-RR-LSVT-sub25100-defpa,2,ilp,block-composition-pa,poisson,ncd,basic:GM-LM-RR-LSVT,sub25100,defpa,Unlocking,0.2,RandResponseMechanism,"{'Optimal': 39, 'TimeLimit': 1}",5016525,328891,32448,54423,10840,10768,4962102,318051,21680,1714,1690,1723,31,60,636,1683,1630,1087,poisson-block-composition-pa
155,sp_workloads,1690805680,wl_big_mem,56,basic:GM-LM-RR-LSVT-sub25100-defpa,2,ilp,block-composition-pa,poisson,ncd,basic:GM-LM-RR-LSVT,sub25100,defpa,Unlocking,0.2,SVTLaplaceMechanism,"{'Optimal': 39, 'TimeLimit': 1}",4781610,327880,32576,85092,12032,10368,4696518,315848,22208,1631,1679,1700,29,62,598,1602,1617,1102,poisson-block-composition-pa
156,sp_workloads,1690805680,wl_big_mem,57,basic:GM-LM-RR-LSVT-sub25100-defpa,2,ilp,block-composition-pa,poisson,ncd,basic:GM-LM-RR-LSVT,sub25100,defpa,Unlocking,0.4,GaussianMechanism,"{'Optimal': 39, 'TimeLimit': 1}",4344073,336565,33248,2242164,235978,28032,2101909,100587,5216,1647,1671,1731,797,1199,1475,850,472,256,poisson-block-composition-pa
157,sp_workloads,1690805680,wl_big_mem,57,basic:GM-LM-RR-LSVT-sub25100-defpa,2,ilp,block-composition-pa,poisson,ncd,basic:GM-LM-RR-LSVT,sub25100,defpa,Unlocking,0.4,LaplaceMechanism,"{'Optimal': 39, 'TimeLimit': 1}",4548967,333299,30800,1627410,137609,26992,2921557,195690,3808,1660,1661,1646,593,742,1445,1067,919,201,poisson-block-composition-pa
158,sp_workloads,1690805680,wl_big_mem,57,basic:GM-LM-RR-LSVT-sub25100-defpa,2,ilp,block-composition-pa,poisson,ncd,basic:GM-LM-RR-LSVT,sub25100,defpa,Unlocking,0.4,RandResponseMechanism,"{'Optimal': 39, 'TimeLimit': 1}",5016525,328891,32448,108673,12080,12896,4907852,316811,19552,1714,1690,1723,45,70,756,1669,1620,967,poisson-block-composition-pa
159,sp_workloads,1690805680,wl_big_mem,57,basic:GM-LM-RR-LSVT-sub25100-defpa,2,ilp,block-composition-pa,poisson,ncd,basic:GM-LM-RR-LSVT,sub25100,defpa,Unlocking,0.4,SVTLaplaceMechanism,"{'Optimal': 39, 'TimeLimit': 1}",4781610,327880,32576,119631,11851,11664,4661979,316029,20912,1631,1679,1700,38,68,671,1593,1611,1029,poisson-block-composition-pa
160,sp_workloads,1690805680,wl_big_mem,60,basic:GM-LM-RR-LSVT-sub25100-defpa,2,ilp,block-composition-pa,poisson,equal-ncd,basic:GM-LM-RR-LSVT,sub25100,defpa,Unlocking,0.2,GaussianMechanism,"{'Optimal': 39, 'TimeLimit': 1}",1647,1671,1731,799,1633,1731,848,38,0,1647,1671,1731,799,1633,1731,848,38,0,poisson-block-composition-pa
161,sp_workloads,1690805680,wl_big_mem,60,basic:GM-LM-RR-LSVT-sub25100-defpa,2,ilp,block-composition-pa,poisson,equal-ncd,basic:GM-LM-RR-LSVT,sub25100,defpa,Unlocking,0.2,LaplaceMechanism,"{'Optimal': 39, 'TimeLimit': 1}",1660,1661,1646,561,1059,1646,1099,602,0,1660,1661,1646,561,1059,1646,1099,602,0,poisson-block-composition-pa
162,sp_workloads,1690805680,wl_big_mem,60,basic:GM-LM-RR-LSVT-sub25100-defpa,2,ilp,block-composition-pa,poisson,equal-ncd,basic:GM-LM-RR-LSVT,sub25100,defpa,Unlocking,0.2,RandResponseMechanism,"{'Optimal': 39, 'TimeLimit': 1}",1714,1690,1723,32,312,1723,1682,1378,0,1714,1690,1723,32,312,1723,1682,1378,0,poisson-block-composition-pa
163,sp_workloads,1690805680,wl_big_mem,60,basic:GM-LM-RR-LSVT-sub25100-defpa,2,ilp,block-composition-pa,poisson,equal-ncd,basic:GM-LM-RR-LSVT,sub25100,defpa,Unlocking,0.2,SVTLaplaceMechanism,"{'Optimal': 39, 'TimeLimit': 1}",1631,1679,1700,26,294,1700,1605,1385,0,1631,1679,1700,26,294,1700,1605,1385,0,poisson-block-composition-pa
164,sp_workloads,1690805680,wl_big_mem,61,basic:GM-LM-RR-LSVT-sub25100-defpa,2,ilp,block-composition-pa,poisson,equal-ncd,basic:GM-LM-RR-LSVT,sub25100,defpa,Unlocking,0.4,GaussianMechanism,"{'Optimal': 39, 'TimeLimit': 1}",1647,1671,1731,799,1614,1731,848,57,0,1647,1671,1731,799,1614,1731,848,57,0,poisson-block-composition-pa
165,sp_workloads,1690805680,wl_big_mem,61,basic:GM-LM-RR-LSVT-sub25100-defpa,2,ilp,block-composition-pa,poisson,equal-ncd,basic:GM-LM-RR-LSVT,sub25100,defpa,Unlocking,0.4,LaplaceMechanism,"{'Optimal': 39, 'TimeLimit': 1}",1660,1661,1646,565,1112,1646,1095,549,0,1660,1661,1646,565,1112,1646,1095,549,0,poisson-block-composition-pa
166,sp_workloads,1690805680,wl_big_mem,61,basic:GM-LM-RR-LSVT-sub25100-defpa,2,ilp,block-composition-pa,poisson,equal-ncd,basic:GM-LM-RR-LSVT,sub25100,defpa,Unlocking,0.4,RandResponseMechanism,"{'Optimal': 39, 'TimeLimit': 1}",1714,1690,1723,34,340,1723,1680,1350,0,1714,1690,1723,34,340,1723,1680,1350,0,poisson-block-composition-pa
167,sp_workloads,1690805680,wl_big_mem,61,basic:GM-LM-RR-LSVT-sub25100-defpa,2,ilp,block-composition-pa,poisson,equal-ncd,basic:GM-LM-RR-LSVT,sub25100,defpa,Unlocking,0.4,SVTLaplaceMechanism,"{'Optimal': 39, 'TimeLimit': 1}",1631,1679,1700,32,296,1700,1599,1383,0,1631,1679,1700,32,296,1700,1599,1383,0,poisson-block-composition-pa
168,sp_workloads,1690805680,wl_big_mem,64,basic:GM-LM-RR-LSVT-sub25100-defpa,3,ilp,block-composition-pa,poisson,ncd,basic:GM-LM-RR-LSVT,sub25100,defpa,Unlocking,0.2,GaussianMechanism,"{'Optimal': 39, 'TimeLimit': 1}",4431438,335185,30243,2444226,197460,25118,1987212,137725,5125,1636,1707,1661,788,1075,1394,848,632,267,poisson-block-composition-pa
169,sp_workloads,1690805680,wl_big_mem,64,basic:GM-LM-RR-LSVT-sub25100-defpa,3,ilp,block-composition-pa,poisson,ncd,basic:GM-LM-RR-LSVT,sub25100,defpa,Unlocking,0.2,LaplaceMechanism,"{'Optimal': 39, 'TimeLimit': 1}",4614241,302136,30909,1142098,109756,26599,3472143,192380,4310,1669,1590,1731,483,648,1497,1186,942,234,poisson-block-composition-pa
170,sp_workloads,1690805680,wl_big_mem,64,basic:GM-LM-RR-LSVT-sub25100-defpa,3,ilp,block-composition-pa,poisson,ncd,basic:GM-LM-RR-LSVT,sub25100,defpa,Unlocking,0.2,RandResponseMechanism,"{'Optimal': 39, 'TimeLimit': 1}",4710432,347409,29228,73684,10187,10301,4636748,337222,18927,1691,1685,1636,34,67,643,1657,1618,993,poisson-block-composition-pa
171,sp_workloads,1690805680,wl_big_mem,64,basic:GM-LM-RR-LSVT-sub25100-defpa,3,ilp,block-composition-pa,poisson,ncd,basic:GM-LM-RR-LSVT,sub25100,defpa,Unlocking,0.2,SVTLaplaceMechanism,"{'Optimal': 39, 'TimeLimit': 1}",4781445,315437,29779,70787,8631,8626,4710658,306806,21153,1697,1624,1645,31,58,542,1666,1566,1103,poisson-block-composition-pa
172,sp_workloads,1690805680,wl_big_mem,65,basic:GM-LM-RR-LSVT-sub25100-defpa,3,ilp,block-composition-pa,poisson,ncd,basic:GM-LM-RR-LSVT,sub25100,defpa,Unlocking,0.4,GaussianMechanism,"{'Optimal': 39, 'TimeLimit': 1}",4431438,335185,30243,2378474,225622,25912,2052964,109563,4331,1636,1707,1661,831,1149,1432,805,558,229,poisson-block-composition-pa
173,sp_workloads,1690805680,wl_big_mem,65,basic:GM-LM-RR-LSVT-sub25100-defpa,3,ilp,block-composition-pa,poisson,ncd,basic:GM-LM-RR-LSVT,sub25100,defpa,Unlocking,0.4,LaplaceMechanism,"{'Optimal': 39, 'TimeLimit': 1}",4614241,302136,30909,1654311,106468,27364,2959930,195668,3545,1669,1590,1731,577,659,1532,1092,931,199,poisson-block-composition-pa
174,sp_workloads,1690805680,wl_big_mem,65,basic:GM-LM-RR-LSVT-sub25100-defpa,3,ilp,block-composition-pa,poisson,ncd,basic:GM-LM-RR-LSVT,sub25100,defpa,Unlocking,0.4,RandResponseMechanism,"{'Optimal': 39, 'TimeLimit': 1}",4710432,347409,29228,135963,9539,11964,4574469,337870,17264,1691,1685,1636,39,62,740,1652,1623,896,poisson-block-composition-pa
175,sp_workloads,1690805680,wl_big_mem,65,basic:GM-LM-RR-LSVT-sub25100-defpa,3,ilp,block-composition-pa,poisson,ncd,basic:GM-LM-RR-LSVT,sub25100,defpa,Unlocking,0.4,SVTLaplaceMechanism,"{'Optimal': 39, 'TimeLimit': 1}",4781445,315437,29779,148022,10238,10534,4633423,305199,19245,1697,1624,1645,48,65,650,1649,1559,995,poisson-block-composition-pa
176,sp_workloads,1690805680,wl_big_mem,68,basic:GM-LM-RR-LSVT-sub25100-defpa,3,ilp,block-composition-pa,poisson,equal-ncd,basic:GM-LM-RR-LSVT,sub25100,defpa,Unlocking,0.2,GaussianMechanism,"{'Optimal': 39, 'TimeLimit': 1}",1636,1707,1661,794,1660,1661,842,47,0,1636,1707,1661,794,1660,1661,842,47,0,poisson-block-composition-pa
177,sp_workloads,1690805680,wl_big_mem,68,basic:GM-LM-RR-LSVT-sub25100-defpa,3,ilp,block-composition-pa,poisson,equal-ncd,basic:GM-LM-RR-LSVT,sub25100,defpa,Unlocking,0.2,LaplaceMechanism,"{'Optimal': 39, 'TimeLimit': 1}",1669,1590,1731,553,1012,1731,1116,578,0,1669,1590,1731,553,1012,1731,1116,578,0,poisson-block-composition-pa
178,sp_workloads,1690805680,wl_big_mem,68,basic:GM-LM-RR-LSVT-sub25100-defpa,3,ilp,block-composition-pa,poisson,equal-ncd,basic:GM-LM-RR-LSVT,sub25100,defpa,Unlocking,0.2,RandResponseMechanism,"{'Optimal': 39, 'TimeLimit': 1}",1691,1685,1636,27,306,1636,1664,1379,0,1691,1685,1636,27,306,1636,1664,1379,0,poisson-block-composition-pa
179,sp_workloads,1690805680,wl_big_mem,68,basic:GM-LM-RR-LSVT-sub25100-defpa,3,ilp,block-composition-pa,poisson,equal-ncd,basic:GM-LM-RR-LSVT,sub25100,defpa,Unlocking,0.2,SVTLaplaceMechanism,"{'Optimal': 39, 'TimeLimit': 1}",1697,1624,1645,37,293,1645,1660,1331,0,1697,1624,1645,37,293,1645,1660,1331,0,poisson-block-composition-pa
180,sp_workloads,1690805680,wl_big_mem,69,basic:GM-LM-RR-LSVT-sub25100-defpa,3,ilp,block-composition-pa,poisson,equal-ncd,basic:GM-LM-RR-LSVT,sub25100,defpa,Unlocking,0.4,GaussianMechanism,"{'Optimal': 39, 'TimeLimit': 1}",1636,1707,1661,792,1643,1661,844,64,0,1636,1707,1661,792,1643,1661,844,64,0,poisson-block-composition-pa
181,sp_workloads,1690805680,wl_big_mem,69,basic:GM-LM-RR-LSVT-sub25100-defpa,3,ilp,block-composition-pa,poisson,equal-ncd,basic:GM-LM-RR-LSVT,sub25100,defpa,Unlocking,0.4,LaplaceMechanism,"{'Optimal': 39, 'TimeLimit': 1}",1669,1590,1731,559,1064,1731,1110,526,0,1669,1590,1731,559,1064,1731,1110,526,0,poisson-block-composition-pa
182,sp_workloads,1690805680,wl_big_mem,69,basic:GM-LM-RR-LSVT-sub25100-defpa,3,ilp,block-composition-pa,poisson,equal-ncd,basic:GM-LM-RR-LSVT,sub25100,defpa,Unlocking,0.4,RandResponseMechanism,"{'Optimal': 39, 'TimeLimit': 1}",1691,1685,1636,33,326,1635,1658,1359,1,1691,1685,1636,33,326,1635,1658,1359,1,poisson-block-composition-pa
183,sp_workloads,1690805680,wl_big_mem,69,basic:GM-LM-RR-LSVT-sub25100-defpa,3,ilp,block-composition-pa,poisson,equal-ncd,basic:GM-LM-RR-LSVT,sub25100,defpa,Unlocking,0.4,SVTLaplaceMechanism,"{'Optimal': 39, 'TimeLimit': 1}",1697,1624,1645,42,293,1645,1655,1331,0,1697,1624,1645,42,293,1645,1655,1331,0,poisson-block-composition-pa
184,sp_workloads,1690805680,wl_big_mem,72,basic:GM-LM-RR-LSVT-sub25100-defpa,4,ilp,block-composition-pa,poisson,ncd,basic:GM-LM-RR-LSVT,sub25100,defpa,Unlocking,0.2,GaussianMechanism,"{'Optimal': 39, 'TimeLimit': 1}",4571824,341651,31424,2508499,214501,25744,2063325,127150,5680,1667,1683,1652,796,1095,1369,871,588,283,poisson-block-composition-pa
185,sp_workloads,1690805680,wl_big_mem,72,basic:GM-LM-RR-LSVT-sub25100-defpa,4,ilp,block-composition-pa,poisson,ncd,basic:GM-LM-RR-LSVT,sub25100,defpa,Unlocking,0.2,LaplaceMechanism,"{'Optimal': 39, 'TimeLimit': 1}",4559498,310728,31904,1135992,106651,26672,3423506,204077,5232,1705,1675,1674,507,677,1423,1198,998,251,poisson-block-composition-pa
186,sp_workloads,1690805680,wl_big_mem,72,basic:GM-LM-RR-LSVT-sub25100-defpa,4,ilp,block-composition-pa,poisson,ncd,basic:GM-LM-RR-LSVT,sub25100,defpa,Unlocking,0.2,RandResponseMechanism,"{'Optimal': 39, 'TimeLimit': 1}",4915555,321907,33248,81396,7253,10496,4834159,314654,22752,1732,1682,1739,32,52,612,1700,1630,1127,poisson-block-composition-pa
187,sp_workloads,1690805680,wl_big_mem,72,basic:GM-LM-RR-LSVT-sub25100-defpa,4,ilp,block-composition-pa,poisson,ncd,basic:GM-LM-RR-LSVT,sub25100,defpa,Unlocking,0.2,SVTLaplaceMechanism,"{'Optimal': 39, 'TimeLimit': 1}",4827443,310825,33008,79675,7428,9264,4747768,303397,23744,1701,1631,1753,33,58,550,1668,1573,1203,poisson-block-composition-pa
188,sp_workloads,1690805680,wl_big_mem,73,basic:GM-LM-RR-LSVT-sub25100-defpa,4,ilp,block-composition-pa,poisson,ncd,basic:GM-LM-RR-LSVT,sub25100,defpa,Unlocking,0.4,GaussianMechanism,"{'Optimal': 39, 'TimeLimit': 1}",4571824,341651,31424,2412806,233938,27136,2159018,107713,4288,1667,1683,1652,853,1184,1428,814,499,224,poisson-block-composition-pa
189,sp_workloads,1690805680,wl_big_mem,73,basic:GM-LM-RR-LSVT-sub25100-defpa,4,ilp,block-composition-pa,poisson,ncd,basic:GM-LM-RR-LSVT,sub25100,defpa,Unlocking,0.4,LaplaceMechanism,"{'Optimal': 39, 'TimeLimit': 1}",4559498,310728,31904,1626382,103718,28384,2933116,207010,3520,1705,1675,1674,589,690,1496,1116,985,178,poisson-block-composition-pa
190,sp_workloads,1690805680,wl_big_mem,73,basic:GM-LM-RR-LSVT-sub25100-defpa,4,ilp,block-composition-pa,poisson,ncd,basic:GM-LM-RR-LSVT,sub25100,defpa,Unlocking,0.4,RandResponseMechanism,"{'Optimal': 39, 'TimeLimit': 1}",4915555,321907,33248,128618,6244,14480,4786937,315663,18768,1732,1682,1739,51,44,847,1681,1638,892,poisson-block-composition-pa
191,sp_workloads,1690805680,wl_big_mem,73,basic:GM-LM-RR-LSVT-sub25100-defpa,4,ilp,block-composition-pa,poisson,ncd,basic:GM-LM-RR-LSVT,sub25100,defpa,Unlocking,0.4,SVTLaplaceMechanism,"{'Optimal': 39, 'TimeLimit': 1}",4827443,310825,33008,139865,10281,12896,4687578,300544,20112,1701,1631,1753,48,56,770,1653,1575,983,poisson-block-composition-pa
192,sp_workloads,1690805680,wl_big_mem,76,basic:GM-LM-RR-LSVT-sub25100-defpa,4,ilp,block-composition-pa,poisson,equal-ncd,basic:GM-LM-RR-LSVT,sub25100,defpa,Unlocking,0.2,GaussianMechanism,"{'Optimal': 39, 'TimeLimit': 1}",1667,1683,1652,818,1636,1652,849,47,0,1667,1683,1652,818,1636,1652,849,47,0,poisson-block-composition-pa
193,sp_workloads,1690805680,wl_big_mem,76,basic:GM-LM-RR-LSVT-sub25100-defpa,4,ilp,block-composition-pa,poisson,equal-ncd,basic:GM-LM-RR-LSVT,sub25100,defpa,Unlocking,0.2,LaplaceMechanism,"{'Optimal': 39, 'TimeLimit': 1}",1705,1675,1674,576,1033,1674,1129,642,0,1705,1675,1674,576,1033,1674,1129,642,0,poisson-block-composition-pa
194,sp_workloads,1690805680,wl_big_mem,76,basic:GM-LM-RR-LSVT-sub25100-defpa,4,ilp,block-composition-pa,poisson,equal-ncd,basic:GM-LM-RR-LSVT,sub25100,defpa,Unlocking,0.2,RandResponseMechanism,"{'Optimal': 39, 'TimeLimit': 1}",1732,1682,1739,31,285,1739,1701,1397,0,1732,1682,1739,31,285,1739,1701,1397,0,poisson-block-composition-pa
195,sp_workloads,1690805680,wl_big_mem,76,basic:GM-LM-RR-LSVT-sub25100-defpa,4,ilp,block-composition-pa,poisson,equal-ncd,basic:GM-LM-RR-LSVT,sub25100,defpa,Unlocking,0.2,SVTLaplaceMechanism,"{'Optimal': 39, 'TimeLimit': 1}",1701,1631,1753,28,307,1752,1673,1324,1,1701,1631,1753,28,307,1752,1673,1324,1,poisson-block-composition-pa
196,sp_workloads,1690805680,wl_big_mem,77,basic:GM-LM-RR-LSVT-sub25100-defpa,4,ilp,block-composition-pa,poisson,equal-ncd,basic:GM-LM-RR-LSVT,sub25100,defpa,Unlocking,0.4,GaussianMechanism,"{'Optimal': 39, 'TimeLimit': 1}",1667,1683,1652,819,1635,1652,848,48,0,1667,1683,1652,819,1635,1652,848,48,0,poisson-block-composition-pa
197,sp_workloads,1690805680,wl_big_mem,77,basic:GM-LM-RR-LSVT-sub25100-defpa,4,ilp,block-composition-pa,poisson,equal-ncd,basic:GM-LM-RR-LSVT,sub25100,defpa,Unlocking,0.4,LaplaceMechanism,"{'Optimal': 39, 'TimeLimit': 1}",1705,1675,1674,595,1074,1673,1110,601,1,1705,1675,1674,595,1074,1673,1110,601,1,poisson-block-composition-pa
198,sp_workloads,1690805680,wl_big_mem,77,basic:GM-LM-RR-LSVT-sub25100-defpa,4,ilp,block-composition-pa,poisson,equal-ncd,basic:GM-LM-RR-LSVT,sub25100,defpa,Unlocking,0.4,RandResponseMechanism,"{'Optimal': 39, 'TimeLimit': 1}",1732,1682,1739,33,284,1739,1699,1398,0,1732,1682,1739,33,284,1739,1699,1398,0,poisson-block-composition-pa
199,sp_workloads,1690805680,wl_big_mem,77,basic:GM-LM-RR-LSVT-sub25100-defpa,4,ilp,block-composition-pa,poisson,equal-ncd,basic:GM-LM-RR-LSVT,sub25100,defpa,Unlocking,0.4,SVTLaplaceMechanism,"{'Optimal': 39, 'TimeLimit': 1}",1701,1631,1753,38,320,1753,1663,1311,0,1701,1631,1753,38,320,1753,1663,1311,0,poisson-block-composition-pa
200,sp_workloads,1690805680,wl_small_mem,0,gm:GM-sub25100-defpa,0,greedy,block-composition,poisson,ncd,gm:GM,sub25100,nopa,Unlocking,0.2,GaussianMechanism,{'Optimal': 40},18864461,1345041,130912,254722,76129,14496,18609739,1268912,116416,6716,6728,6904,191,433,811,6525,6295,6093,poisson-block-composition
201,sp_workloads,1690805680,wl_small_mem,1,gm:GM-sub25100-defpa,0,greedy,block-composition,poisson,ncd,gm:GM,sub25100,nopa,Unlocking,0.4,GaussianMechanism,{'Optimal': 40},18864461,1345041,130912,257992,70678,14128,18606469,1274363,116784,6716,6728,6904,174,404,793,6542,6324,6111,poisson-block-composition
202,sp_workloads,1690805680,wl_small_mem,2,gm:GM-sub25100-defpa,0,greedy,block-composition,upc,ncd,gm:GM,sub25100,nopa,Unlocking,0.2,GaussianMechanism,{'Optimal': 40},18893588,1315647,124584,107203,78390,28718,18786385,1237257,95866,6716,6728,6904,99,749,1826,6617,5979,5078,upc-block-composition
203,sp_workloads,1690805680,wl_small_mem,3,gm:GM-sub25100-defpa,0,greedy,block-composition,upc,ncd,gm:GM,sub25100,nopa,Unlocking,0.4,GaussianMechanism,{'Optimal': 40},18893588,1315647,124584,109239,75569,29861,18784349,1240078,94723,6716,6728,6904,101,642,1883,6615,6086,5021,upc-block-composition
204,sp_workloads,1690805680,wl_small_mem,4,gm:GM-sub25100-defpa,0,greedy,block-composition,poisson,equal-ncd,gm:GM,sub25100,nopa,Unlocking,0.2,GaussianMechanism,{'Optimal': 40},6716,6728,6904,191,433,811,6525,6295,6093,6716,6728,6904,191,433,811,6525,6295,6093,poisson-block-composition
205,sp_workloads,1690805680,wl_small_mem,5,gm:GM-sub25100-defpa,0,greedy,block-composition,poisson,equal-ncd,gm:GM,sub25100,nopa,Unlocking,0.4,GaussianMechanism,{'Optimal': 40},6716,6728,6904,174,404,793,6542,6324,6111,6716,6728,6904,174,404,793,6542,6324,6111,poisson-block-composition
206,sp_workloads,1690805680,wl_small_mem,6,gm:GM-sub25100-defpa,0,greedy,block-composition,upc,equal-ncd,gm:GM,sub25100,nopa,Unlocking,0.2,GaussianMechanism,{'Optimal': 40},6716,6728,6904,99,749,1826,6617,5979,5078,6716,6728,6904,99,749,1826,6617,5979,5078,upc-block-composition
207,sp_workloads,1690805680,wl_small_mem,7,gm:GM-sub25100-defpa,0,greedy,block-composition,upc,equal-ncd,gm:GM,sub25100,nopa,Unlocking,0.4,GaussianMechanism,{'Optimal': 40},6716,6728,6904,101,642,1883,6615,6086,5021,6716,6728,6904,101,642,1883,6615,6086,5021,upc-block-composition
208,sp_workloads,1690805680,wl_small_mem,8,gm:GM-sub25100-defpa,1,greedy,block-composition,poisson,ncd,gm:GM,sub25100,nopa,Unlocking,0.2,GaussianMechanism,{'Optimal': 40},18715267,1320958,128176,302397,57749,15520,18412870,1263209,112656,6673,6765,6731,191,399,873,6482,6366,5858,poisson-block-composition
209,sp_workloads,1690805680,wl_small_mem,9,gm:GM-sub25100-defpa,1,greedy,block-composition,poisson,ncd,gm:GM,sub25100,nopa,Unlocking,0.4,GaussianMechanism,{'Optimal': 40},18715267,1320958,128176,300175,53634,13328,18415092,1267324,114848,6673,6765,6731,173,355,755,6500,6410,5976,poisson-block-composition
210,sp_workloads,1690805680,wl_small_mem,10,gm:GM-sub25100-defpa,1,greedy,block-composition,upc,ncd,gm:GM,sub25100,nopa,Unlocking,0.2,GaussianMechanism,{'Optimal': 40},18728783,1307738,120469,122414,74373,27996,18606369,1233365,92473,6673,6765,6731,100,744,1764,6573,6021,4967,upc-block-composition
211,sp_workloads,1690805680,wl_small_mem,11,gm:GM-sub25100-defpa,1,greedy,block-composition,upc,ncd,gm:GM,sub25100,nopa,Unlocking,0.4,GaussianMechanism,{'Optimal': 40},18728783,1307738,120469,122429,74824,31844,18606354,1232914,88625,6673,6765,6731,101,646,1996,6572,6119,4735,upc-block-composition
212,sp_workloads,1690805680,wl_small_mem,12,gm:GM-sub25100-defpa,1,greedy,block-composition,poisson,equal-ncd,gm:GM,sub25100,nopa,Unlocking,0.2,GaussianMechanism,{'Optimal': 40},6673,6765,6731,191,399,873,6482,6366,5858,6673,6765,6731,191,399,873,6482,6366,5858,poisson-block-composition
213,sp_workloads,1690805680,wl_small_mem,13,gm:GM-sub25100-defpa,1,greedy,block-composition,poisson,equal-ncd,gm:GM,sub25100,nopa,Unlocking,0.4,GaussianMechanism,{'Optimal': 40},6673,6765,6731,173,355,755,6500,6410,5976,6673,6765,6731,173,355,755,6500,6410,5976,poisson-block-composition
214,sp_workloads,1690805680,wl_small_mem,14,gm:GM-sub25100-defpa,1,greedy,block-composition,upc,equal-ncd,gm:GM,sub25100,nopa,Unlocking,0.2,GaussianMechanism,{'Optimal': 40},6673,6765,6731,100,744,1764,6573,6021,4967,6673,6765,6731,100,744,1764,6573,6021,4967,upc-block-composition
215,sp_workloads,1690805680,wl_small_mem,15,gm:GM-sub25100-defpa,1,greedy,block-composition,upc,equal-ncd,gm:GM,sub25100,nopa,Unlocking,0.4,GaussianMechanism,{'Optimal': 40},6673,6765,6731,101,646,1996,6572,6119,4735,6673,6765,6731,101,646,1996,6572,6119,4735,upc-block-composition
216,sp_workloads,1690805680,wl_small_mem,16,gm:GM-sub25100-defpa,2,greedy,block-composition,poisson,ncd,gm:GM,sub25100,nopa,Unlocking,0.2,GaussianMechanism,{'Optimal': 40},18806374,1355979,126784,233695,74108,12816,18572679,1281871,113968,6783,6833,6678,185,424,720,6598,6409,5958,poisson-block-composition
217,sp_workloads,1690805680,wl_small_mem,17,gm:GM-sub25100-defpa,2,greedy,block-composition,poisson,ncd,gm:GM,sub25100,nopa,Unlocking,0.4,GaussianMechanism,{'Optimal': 40},18806374,1355979,126784,251345,64669,14496,18555029,1291310,112288,6783,6833,6678,170,391,819,6613,6442,5859,poisson-block-composition
218,sp_workloads,1690805680,wl_small_mem,18,gm:GM-sub25100-defpa,2,greedy,block-composition,upc,ncd,gm:GM,sub25100,nopa,Unlocking,0.2,GaussianMechanism,{'Optimal': 40},18840947,1320526,120650,117150,75041,27346,18723797,1245485,93304,6783,6833,6678,95,789,1742,6688,6044,4936,upc-block-composition
219,sp_workloads,1690805680,wl_small_mem,19,gm:GM-sub25100-defpa,2,greedy,block-composition,upc,ncd,gm:GM,sub25100,nopa,Unlocking,0.4,GaussianMechanism,{'Optimal': 40},18840947,1320526,120650,125744,73259,29223,18715203,1247267,91427,6783,6833,6678,102,607,1833,6681,6226,4845,upc-block-composition
220,sp_workloads,1690805680,wl_small_mem,20,gm:GM-sub25100-defpa,2,greedy,block-composition,poisson,equal-ncd,gm:GM,sub25100,nopa,Unlocking,0.2,GaussianMechanism,{'Optimal': 40},6783,6833,6678,185,424,720,6598,6409,5958,6783,6833,6678,185,424,720,6598,6409,5958,poisson-block-composition
221,sp_workloads,1690805680,wl_small_mem,21,gm:GM-sub25100-defpa,2,greedy,block-composition,poisson,equal-ncd,gm:GM,sub25100,nopa,Unlocking,0.4,GaussianMechanism,{'Optimal': 40},6783,6833,6678,170,391,819,6613,6442,5859,6783,6833,6678,170,391,819,6613,6442,5859,poisson-block-composition
222,sp_workloads,1690805680,wl_small_mem,22,gm:GM-sub25100-defpa,2,greedy,block-composition,upc,equal-ncd,gm:GM,sub25100,nopa,Unlocking,0.2,GaussianMechanism,{'Optimal': 40},6783,6833,6678,95,789,1742,6688,6044,4936,6783,6833,6678,95,789,1742,6688,6044,4936,upc-block-composition
223,sp_workloads,1690805680,wl_small_mem,23,gm:GM-sub25100-defpa,2,greedy,block-composition,upc,equal-ncd,gm:GM,sub25100,nopa,Unlocking,0.4,GaussianMechanism,{'Optimal': 40},6783,6833,6678,102,607,1833,6681,6226,4845,6783,6833,6678,102,607,1833,6681,6226,4845,upc-block-composition
224,sp_workloads,1690805680,wl_small_mem,24,gm:GM-sub25100-defpa,3,greedy,block-composition,poisson,ncd,gm:GM,sub25100,nopa,Unlocking,0.2,GaussianMechanism,{'Optimal': 40},18672541,1292482,118587,264537,55686,13183,18408004,1236796,105404,6771,6693,6629,162,377,785,6609,6316,5844,poisson-block-composition
225,sp_workloads,1690805680,wl_small_mem,25,gm:GM-sub25100-defpa,3,greedy,block-composition,poisson,ncd,gm:GM,sub25100,nopa,Unlocking,0.4,GaussianMechanism,{'Optimal': 40},18672541,1292482,118587,282336,58254,11834,18390205,1234228,106753,6771,6693,6629,170,370,710,6601,6323,5919,poisson-block-composition
226,sp_workloads,1690805680,wl_small_mem,26,gm:GM-sub25100-defpa,3,greedy,block-composition,upc,ncd,gm:GM,sub25100,nopa,Unlocking,0.2,GaussianMechanism,{'Optimal': 40},18653277,1308064,119435,107408,76495,29475,18545869,1231569,89960,6771,6693,6629,98,731,1853,6673,5962,4776,upc-block-composition
227,sp_workloads,1690805680,wl_small_mem,27,gm:GM-sub25100-defpa,3,greedy,block-composition,upc,ncd,gm:GM,sub25100,nopa,Unlocking,0.4,GaussianMechanism,{'Optimal': 40},18653277,1308064,119435,110759,76840,28368,18542518,1231224,91067,6771,6693,6629,102,634,1792,6669,6059,4837,upc-block-composition
228,sp_workloads,1690805680,wl_small_mem,28,gm:GM-sub25100-defpa,3,greedy,block-composition,poisson,equal-ncd,gm:GM,sub25100,nopa,Unlocking,0.2,GaussianMechanism,{'Optimal': 40},6771,6693,6629,162,377,785,6609,6316,5844,6771,6693,6629,162,377,785,6609,6316,5844,poisson-block-composition
229,sp_workloads,1690805680,wl_small_mem,29,gm:GM-sub25100-defpa,3,greedy,block-composition,poisson,equal-ncd,gm:GM,sub25100,nopa,Unlocking,0.4,GaussianMechanism,{'Optimal': 40},6771,6693,6629,170,370,710,6601,6323,5919,6771,6693,6629,170,370,710,6601,6323,5919,poisson-block-composition
230,sp_workloads,1690805680,wl_small_mem,30,gm:GM-sub25100-defpa,3,greedy,block-composition,upc,equal-ncd,gm:GM,sub25100,nopa,Unlocking,0.2,GaussianMechanism,{'Optimal': 40},6771,6693,6629,98,731,1853,6673,5962,4776,6771,6693,6629,98,731,1853,6673,5962,4776,upc-block-composition
231,sp_workloads,1690805680,wl_small_mem,31,gm:GM-sub25100-defpa,3,greedy,block-composition,upc,equal-ncd,gm:GM,sub25100,nopa,Unlocking,0.4,GaussianMechanism,{'Optimal': 40},6771,6693,6629,102,634,1792,6669,6059,4837,6771,6693,6629,102,634,1792,6669,6059,4837,upc-block-composition
232,sp_workloads,1690805680,wl_small_mem,32,gm:GM-sub25100-defpa,4,greedy,block-composition,poisson,ncd,gm:GM,sub25100,nopa,Unlocking,0.2,GaussianMechanism,{'Optimal': 40},18857452,1277663,120343,257430,78771,15275,18600022,1198892,105068,6862,6691,6713,180,480,901,6682,6211,5812,poisson-block-composition
233,sp_workloads,1690805680,wl_small_mem,33,gm:GM-sub25100-defpa,4,greedy,block-composition,poisson,ncd,gm:GM,sub25100,nopa,Unlocking,0.4,GaussianMechanism,{'Optimal': 40},18857452,1277663,120343,265033,65309,13154,18592419,1212354,107189,6862,6691,6713,165,411,782,6697,6280,5931,poisson-block-composition
234,sp_workloads,1690805680,wl_small_mem,34,gm:GM-sub25100-defpa,4,greedy,block-composition,upc,ncd,gm:GM,sub25100,nopa,Unlocking,0.2,GaussianMechanism,{'Optimal': 40},18854676,1280656,121591,111127,79866,28674,18743549,1200790,92917,6862,6691,6713,91,817,1822,6771,5874,4891,upc-block-composition
235,sp_workloads,1690805680,wl_small_mem,35,gm:GM-sub25100-defpa,4,greedy,block-composition,upc,ncd,gm:GM,sub25100,nopa,Unlocking,0.4,GaussianMechanism,{'Optimal': 40},18854676,1280656,121591,127174,70332,28774,18727502,1210324,92817,6862,6691,6713,102,668,1802,6760,6023,4911,upc-block-composition
236,sp_workloads,1690805680,wl_small_mem,36,gm:GM-sub25100-defpa,4,greedy,block-composition,poisson,equal-ncd,gm:GM,sub25100,nopa,Unlocking,0.2,GaussianMechanism,{'Optimal': 40},6862,6691,6713,180,480,901,6682,6211,5812,6862,6691,6713,180,480,901,6682,6211,5812,poisson-block-composition
237,sp_workloads,1690805680,wl_small_mem,37,gm:GM-sub25100-defpa,4,greedy,block-composition,poisson,equal-ncd,gm:GM,sub25100,nopa,Unlocking,0.4,GaussianMechanism,{'Optimal': 40},6862,6691,6713,165,411,782,6697,6280,5931,6862,6691,6713,165,411,782,6697,6280,5931,poisson-block-composition
238,sp_workloads,1690805680,wl_small_mem,38,gm:GM-sub25100-defpa,4,greedy,block-composition,upc,equal-ncd,gm:GM,sub25100,nopa,Unlocking,0.2,GaussianMechanism,{'Optimal': 40},6862,6691,6713,91,817,1822,6771,5874,4891,6862,6691,6713,91,817,1822,6771,5874,4891,upc-block-composition
239,sp_workloads,1690805680,wl_small_mem,39,gm:GM-sub25100-defpa,4,greedy,block-composition,upc,equal-ncd,gm:GM,sub25100,nopa,Unlocking,0.4,GaussianMechanism,{'Optimal': 40},6862,6691,6713,102,668,1802,6760,6023,4911,6862,6691,6713,102,668,1802,6760,6023,4911,upc-block-composition
240,sp_workloads,1690805680,wl_small_mem,40,ml:SGD-PATE-sub25100-defpa,0,greedy,block-composition,poisson,ncd,ml:SGD-PATE,sub25100,nopa,Unlocking,0.2,MLNoisySGDMechanism,{'Optimal': 40},9320337,647144,60780,171430,26587,5100,9148907,620557,55680,3347,3348,3392,80,177,305,3267,3171,3087,poisson-block-composition
241,sp_workloads,1690805680,wl_small_mem,40,ml:SGD-PATE-sub25100-defpa,0,greedy,block-composition,poisson,ncd,ml:SGD-PATE,sub25100,nopa,Unlocking,0.2,MLPateGaussianMechanism,{'Optimal': 40},9560711,630849,59490,101492,25522,5985,9459219,605327,53505,3488,3389,3328,67,141,364,3421,3248,2964,poisson-block-composition
242,sp_workloads,1690805680,wl_small_mem,41,ml:SGD-PATE-sub25100-defpa,0,greedy,block-composition,poisson,ncd,ml:SGD-PATE,sub25100,nopa,Unlocking,0.4,MLNoisySGDMechanism,{'Optimal': 40},9320337,647144,60780,149123,30813,5610,9171214,616331,55170,3347,3348,3392,86,184,339,3261,3164,3053,poisson-block-composition
243,sp_workloads,1690805680,wl_small_mem,41,ml:SGD-PATE-sub25100-defpa,0,greedy,block-composition,poisson,ncd,ml:SGD-PATE,sub25100,nopa,Unlocking,0.4,MLPateGaussianMechanism,{'Optimal': 40},9560711,630849,59490,126845,27389,6360,9433866,603460,53130,3488,3389,3328,76,150,389,3412,3239,2939,poisson-block-composition
244,sp_workloads,1690805680,wl_small_mem,42,ml:SGD-PATE-sub25100-defpa,0,greedy,block-composition,upc,ncd,ml:SGD-PATE,sub25100,nopa,Unlocking,0.2,MLNoisySGDMechanism,{'Optimal': 40},9083039,636185,61248,118677,29095,10907,8964362,607090,50341,3347,3348,3392,90,293,693,3257,3055,2699,upc-block-composition
245,sp_workloads,1690805680,wl_small_mem,42,ml:SGD-PATE-sub25100-defpa,0,greedy,block-composition,upc,ncd,ml:SGD-PATE,sub25100,nopa,Unlocking,0.2,MLPateGaussianMechanism,{'Optimal': 40},9794725,645631,60352,74548,28066,11460,9720177,617565,48892,3488,3389,3328,52,252,716,3436,3137,2612,upc-block-composition
246,sp_workloads,1690805680,wl_small_mem,43,ml:SGD-PATE-sub25100-defpa,0,greedy,block-composition,upc,ncd,ml:SGD-PATE,sub25100,nopa,Unlocking,0.4,MLNoisySGDMechanism,{'Optimal': 40},9083039,636185,61248,102214,35175,13312,8980825,601010,47936,3347,3348,3392,91,339,848,3256,3009,2544,upc-block-composition
247,sp_workloads,1690805680,wl_small_mem,43,ml:SGD-PATE-sub25100-defpa,0,greedy,block-composition,upc,ncd,ml:SGD-PATE,sub25100,nopa,Unlocking,0.4,MLPateGaussianMechanism,{'Optimal': 40},9794725,645631,60352,73309,29720,13266,9721416,615911,47086,3488,3389,3328,53,274,830,3435,3115,2498,upc-block-composition
248,sp_workloads,1690805680,wl_small_mem,44,ml:SGD-PATE-sub25100-defpa,0,greedy,block-composition,poisson,equal-ncd,ml:SGD-PATE,sub25100,nopa,Unlocking,0.2,MLNoisySGDMechanism,{'Optimal': 40},3347,3348,3392,80,177,305,3267,3171,3087,3347,3348,3392,80,177,305,3267,3171,3087,poisson-block-composition
249,sp_workloads,1690805680,wl_small_mem,44,ml:SGD-PATE-sub25100-defpa,0,greedy,block-composition,poisson,equal-ncd,ml:SGD-PATE,sub25100,nopa,Unlocking,0.2,MLPateGaussianMechanism,{'Optimal': 40},3488,3389,3328,67,141,364,3421,3248,2964,3488,3389,3328,67,141,364,3421,3248,2964,poisson-block-composition
250,sp_workloads,1690805680,wl_small_mem,45,ml:SGD-PATE-sub25100-defpa,0,greedy,block-composition,poisson,equal-ncd,ml:SGD-PATE,sub25100,nopa,Unlocking,0.4,MLNoisySGDMechanism,{'Optimal': 40},3347,3348,3392,86,184,339,3261,3164,3053,3347,3348,3392,86,184,339,3261,3164,3053,poisson-block-composition
251,sp_workloads,1690805680,wl_small_mem,45,ml:SGD-PATE-sub25100-defpa,0,greedy,block-composition,poisson,equal-ncd,ml:SGD-PATE,sub25100,nopa,Unlocking,0.4,MLPateGaussianMechanism,{'Optimal': 40},3488,3389,3328,76,150,389,3412,3239,2939,3488,3389,3328,76,150,389,3412,3239,2939,poisson-block-composition
252,sp_workloads,1690805680,wl_small_mem,46,ml:SGD-PATE-sub25100-defpa,0,greedy,block-composition,upc,equal-ncd,ml:SGD-PATE,sub25100,nopa,Unlocking,0.2,MLNoisySGDMechanism,{'Optimal': 40},3347,3348,3392,90,293,693,3257,3055,2699,3347,3348,3392,90,293,693,3257,3055,2699,upc-block-composition
253,sp_workloads,1690805680,wl_small_mem,46,ml:SGD-PATE-sub25100-defpa,0,greedy,block-composition,upc,equal-ncd,ml:SGD-PATE,sub25100,nopa,Unlocking,0.2,MLPateGaussianMechanism,{'Optimal': 40},3488,3389,3328,52,252,716,3436,3137,2612,3488,3389,3328,52,252,716,3436,3137,2612,upc-block-composition
254,sp_workloads,1690805680,wl_small_mem,47,ml:SGD-PATE-sub25100-defpa,0,greedy,block-composition,upc,equal-ncd,ml:SGD-PATE,sub25100,nopa,Unlocking,0.4,MLNoisySGDMechanism,{'Optimal': 40},3347,3348,3392,91,339,848,3256,3009,2544,3347,3348,3392,91,339,848,3256,3009,2544,upc-block-composition
255,sp_workloads,1690805680,wl_small_mem,47,ml:SGD-PATE-sub25100-defpa,0,greedy,block-composition,upc,equal-ncd,ml:SGD-PATE,sub25100,nopa,Unlocking,0.4,MLPateGaussianMechanism,{'Optimal': 40},3488,3389,3328,53,274,830,3435,3115,2498,3488,3389,3328,53,274,830,3435,3115,2498,upc-block-composition
256,sp_workloads,1690805680,wl_small_mem,48,ml:SGD-PATE-sub25100-defpa,1,greedy,block-composition,poisson,ncd,ml:SGD-PATE,sub25100,nopa,Unlocking,0.2,MLNoisySGDMechanism,{'Optimal': 40},9612014,638642,60437,137027,21793,6054,9474987,616849,54383,3436,3336,3371,85,172,362,3351,3164,3009,poisson-block-composition
257,sp_workloads,1690805680,wl_small_mem,48,ml:SGD-PATE-sub25100-defpa,1,greedy,block-composition,poisson,ncd,ml:SGD-PATE,sub25100,nopa,Unlocking,0.2,MLPateGaussianMechanism,{'Optimal': 40},9101816,660711,61026,149568,36906,6259,8952248,623805,54767,3337,3307,3358,76,210,349,3261,3097,3009,poisson-block-composition
258,sp_workloads,1690805680,wl_small_mem,49,ml:SGD-PATE-sub25100-defpa,1,greedy,block-composition,poisson,ncd,ml:SGD-PATE,sub25100,nopa,Unlocking,0.4,MLNoisySGDMechanism,{'Optimal': 40},9612014,638642,60437,122695,23523,5648,9489319,615119,54789,3436,3336,3371,89,173,336,3347,3163,3035,poisson-block-composition
259,sp_workloads,1690805680,wl_small_mem,49,ml:SGD-PATE-sub25100-defpa,1,greedy,block-composition,poisson,ncd,ml:SGD-PATE,sub25100,nopa,Unlocking,0.4,MLPateGaussianMechanism,{'Optimal': 40},9101816,660711,61026,176236,36156,5915,8925580,624555,55111,3337,3307,3358,90,212,341,3247,3095,3017,poisson-block-composition
260,sp_workloads,1690805680,wl_small_mem,50,ml:SGD-PATE-sub25100-defpa,1,greedy,block-composition,upc,ncd,ml:SGD-PATE,sub25100,nopa,Unlocking,0.2,MLNoisySGDMechanism,{'Optimal': 40},9248526,647648,60469,137607,27054,9767,9110919,620594,50702,3436,3336,3371,91,231,617,3345,3105,2754,upc-block-composition
261,sp_workloads,1690805680,wl_small_mem,50,ml:SGD-PATE-sub25100-defpa,1,greedy,block-composition,upc,ncd,ml:SGD-PATE,sub25100,nopa,Unlocking,0.2,MLPateGaussianMechanism,{'Optimal': 40},9470335,646016,60114,66729,27164,9254,9403606,618852,50860,3337,3307,3358,58,254,570,3279,3053,2788,upc-block-composition
262,sp_workloads,1690805680,wl_small_mem,51,ml:SGD-PATE-sub25100-defpa,1,greedy,block-composition,upc,ncd,ml:SGD-PATE,sub25100,nopa,Unlocking,0.4,MLNoisySGDMechanism,{'Optimal': 40},9248526,647648,60469,139625,29613,15900,9108901,618035,44569,3436,3336,3371,89,271,1012,3347,3065,2359,upc-block-composition
263,sp_workloads,1690805680,wl_small_mem,51,ml:SGD-PATE-sub25100-defpa,1,greedy,block-composition,upc,ncd,ml:SGD-PATE,sub25100,nopa,Unlocking,0.4,MLPateGaussianMechanism,{'Optimal': 40},9470335,646016,60114,63436,28882,15080,9406899,617134,45034,3337,3307,3358,57,304,952,3280,3003,2406,upc-block-composition
264,sp_workloads,1690805680,wl_small_mem,52,ml:SGD-PATE-sub25100-defpa,1,greedy,block-composition,poisson,equal-ncd,ml:SGD-PATE,sub25100,nopa,Unlocking,0.2,MLNoisySGDMechanism,{'Optimal': 40},3436,3336,3371,85,172,362,3351,3164,3009,3436,3336,3371,85,172,362,3351,3164,3009,poisson-block-composition
265,sp_workloads,1690805680,wl_small_mem,52,ml:SGD-PATE-sub25100-defpa,1,greedy,block-composition,poisson,equal-ncd,ml:SGD-PATE,sub25100,nopa,Unlocking,0.2,MLPateGaussianMechanism,{'Optimal': 40},3337,3307,3358,76,210,349,3261,3097,3009,3337,3307,3358,76,210,349,3261,3097,3009,poisson-block-composition
266,sp_workloads,1690805680,wl_small_mem,53,ml:SGD-PATE-sub25100-defpa,1,greedy,block-composition,poisson,equal-ncd,ml:SGD-PATE,sub25100,nopa,Unlocking,0.4,MLNoisySGDMechanism,{'Optimal': 40},3436,3336,3371,89,173,336,3347,3163,3035,3436,3336,3371,89,173,336,3347,3163,3035,poisson-block-composition
267,sp_workloads,1690805680,wl_small_mem,53,ml:SGD-PATE-sub25100-defpa,1,greedy,block-composition,poisson,equal-ncd,ml:SGD-PATE,sub25100,nopa,Unlocking,0.4,MLPateGaussianMechanism,{'Optimal': 40},3337,3307,3358,90,212,341,3247,3095,3017,3337,3307,3358,90,212,341,3247,3095,3017,poisson-block-composition
268,sp_workloads,1690805680,wl_small_mem,54,ml:SGD-PATE-sub25100-defpa,1,greedy,block-composition,upc,equal-ncd,ml:SGD-PATE,sub25100,nopa,Unlocking,0.2,MLNoisySGDMechanism,{'Optimal': 40},3436,3336,3371,91,231,617,3345,3105,2754,3436,3336,3371,91,231,617,3345,3105,2754,upc-block-composition
269,sp_workloads,1690805680,wl_small_mem,54,ml:SGD-PATE-sub25100-defpa,1,greedy,block-composition,upc,equal-ncd,ml:SGD-PATE,sub25100,nopa,Unlocking,0.2,MLPateGaussianMechanism,{'Optimal': 40},3337,3307,3358,58,254,570,3279,3053,2788,3337,3307,3358,58,254,570,3279,3053,2788,upc-block-composition
270,sp_workloads,1690805680,wl_small_mem,55,ml:SGD-PATE-sub25100-defpa,1,greedy,block-composition,upc,equal-ncd,ml:SGD-PATE,sub25100,nopa,Unlocking,0.4,MLNoisySGDMechanism,{'Optimal': 40},3436,3336,3371,89,271,1012,3347,3065,2359,3436,3336,3371,89,271,1012,3347,3065,2359,upc-block-composition
271,sp_workloads,1690805680,wl_small_mem,55,ml:SGD-PATE-sub25100-defpa,1,greedy,block-composition,upc,equal-ncd,ml:SGD-PATE,sub25100,nopa,Unlocking,0.4,MLPateGaussianMechanism,{'Optimal': 40},3337,3307,3358,57,304,952,3280,3003,2406,3337,3307,3358,57,304,952,3280,3003,2406,upc-block-composition
272,sp_workloads,1690805680,wl_small_mem,56,ml:SGD-PATE-sub25100-defpa,2,greedy,block-composition,poisson,ncd,ml:SGD-PATE,sub25100,nopa,Unlocking,0.2,MLNoisySGDMechanism,{'Optimal': 40},9102086,650387,61289,197815,27718,6262,8904271,622669,55027,3387,3344,3399,82,160,362,3305,3184,3037,poisson-block-composition
273,sp_workloads,1690805680,wl_small_mem,56,ml:SGD-PATE-sub25100-defpa,2,greedy,block-composition,poisson,ncd,ml:SGD-PATE,sub25100,nopa,Unlocking,0.2,MLPateGaussianMechanism,{'Optimal': 40},9667159,651460,60587,90970,22295,5746,9576189,629165,54841,3356,3340,3381,63,158,350,3293,3182,3031,poisson-block-composition
274,sp_workloads,1690805680,wl_small_mem,57,ml:SGD-PATE-sub25100-defpa,2,greedy,block-composition,poisson,ncd,ml:SGD-PATE,sub25100,nopa,Unlocking,0.4,MLNoisySGDMechanism,{'Optimal': 40},9102086,650387,61289,170012,33312,6379,8932074,617075,54910,3387,3344,3399,79,196,373,3308,3148,3026,poisson-block-composition
275,sp_workloads,1690805680,wl_small_mem,57,ml:SGD-PATE-sub25100-defpa,2,greedy,block-composition,poisson,ncd,ml:SGD-PATE,sub25100,nopa,Unlocking,0.4,MLPateGaussianMechanism,{'Optimal': 40},9667159,651460,60587,108610,29823,6023,9558549,621637,54564,3356,3340,3381,80,201,361,3276,3139,3020,poisson-block-composition
276,sp_workloads,1690805680,wl_small_mem,58,ml:SGD-PATE-sub25100-defpa,2,greedy,block-composition,upc,ncd,ml:SGD-PATE,sub25100,nopa,Unlocking,0.2,MLNoisySGDMechanism,{'Optimal': 40},9360300,635145,61577,172719,27495,10675,9187581,607650,50902,3387,3344,3399,95,259,669,3292,3085,2730,upc-block-composition
277,sp_workloads,1690805680,wl_small_mem,58,ml:SGD-PATE-sub25100-defpa,2,greedy,block-composition,upc,ncd,ml:SGD-PATE,sub25100,nopa,Unlocking,0.2,MLPateGaussianMechanism,{'Optimal': 40},9448947,628519,60475,57422,24484,10029,9391525,604035,50446,3356,3340,3381,54,245,627,3302,3095,2754,upc-block-composition
278,sp_workloads,1690805680,wl_small_mem,59,ml:SGD-PATE-sub25100-defpa,2,greedy,block-composition,upc,ncd,ml:SGD-PATE,sub25100,nopa,Unlocking,0.4,MLNoisySGDMechanism,{'Optimal': 40},9360300,635145,61577,119974,33294,13547,9240326,601851,48030,3387,3344,3399,82,318,853,3305,3026,2546,upc-block-composition
279,sp_workloads,1690805680,wl_small_mem,59,ml:SGD-PATE-sub25100-defpa,2,greedy,block-composition,upc,ncd,ml:SGD-PATE,sub25100,nopa,Unlocking,0.4,MLPateGaussianMechanism,{'Optimal': 40},9448947,628519,60475,64811,29481,12911,9384136,599038,47564,3356,3340,3381,59,327,817,3297,3013,2564,upc-block-composition
280,sp_workloads,1690805680,wl_small_mem,60,ml:SGD-PATE-sub25100-defpa,2,greedy,block-composition,poisson,equal-ncd,ml:SGD-PATE,sub25100,nopa,Unlocking,0.2,MLNoisySGDMechanism,{'Optimal': 40},3387,3344,3399,82,160,362,3305,3184,3037,3387,3344,3399,82,160,362,3305,3184,3037,poisson-block-composition
281,sp_workloads,1690805680,wl_small_mem,60,ml:SGD-PATE-sub25100-defpa,2,greedy,block-composition,poisson,equal-ncd,ml:SGD-PATE,sub25100,nopa,Unlocking,0.2,MLPateGaussianMechanism,{'Optimal': 40},3356,3340,3381,63,158,350,3293,3182,3031,3356,3340,3381,63,158,350,3293,3182,3031,poisson-block-composition
282,sp_workloads,1690805680,wl_small_mem,61,ml:SGD-PATE-sub25100-defpa,2,greedy,block-composition,poisson,equal-ncd,ml:SGD-PATE,sub25100,nopa,Unlocking,0.4,MLNoisySGDMechanism,{'Optimal': 40},3387,3344,3399,79,196,373,3308,3148,3026,3387,3344,3399,79,196,373,3308,3148,3026,poisson-block-composition
283,sp_workloads,1690805680,wl_small_mem,61,ml:SGD-PATE-sub25100-defpa,2,greedy,block-composition,poisson,equal-ncd,ml:SGD-PATE,sub25100,nopa,Unlocking,0.4,MLPateGaussianMechanism,{'Optimal': 40},3356,3340,3381,80,201,361,3276,3139,3020,3356,3340,3381,80,201,361,3276,3139,3020,poisson-block-composition
284,sp_workloads,1690805680,wl_small_mem,62,ml:SGD-PATE-sub25100-defpa,2,greedy,block-composition,upc,equal-ncd,ml:SGD-PATE,sub25100,nopa,Unlocking,0.2,MLNoisySGDMechanism,{'Optimal': 40},3387,3344,3399,95,259,669,3292,3085,2730,3387,3344,3399,95,259,669,3292,3085,2730,upc-block-composition
285,sp_workloads,1690805680,wl_small_mem,62,ml:SGD-PATE-sub25100-defpa,2,greedy,block-composition,upc,equal-ncd,ml:SGD-PATE,sub25100,nopa,Unlocking,0.2,MLPateGaussianMechanism,{'Optimal': 40},3356,3340,3381,54,245,627,3302,3095,2754,3356,3340,3381,54,245,627,3302,3095,2754,upc-block-composition
286,sp_workloads,1690805680,wl_small_mem,63,ml:SGD-PATE-sub25100-defpa,2,greedy,block-composition,upc,equal-ncd,ml:SGD-PATE,sub25100,nopa,Unlocking,0.4,MLNoisySGDMechanism,{'Optimal': 40},3387,3344,3399,82,318,853,3305,3026,2546,3387,3344,3399,82,318,853,3305,3026,2546,upc-block-composition
287,sp_workloads,1690805680,wl_small_mem,63,ml:SGD-PATE-sub25100-defpa,2,greedy,block-composition,upc,equal-ncd,ml:SGD-PATE,sub25100,nopa,Unlocking,0.4,MLPateGaussianMechanism,{'Optimal': 40},3356,3340,3381,59,327,817,3297,3013,2564,3356,3340,3381,59,327,817,3297,3013,2564,upc-block-composition
288,sp_workloads,1690805680,wl_small_mem,64,ml:SGD-PATE-sub25100-defpa,3,greedy,block-composition,poisson,ncd,ml:SGD-PATE,sub25100,nopa,Unlocking,0.2,MLNoisySGDMechanism,{'Optimal': 40},9538338,661542,60462,188863,27659,6109,9349475,633883,54353,3432,3504,3362,82,177,371,3350,3327,2991,poisson-block-composition
289,sp_workloads,1690805680,wl_small_mem,64,ml:SGD-PATE-sub25100-defpa,3,greedy,block-composition,poisson,ncd,ml:SGD-PATE,sub25100,nopa,Unlocking,0.2,MLPateGaussianMechanism,{'Optimal': 40},9431567,656376,60193,108109,28541,6325,9323458,627835,53868,3379,3400,3343,67,171,379,3312,3229,2964,poisson-block-composition
290,sp_workloads,1690805680,wl_small_mem,65,ml:SGD-PATE-sub25100-defpa,3,greedy,block-composition,poisson,ncd,ml:SGD-PATE,sub25100,nopa,Unlocking,0.4,MLNoisySGDMechanism,{'Optimal': 40},9538338,661542,60462,161083,31569,6105,9377255,629973,54357,3432,3504,3362,84,194,359,3348,3310,3003,poisson-block-composition
291,sp_workloads,1690805680,wl_small_mem,65,ml:SGD-PATE-sub25100-defpa,3,greedy,block-composition,poisson,ncd,ml:SGD-PATE,sub25100,nopa,Unlocking,0.4,MLPateGaussianMechanism,{'Optimal': 40},9431567,656376,60193,116892,33633,6268,9314675,622743,53925,3379,3400,3343,72,197,372,3307,3203,2971,poisson-block-composition
292,sp_workloads,1690805680,wl_small_mem,66,ml:SGD-PATE-sub25100-defpa,3,greedy,block-composition,upc,ncd,ml:SGD-PATE,sub25100,nopa,Unlocking,0.2,MLNoisySGDMechanism,{'Optimal': 40},9534421,712160,60142,148779,25393,10915,9385642,686767,49227,3432,3504,3362,100,239,685,3332,3265,2677,upc-block-composition
293,sp_workloads,1690805680,wl_small_mem,66,ml:SGD-PATE-sub25100-defpa,3,greedy,block-composition,upc,ncd,ml:SGD-PATE,sub25100,nopa,Unlocking,0.2,MLPateGaussianMechanism,{'Optimal': 40},9371673,665112,59809,44557,31676,10599,9327116,633436,49210,3379,3400,3343,51,260,665,3328,3140,2678,upc-block-composition
294,sp_workloads,1690805680,wl_small_mem,67,ml:SGD-PATE-sub25100-defpa,3,greedy,block-composition,upc,ncd,ml:SGD-PATE,sub25100,nopa,Unlocking,0.4,MLNoisySGDMechanism,{'Optimal': 40},9534421,712160,60142,114637,32790,13671,9419784,679370,46471,3432,3504,3362,93,298,857,3339,3206,2505,upc-block-composition
295,sp_workloads,1690805680,wl_small_mem,67,ml:SGD-PATE-sub25100-defpa,3,greedy,block-composition,upc,ncd,ml:SGD-PATE,sub25100,nopa,Unlocking,0.4,MLPateGaussianMechanism,{'Optimal': 40},9371673,665112,59809,48921,38680,13289,9322752,626432,46520,3379,3400,3343,55,312,839,3324,3088,2504,upc-block-composition
296,sp_workloads,1690805680,wl_small_mem,68,ml:SGD-PATE-sub25100-defpa,3,greedy,block-composition,poisson,equal-ncd,ml:SGD-PATE,sub25100,nopa,Unlocking,0.2,MLNoisySGDMechanism,{'Optimal': 40},3432,3504,3362,82,177,371,3350,3327,2991,3432,3504,3362,82,177,371,3350,3327,2991,poisson-block-composition
297,sp_workloads,1690805680,wl_small_mem,68,ml:SGD-PATE-sub25100-defpa,3,greedy,block-composition,poisson,equal-ncd,ml:SGD-PATE,sub25100,nopa,Unlocking,0.2,MLPateGaussianMechanism,{'Optimal': 40},3379,3400,3343,67,171,379,3312,3229,2964,3379,3400,3343,67,171,379,3312,3229,2964,poisson-block-composition
298,sp_workloads,1690805680,wl_small_mem,69,ml:SGD-PATE-sub25100-defpa,3,greedy,block-composition,poisson,equal-ncd,ml:SGD-PATE,sub25100,nopa,Unlocking,0.4,MLNoisySGDMechanism,{'Optimal': 40},3432,3504,3362,84,194,359,3348,3310,3003,3432,3504,3362,84,194,359,3348,3310,3003,poisson-block-composition
299,sp_workloads,1690805680,wl_small_mem,69,ml:SGD-PATE-sub25100-defpa,3,greedy,block-composition,poisson,equal-ncd,ml:SGD-PATE,sub25100,nopa,Unlocking,0.4,MLPateGaussianMechanism,{'Optimal': 40},3379,3400,3343,72,197,372,3307,3203,2971,3379,3400,3343,72,197,372,3307,3203,2971,poisson-block-composition
300,sp_workloads,1690805680,wl_small_mem,70,ml:SGD-PATE-sub25100-defpa,3,greedy,block-composition,upc,equal-ncd,ml:SGD-PATE,sub25100,nopa,Unlocking,0.2,MLNoisySGDMechanism,{'Optimal': 40},3432,3504,3362,100,239,685,3332,3265,2677,3432,3504,3362,100,239,685,3332,3265,2677,upc-block-composition
301,sp_workloads,1690805680,wl_small_mem,70,ml:SGD-PATE-sub25100-defpa,3,greedy,block-composition,upc,equal-ncd,ml:SGD-PATE,sub25100,nopa,Unlocking,0.2,MLPateGaussianMechanism,{'Optimal': 40},3379,3400,3343,51,260,665,3328,3140,2678,3379,3400,3343,51,260,665,3328,3140,2678,upc-block-composition
302,sp_workloads,1690805680,wl_small_mem,71,ml:SGD-PATE-sub25100-defpa,3,greedy,block-composition,upc,equal-ncd,ml:SGD-PATE,sub25100,nopa,Unlocking,0.4,MLNoisySGDMechanism,{'Optimal': 40},3432,3504,3362,93,298,857,3339,3206,2505,3432,3504,3362,93,298,857,3339,3206,2505,upc-block-composition
303,sp_workloads,1690805680,wl_small_mem,71,ml:SGD-PATE-sub25100-defpa,3,greedy,block-composition,upc,equal-ncd,ml:SGD-PATE,sub25100,nopa,Unlocking,0.4,MLPateGaussianMechanism,{'Optimal': 40},3379,3400,3343,55,312,839,3324,3088,2504,3379,3400,3343,55,312,839,3324,3088,2504,upc-block-composition
304,sp_workloads,1690805680,wl_small_mem,72,ml:SGD-PATE-sub25100-defpa,4,greedy,block-composition,poisson,ncd,ml:SGD-PATE,sub25100,nopa,Unlocking,0.2,MLNoisySGDMechanism,{'Optimal': 40},9619476,680600,63408,188987,28229,5488,9430489,652371,57920,3443,3381,3350,95,162,304,3348,3219,3046,poisson-block-composition
305,sp_workloads,1690805680,wl_small_mem,72,ml:SGD-PATE-sub25100-defpa,4,greedy,block-composition,poisson,ncd,ml:SGD-PATE,sub25100,nopa,Unlocking,0.2,MLPateGaussianMechanism,{'Optimal': 40},9087643,650021,64528,95743,25749,5728,8991900,624272,58800,3245,3345,3408,68,186,322,3177,3159,3086,poisson-block-composition
306,sp_workloads,1690805680,wl_small_mem,73,ml:SGD-PATE-sub25100-defpa,4,greedy,block-composition,poisson,ncd,ml:SGD-PATE,sub25100,nopa,Unlocking,0.4,MLNoisySGDMechanism,{'Optimal': 40},9619476,680600,63408,178212,31921,6064,9441264,648679,57344,3443,3381,3350,94,179,334,3349,3202,3016,poisson-block-composition
307,sp_workloads,1690805680,wl_small_mem,73,ml:SGD-PATE-sub25100-defpa,4,greedy,block-composition,poisson,ncd,ml:SGD-PATE,sub25100,nopa,Unlocking,0.4,MLPateGaussianMechanism,{'Optimal': 40},9087643,650021,64528,123904,26080,6000,8963739,623941,58528,3245,3345,3408,80,192,331,3165,3153,3077,poisson-block-composition
308,sp_workloads,1690805680,wl_small_mem,74,ml:SGD-PATE-sub25100-defpa,4,greedy,block-composition,upc,ncd,ml:SGD-PATE,sub25100,nopa,Unlocking,0.2,MLNoisySGDMechanism,{'Optimal': 40},9753693,680301,63744,140116,32577,11328,9613577,647724,52416,3443,3381,3350,96,246,676,3347,3135,2674,upc-block-composition
309,sp_workloads,1690805680,wl_small_mem,74,ml:SGD-PATE-sub25100-defpa,4,greedy,block-composition,upc,ncd,ml:SGD-PATE,sub25100,nopa,Unlocking,0.2,MLPateGaussianMechanism,{'Optimal': 40},8922612,681243,64896,65707,30086,11120,8856905,651157,53776,3245,3345,3408,53,263,662,3192,3082,2746,upc-block-composition
310,sp_workloads,1690805680,wl_small_mem,75,ml:SGD-PATE-sub25100-defpa,4,greedy,block-composition,upc,ncd,ml:SGD-PATE,sub25100,nopa,Unlocking,0.4,MLNoisySGDMechanism,{'Optimal': 40},9753693,680301,63744,113317,34316,13360,9640376,645985,50384,3443,3381,3350,95,293,803,3348,3088,2547,upc-block-composition
311,sp_workloads,1690805680,wl_small_mem,75,ml:SGD-PATE-sub25100-defpa,4,greedy,block-composition,upc,ncd,ml:SGD-PATE,sub25100,nopa,Unlocking,0.4,MLPateGaussianMechanism,{'Optimal': 40},8922612,681243,64896,68164,32814,13344,8854448,648429,51552,3245,3345,3408,56,310,795,3189,3035,2613,upc-block-composition
312,sp_workloads,1690805680,wl_small_mem,76,ml:SGD-PATE-sub25100-defpa,4,greedy,block-composition,poisson,equal-ncd,ml:SGD-PATE,sub25100,nopa,Unlocking,0.2,MLNoisySGDMechanism,{'Optimal': 40},3443,3381,3350,95,162,304,3348,3219,3046,3443,3381,3350,95,162,304,3348,3219,3046,poisson-block-composition
313,sp_workloads,1690805680,wl_small_mem,76,ml:SGD-PATE-sub25100-defpa,4,greedy,block-composition,poisson,equal-ncd,ml:SGD-PATE,sub25100,nopa,Unlocking,0.2,MLPateGaussianMechanism,{'Optimal': 40},3245,3345,3408,68,186,322,3177,3159,3086,3245,3345,3408,68,186,322,3177,3159,3086,poisson-block-composition
314,sp_workloads,1690805680,wl_small_mem,77,ml:SGD-PATE-sub25100-defpa,4,greedy,block-composition,poisson,equal-ncd,ml:SGD-PATE,sub25100,nopa,Unlocking,0.4,MLNoisySGDMechanism,{'Optimal': 40},3443,3381,3350,94,179,334,3349,3202,3016,3443,3381,3350,94,179,334,3349,3202,3016,poisson-block-composition
315,sp_workloads,1690805680,wl_small_mem,77,ml:SGD-PATE-sub25100-defpa,4,greedy,block-composition,poisson,equal-ncd,ml:SGD-PATE,sub25100,nopa,Unlocking,0.4,MLPateGaussianMechanism,{'Optimal': 40},3245,3345,3408,80,192,331,3165,3153,3077,3245,3345,3408,80,192,331,3165,3153,3077,poisson-block-composition
316,sp_workloads,1690805680,wl_small_mem,78,ml:SGD-PATE-sub25100-defpa,4,greedy,block-composition,upc,equal-ncd,ml:SGD-PATE,sub25100,nopa,Unlocking,0.2,MLNoisySGDMechanism,{'Optimal': 40},3443,3381,3350,96,246,676,3347,3135,2674,3443,3381,3350,96,246,676,3347,3135,2674,upc-block-composition
317,sp_workloads,1690805680,wl_small_mem,78,ml:SGD-PATE-sub25100-defpa,4,greedy,block-composition,upc,equal-ncd,ml:SGD-PATE,sub25100,nopa,Unlocking,0.2,MLPateGaussianMechanism,{'Optimal': 40},3245,3345,3408,53,263,662,3192,3082,2746,3245,3345,3408,53,263,662,3192,3082,2746,upc-block-composition
318,sp_workloads,1690805680,wl_small_mem,79,ml:SGD-PATE-sub25100-defpa,4,greedy,block-composition,upc,equal-ncd,ml:SGD-PATE,sub25100,nopa,Unlocking,0.4,MLNoisySGDMechanism,{'Optimal': 40},3443,3381,3350,95,293,803,3348,3088,2547,3443,3381,3350,95,293,803,3348,3088,2547,upc-block-composition
319,sp_workloads,1690805680,wl_small_mem,79,ml:SGD-PATE-sub25100-defpa,4,greedy,block-composition,upc,equal-ncd,ml:SGD-PATE,sub25100,nopa,Unlocking,0.4,MLPateGaussianMechanism,{'Optimal': 40},3245,3345,3408,56,310,795,3189,3035,2613,3245,3345,3408,56,310,795,3189,3035,2613,upc-block-composition
320,sp_workloads,1690805680,wl_small_mem,80,mixed:GM-LM-RR-LSVT-SGD-PATE-sub25100-defpa,0,greedy,block-composition,poisson,ncd,mixed:GM-LM-RR-LSVT-SGD-PATE,sub25100,nopa,Unlocking,0.2,GaussianMechanism,{'Optimal': 40},3326864,216518,19768,25792,12370,1702,3301072,204148,18066,1098,1121,1112,27,61,106,1071,1060,1006,poisson-block-composition
321,sp_workloads,1690805680,wl_small_mem,80,mixed:GM-LM-RR-LSVT-SGD-PATE-sub25100-defpa,0,greedy,block-composition,poisson,ncd,mixed:GM-LM-RR-LSVT-SGD-PATE,sub25100,nopa,Unlocking,0.2,LaplaceMechanism,{'Optimal': 40},3160262,214484,19740,20906,6096,1739,3139356,208388,18001,1133,1141,1092,19,41,101,1114,1100,991,poisson-block-composition
322,sp_workloads,1690805680,wl_small_mem,80,mixed:GM-LM-RR-LSVT-SGD-PATE-sub25100-defpa,0,greedy,block-composition,poisson,ncd,mixed:GM-LM-RR-LSVT-SGD-PATE,sub25100,nopa,Unlocking,0.2,MLNoisySGDMechanism,{'Optimal': 40},3049683,202901,20644,55354,14276,1725,2994329,188625,18919,1124,1132,1148,30,72,99,1094,1060,1049,poisson-block-composition
323,sp_workloads,1690805680,wl_small_mem,80,mixed:GM-LM-RR-LSVT-SGD-PATE-sub25100-defpa,0,greedy,block-composition,poisson,ncd,mixed:GM-LM-RR-LSVT-SGD-PATE,sub25100,nopa,Unlocking,0.2,MLPateGaussianMechanism,{'Optimal': 40},3104776,219595,19804,44375,10193,2084,3060401,209402,17720,1159,1162,1108,27,64,124,1132,1098,984,poisson-block-composition
324,sp_workloads,1690805680,wl_small_mem,80,mixed:GM-LM-RR-LSVT-SGD-PATE-sub25100-defpa,0,greedy,block-composition,poisson,ncd,mixed:GM-LM-RR-LSVT-SGD-PATE,sub25100,nopa,Unlocking,0.2,RandResponseMechanism,{'Optimal': 40},3027994,204361,19932,8174,3715,1919,3019820,200646,18013,1129,1138,1140,9,36,113,1120,1102,1027,poisson-block-composition
325,sp_workloads,1690805680,wl_small_mem,80,mixed:GM-LM-RR-LSVT-SGD-PATE-sub25100-defpa,0,greedy,block-composition,poisson,ncd,mixed:GM-LM-RR-LSVT-SGD-PATE,sub25100,nopa,Unlocking,0.2,SVTLaplaceMechanism,{'Optimal': 40},3254745,215442,20539,12043,3405,1712,3242702,212037,18827,1155,1111,1125,11,30,96,1144,1081,1029,poisson-block-composition
326,sp_workloads,1690805680,wl_small_mem,81,mixed:GM-LM-RR-LSVT-SGD-PATE-sub25100-defpa,0,greedy,block-composition,poisson,ncd,mixed:GM-LM-RR-LSVT-SGD-PATE,sub25100,nopa,Unlocking,0.4,GaussianMechanism,{'Optimal': 40},3326864,216518,19768,40019,12258,1915,3286845,204260,17853,1098,1121,1112,24,68,117,1074,1053,995,poisson-block-composition
327,sp_workloads,1690805680,wl_small_mem,81,mixed:GM-LM-RR-LSVT-SGD-PATE-sub25100-defpa,0,greedy,block-composition,poisson,ncd,mixed:GM-LM-RR-LSVT-SGD-PATE,sub25100,nopa,Unlocking,0.4,LaplaceMechanism,{'Optimal': 40},3160262,214484,19740,19732,5031,1803,3140530,209453,17937,1133,1141,1092,18,39,101,1115,1102,991,poisson-block-composition
328,sp_workloads,1690805680,wl_small_mem,81,mixed:GM-LM-RR-LSVT-SGD-PATE-sub25100-defpa,0,greedy,block-composition,poisson,ncd,mixed:GM-LM-RR-LSVT-SGD-PATE,sub25100,nopa,Unlocking,0.4,MLNoisySGDMechanism,{'Optimal': 40},3049683,202901,20644,61372,13274,1815,2988311,189627,18829,1124,1132,1148,28,69,105,1096,1063,1043,poisson-block-composition
329,sp_workloads,1690805680,wl_small_mem,81,mixed:GM-LM-RR-LSVT-SGD-PATE-sub25100-defpa,0,greedy,block-composition,poisson,ncd,mixed:GM-LM-RR-LSVT-SGD-PATE,sub25100,nopa,Unlocking,0.4,MLPateGaussianMechanism,{'Optimal': 40},3104776,219595,19804,46254,12305,2069,3058522,207290,17735,1159,1162,1108,29,72,123,1130,1090,985,poisson-block-composition
330,sp_workloads,1690805680,wl_small_mem,81,mixed:GM-LM-RR-LSVT-SGD-PATE-sub25100-defpa,0,greedy,block-composition,poisson,ncd,mixed:GM-LM-RR-LSVT-SGD-PATE,sub25100,nopa,Unlocking,0.4,RandResponseMechanism,{'Optimal': 40},3027994,204361,19932,19095,4497,2162,3008899,199864,17770,1129,1138,1140,9,39,126,1120,1099,1014,poisson-block-composition
331,sp_workloads,1690805680,wl_small_mem,81,mixed:GM-LM-RR-LSVT-SGD-PATE-sub25100-defpa,0,greedy,block-composition,poisson,ncd,mixed:GM-LM-RR-LSVT-SGD-PATE,sub25100,nopa,Unlocking,0.4,SVTLaplaceMechanism,{'Optimal': 40},3254745,215442,20539,10227,3485,1849,3244518,211957,18690,1155,1111,1125,8,26,103,1147,1085,1022,poisson-block-composition
332,sp_workloads,1690805680,wl_small_mem,82,mixed:GM-LM-RR-LSVT-SGD-PATE-sub25100-defpa,0,greedy,block-composition,upc,ncd,mixed:GM-LM-RR-LSVT-SGD-PATE,sub25100,nopa,Unlocking,0.2,GaussianMechanism,{'Optimal': 40},2981730,214916,19928,23607,14266,4003,2958123,200650,15925,1098,1121,1112,16,119,253,1082,1002,859,upc-block-composition
333,sp_workloads,1690805680,wl_small_mem,82,mixed:GM-LM-RR-LSVT-SGD-PATE-sub25100-defpa,0,greedy,block-composition,upc,ncd,mixed:GM-LM-RR-LSVT-SGD-PATE,sub25100,nopa,Unlocking,0.2,LaplaceMechanism,{'Optimal': 40},3131295,232349,19708,8479,3421,3997,3122816,228928,15711,1133,1141,1092,7,31,243,1126,1110,849,upc-block-composition
334,sp_workloads,1690805680,wl_small_mem,82,mixed:GM-LM-RR-LSVT-SGD-PATE-sub25100-defpa,0,greedy,block-composition,upc,ncd,mixed:GM-LM-RR-LSVT-SGD-PATE,sub25100,nopa,Unlocking,0.2,MLNoisySGDMechanism,{'Optimal': 40},3118726,223010,20660,67081,16185,4286,3051645,206825,16374,1124,1132,1148,32,129,274,1092,1003,874,upc-block-composition
335,sp_workloads,1690805680,wl_small_mem,82,mixed:GM-LM-RR-LSVT-SGD-PATE-sub25100-defpa,0,greedy,block-composition,upc,ncd,mixed:GM-LM-RR-LSVT-SGD-PATE,sub25100,nopa,Unlocking,0.2,MLPateGaussianMechanism,{'Optimal': 40},3293821,219087,19708,30939,15782,4027,3262882,203305,15681,1159,1162,1108,21,122,261,1138,1040,847,upc-block-composition
336,sp_workloads,1690805680,wl_small_mem,82,mixed:GM-LM-RR-LSVT-SGD-PATE-sub25100-defpa,0,greedy,block-composition,upc,ncd,mixed:GM-LM-RR-LSVT-SGD-PATE,sub25100,nopa,Unlocking,0.2,RandResponseMechanism,{'Optimal': 40},3089004,211671,20540,6887,3683,4653,3082117,207988,15887,1129,1138,1140,4,45,291,1125,1093,849,upc-block-composition
337,sp_workloads,1690805680,wl_small_mem,82,mixed:GM-LM-RR-LSVT-SGD-PATE-sub25100-defpa,0,greedy,block-composition,upc,ncd,mixed:GM-LM-RR-LSVT-SGD-PATE,sub25100,nopa,Unlocking,0.2,SVTLaplaceMechanism,{'Optimal': 40},3249651,226516,20283,6774,3326,4153,3242877,223190,16130,1155,1111,1125,5,32,263,1150,1079,862,upc-block-composition
338,sp_workloads,1690805680,wl_small_mem,83,mixed:GM-LM-RR-LSVT-SGD-PATE-sub25100-defpa,0,greedy,block-composition,upc,ncd,mixed:GM-LM-RR-LSVT-SGD-PATE,sub25100,nopa,Unlocking,0.4,GaussianMechanism,{'Optimal': 40},2981730,214916,19928,21088,9247,3967,2960642,205669,15961,1098,1121,1112,14,89,257,1084,1032,855,upc-block-composition
339,sp_workloads,1690805680,wl_small_mem,83,mixed:GM-LM-RR-LSVT-SGD-PATE-sub25100-defpa,0,greedy,block-composition,upc,ncd,mixed:GM-LM-RR-LSVT-SGD-PATE,sub25100,nopa,Unlocking,0.4,LaplaceMechanism,{'Optimal': 40},3131295,232349,19708,12558,4036,3671,3118737,228313,16037,1133,1141,1092,12,39,233,1121,1102,859,upc-block-composition
340,sp_workloads,1690805680,wl_small_mem,83,mixed:GM-LM-RR-LSVT-SGD-PATE-sub25100-defpa,0,greedy,block-composition,upc,ncd,mixed:GM-LM-RR-LSVT-SGD-PATE,sub25100,nopa,Unlocking,0.4,MLNoisySGDMechanism,{'Optimal': 40},3118726,223010,20660,48903,13114,4466,3069823,209896,16194,1124,1132,1148,29,119,286,1095,1013,862,upc-block-composition
341,sp_workloads,1690805680,wl_small_mem,83,mixed:GM-LM-RR-LSVT-SGD-PATE-sub25100-defpa,0,greedy,block-composition,upc,ncd,mixed:GM-LM-RR-LSVT-SGD-PATE,sub25100,nopa,Unlocking,0.4,MLPateGaussianMechanism,{'Optimal': 40},3293821,219087,19708,21102,10138,4026,3272719,208949,15682,1159,1162,1108,17,96,262,1142,1066,846,upc-block-composition
342,sp_workloads,1690805680,wl_small_mem,83,mixed:GM-LM-RR-LSVT-SGD-PATE-sub25100-defpa,0,greedy,block-composition,upc,ncd,mixed:GM-LM-RR-LSVT-SGD-PATE,sub25100,nopa,Unlocking,0.4,RandResponseMechanism,{'Optimal': 40},3089004,211671,20540,10488,3256,4335,3078516,208415,16205,1129,1138,1140,8,40,273,1121,1098,867,upc-block-composition
343,sp_workloads,1690805680,wl_small_mem,83,mixed:GM-LM-RR-LSVT-SGD-PATE-sub25100-defpa,0,greedy,block-composition,upc,ncd,mixed:GM-LM-RR-LSVT-SGD-PATE,sub25100,nopa,Unlocking,0.4,SVTLaplaceMechanism,{'Optimal': 40},3249651,226516,20283,11506,3312,4062,3238145,223204,16221,1155,1111,1125,11,30,258,1144,1081,867,upc-block-composition
344,sp_workloads,1690805680,wl_small_mem,84,mixed:GM-LM-RR-LSVT-SGD-PATE-sub25100-defpa,0,greedy,block-composition,poisson,equal-ncd,mixed:GM-LM-RR-LSVT-SGD-PATE,sub25100,nopa,Unlocking,0.2,GaussianMechanism,{'Optimal': 40},1098,1121,1112,27,61,106,1071,1060,1006,1098,1121,1112,27,61,106,1071,1060,1006,poisson-block-composition
345,sp_workloads,1690805680,wl_small_mem,84,mixed:GM-LM-RR-LSVT-SGD-PATE-sub25100-defpa,0,greedy,block-composition,poisson,equal-ncd,mixed:GM-LM-RR-LSVT-SGD-PATE,sub25100,nopa,Unlocking,0.2,LaplaceMechanism,{'Optimal': 40},1133,1141,1092,19,41,101,1114,1100,991,1133,1141,1092,19,41,101,1114,1100,991,poisson-block-composition
346,sp_workloads,1690805680,wl_small_mem,84,mixed:GM-LM-RR-LSVT-SGD-PATE-sub25100-defpa,0,greedy,block-composition,poisson,equal-ncd,mixed:GM-LM-RR-LSVT-SGD-PATE,sub25100,nopa,Unlocking,0.2,MLNoisySGDMechanism,{'Optimal': 40},1124,1132,1148,30,72,99,1094,1060,1049,1124,1132,1148,30,72,99,1094,1060,1049,poisson-block-composition
347,sp_workloads,1690805680,wl_small_mem,84,mixed:GM-LM-RR-LSVT-SGD-PATE-sub25100-defpa,0,greedy,block-composition,poisson,equal-ncd,mixed:GM-LM-RR-LSVT-SGD-PATE,sub25100,nopa,Unlocking,0.2,MLPateGaussianMechanism,{'Optimal': 40},1159,1162,1108,27,64,124,1132,1098,984,1159,1162,1108,27,64,124,1132,1098,984,poisson-block-composition
348,sp_workloads,1690805680,wl_small_mem,84,mixed:GM-LM-RR-LSVT-SGD-PATE-sub25100-defpa,0,greedy,block-composition,poisson,equal-ncd,mixed:GM-LM-RR-LSVT-SGD-PATE,sub25100,nopa,Unlocking,0.2,RandResponseMechanism,{'Optimal': 40},1129,1138,1140,9,36,113,1120,1102,1027,1129,1138,1140,9,36,113,1120,1102,1027,poisson-block-composition
349,sp_workloads,1690805680,wl_small_mem,84,mixed:GM-LM-RR-LSVT-SGD-PATE-sub25100-defpa,0,greedy,block-composition,poisson,equal-ncd,mixed:GM-LM-RR-LSVT-SGD-PATE,sub25100,nopa,Unlocking,0.2,SVTLaplaceMechanism,{'Optimal': 40},1155,1111,1125,11,30,96,1144,1081,1029,1155,1111,1125,11,30,96,1144,1081,1029,poisson-block-composition
350,sp_workloads,1690805680,wl_small_mem,85,mixed:GM-LM-RR-LSVT-SGD-PATE-sub25100-defpa,0,greedy,block-composition,poisson,equal-ncd,mixed:GM-LM-RR-LSVT-SGD-PATE,sub25100,nopa,Unlocking,0.4,GaussianMechanism,{'Optimal': 40},1098,1121,1112,24,68,117,1074,1053,995,1098,1121,1112,24,68,117,1074,1053,995,poisson-block-composition
351,sp_workloads,1690805680,wl_small_mem,85,mixed:GM-LM-RR-LSVT-SGD-PATE-sub25100-defpa,0,greedy,block-composition,poisson,equal-ncd,mixed:GM-LM-RR-LSVT-SGD-PATE,sub25100,nopa,Unlocking,0.4,LaplaceMechanism,{'Optimal': 40},1133,1141,1092,18,39,101,1115,1102,991,1133,1141,1092,18,39,101,1115,1102,991,poisson-block-composition
352,sp_workloads,1690805680,wl_small_mem,85,mixed:GM-LM-RR-LSVT-SGD-PATE-sub25100-defpa,0,greedy,block-composition,poisson,equal-ncd,mixed:GM-LM-RR-LSVT-SGD-PATE,sub25100,nopa,Unlocking,0.4,MLNoisySGDMechanism,{'Optimal': 40},1124,1132,1148,28,69,105,1096,1063,1043,1124,1132,1148,28,69,105,1096,1063,1043,poisson-block-composition
353,sp_workloads,1690805680,wl_small_mem,85,mixed:GM-LM-RR-LSVT-SGD-PATE-sub25100-defpa,0,greedy,block-composition,poisson,equal-ncd,mixed:GM-LM-RR-LSVT-SGD-PATE,sub25100,nopa,Unlocking,0.4,MLPateGaussianMechanism,{'Optimal': 40},1159,1162,1108,29,72,123,1130,1090,985,1159,1162,1108,29,72,123,1130,1090,985,poisson-block-composition
354,sp_workloads,1690805680,wl_small_mem,85,mixed:GM-LM-RR-LSVT-SGD-PATE-sub25100-defpa,0,greedy,block-composition,poisson,equal-ncd,mixed:GM-LM-RR-LSVT-SGD-PATE,sub25100,nopa,Unlocking,0.4,RandResponseMechanism,{'Optimal': 40},1129,1138,1140,9,39,126,1120,1099,1014,1129,1138,1140,9,39,126,1120,1099,1014,poisson-block-composition
355,sp_workloads,1690805680,wl_small_mem,85,mixed:GM-LM-RR-LSVT-SGD-PATE-sub25100-defpa,0,greedy,block-composition,poisson,equal-ncd,mixed:GM-LM-RR-LSVT-SGD-PATE,sub25100,nopa,Unlocking,0.4,SVTLaplaceMechanism,{'Optimal': 40},1155,1111,1125,8,26,103,1147,1085,1022,1155,1111,1125,8,26,103,1147,1085,1022,poisson-block-composition
356,sp_workloads,1690805680,wl_small_mem,86,mixed:GM-LM-RR-LSVT-SGD-PATE-sub25100-defpa,0,greedy,block-composition,upc,equal-ncd,mixed:GM-LM-RR-LSVT-SGD-PATE,sub25100,nopa,Unlocking,0.2,GaussianMechanism,{'Optimal': 40},1098,1121,1112,16,119,253,1082,1002,859,1098,1121,1112,16,119,253,1082,1002,859,upc-block-composition
357,sp_workloads,1690805680,wl_small_mem,86,mixed:GM-LM-RR-LSVT-SGD-PATE-sub25100-defpa,0,greedy,block-composition,upc,equal-ncd,mixed:GM-LM-RR-LSVT-SGD-PATE,sub25100,nopa,Unlocking,0.2,LaplaceMechanism,{'Optimal': 40},1133,1141,1092,7,31,243,1126,1110,849,1133,1141,1092,7,31,243,1126,1110,849,upc-block-composition
358,sp_workloads,1690805680,wl_small_mem,86,mixed:GM-LM-RR-LSVT-SGD-PATE-sub25100-defpa,0,greedy,block-composition,upc,equal-ncd,mixed:GM-LM-RR-LSVT-SGD-PATE,sub25100,nopa,Unlocking,0.2,MLNoisySGDMechanism,{'Optimal': 40},1124,1132,1148,32,129,274,1092,1003,874,1124,1132,1148,32,129,274,1092,1003,874,upc-block-composition
359,sp_workloads,1690805680,wl_small_mem,86,mixed:GM-LM-RR-LSVT-SGD-PATE-sub25100-defpa,0,greedy,block-composition,upc,equal-ncd,mixed:GM-LM-RR-LSVT-SGD-PATE,sub25100,nopa,Unlocking,0.2,MLPateGaussianMechanism,{'Optimal': 40},1159,1162,1108,21,122,261,1138,1040,847,1159,1162,1108,21,122,261,1138,1040,847,upc-block-composition
360,sp_workloads,1690805680,wl_small_mem,86,mixed:GM-LM-RR-LSVT-SGD-PATE-sub25100-defpa,0,greedy,block-composition,upc,equal-ncd,mixed:GM-LM-RR-LSVT-SGD-PATE,sub25100,nopa,Unlocking,0.2,RandResponseMechanism,{'Optimal': 40},1129,1138,1140,4,45,291,1125,1093,849,1129,1138,1140,4,45,291,1125,1093,849,upc-block-composition
361,sp_workloads,1690805680,wl_small_mem,86,mixed:GM-LM-RR-LSVT-SGD-PATE-sub25100-defpa,0,greedy,block-composition,upc,equal-ncd,mixed:GM-LM-RR-LSVT-SGD-PATE,sub25100,nopa,Unlocking,0.2,SVTLaplaceMechanism,{'Optimal': 40},1155,1111,1125,5,32,263,1150,1079,862,1155,1111,1125,5,32,263,1150,1079,862,upc-block-composition
362,sp_workloads,1690805680,wl_small_mem,87,mixed:GM-LM-RR-LSVT-SGD-PATE-sub25100-defpa,0,greedy,block-composition,upc,equal-ncd,mixed:GM-LM-RR-LSVT-SGD-PATE,sub25100,nopa,Unlocking,0.4,GaussianMechanism,{'Optimal': 40},1098,1121,1112,14,89,257,1084,1032,855,1098,1121,1112,14,89,257,1084,1032,855,upc-block-composition
363,sp_workloads,1690805680,wl_small_mem,87,mixed:GM-LM-RR-LSVT-SGD-PATE-sub25100-defpa,0,greedy,block-composition,upc,equal-ncd,mixed:GM-LM-RR-LSVT-SGD-PATE,sub25100,nopa,Unlocking,0.4,LaplaceMechanism,{'Optimal': 40},1133,1141,1092,12,39,233,1121,1102,859,1133,1141,1092,12,39,233,1121,1102,859,upc-block-composition
364,sp_workloads,1690805680,wl_small_mem,87,mixed:GM-LM-RR-LSVT-SGD-PATE-sub25100-defpa,0,greedy,block-composition,upc,equal-ncd,mixed:GM-LM-RR-LSVT-SGD-PATE,sub25100,nopa,Unlocking,0.4,MLNoisySGDMechanism,{'Optimal': 40},1124,1132,1148,29,119,286,1095,1013,862,1124,1132,1148,29,119,286,1095,1013,862,upc-block-composition
365,sp_workloads,1690805680,wl_small_mem,87,mixed:GM-LM-RR-LSVT-SGD-PATE-sub25100-defpa,0,greedy,block-composition,upc,equal-ncd,mixed:GM-LM-RR-LSVT-SGD-PATE,sub25100,nopa,Unlocking,0.4,MLPateGaussianMechanism,{'Optimal': 40},1159,1162,1108,17,96,262,1142,1066,846,1159,1162,1108,17,96,262,1142,1066,846,upc-block-composition
366,sp_workloads,1690805680,wl_small_mem,87,mixed:GM-LM-RR-LSVT-SGD-PATE-sub25100-defpa,0,greedy,block-composition,upc,equal-ncd,mixed:GM-LM-RR-LSVT-SGD-PATE,sub25100,nopa,Unlocking,0.4,RandResponseMechanism,{'Optimal': 40},1129,1138,1140,8,40,273,1121,1098,867,1129,1138,1140,8,40,273,1121,1098,867,upc-block-composition
367,sp_workloads,1690805680,wl_small_mem,87,mixed:GM-LM-RR-LSVT-SGD-PATE-sub25100-defpa,0,greedy,block-composition,upc,equal-ncd,mixed:GM-LM-RR-LSVT-SGD-PATE,sub25100,nopa,Unlocking,0.4,SVTLaplaceMechanism,{'Optimal': 40},1155,1111,1125,11,30,258,1144,1081,867,1155,1111,1125,11,30,258,1144,1081,867,upc-block-composition
368,sp_workloads,1690805680,wl_small_mem,88,mixed:GM-LM-RR-LSVT-SGD-PATE-sub25100-defpa,1,greedy,block-composition,poisson,ncd,mixed:GM-LM-RR-LSVT-SGD-PATE,sub25100,nopa,Unlocking,0.2,GaussianMechanism,{'Optimal': 40},3139319,215782,21216,26644,10483,2096,3112675,205299,19120,1075,1140,1126,22,60,121,1053,1080,1005,poisson-block-composition
369,sp_workloads,1690805680,wl_small_mem,88,mixed:GM-LM-RR-LSVT-SGD-PATE-sub25100-defpa,1,greedy,block-composition,poisson,ncd,mixed:GM-LM-RR-LSVT-SGD-PATE,sub25100,nopa,Unlocking,0.2,LaplaceMechanism,{'Optimal': 40},3080200,239601,21344,15923,5736,2256,3064277,233865,19088,1140,1163,1130,11,41,126,1129,1122,1004,poisson-block-composition
370,sp_workloads,1690805680,wl_small_mem,88,mixed:GM-LM-RR-LSVT-SGD-PATE-sub25100-defpa,1,greedy,block-composition,poisson,ncd,mixed:GM-LM-RR-LSVT-SGD-PATE,sub25100,nopa,Unlocking,0.2,MLNoisySGDMechanism,{'Optimal': 40},3197047,217314,22128,53855,5663,2224,3143192,211651,19904,1145,1089,1161,23,51,122,1122,1038,1039,poisson-block-composition
371,sp_workloads,1690805680,wl_small_mem,88,mixed:GM-LM-RR-LSVT-SGD-PATE-sub25100-defpa,1,greedy,block-composition,poisson,ncd,mixed:GM-LM-RR-LSVT-SGD-PATE,sub25100,nopa,Unlocking,0.2,MLPateGaussianMechanism,{'Optimal': 40},3203621,231498,21632,41654,8839,2032,3161967,222659,19600,1163,1144,1138,27,58,112,1136,1086,1026,poisson-block-composition
372,sp_workloads,1690805680,wl_small_mem,88,mixed:GM-LM-RR-LSVT-SGD-PATE-sub25100-defpa,1,greedy,block-composition,poisson,ncd,mixed:GM-LM-RR-LSVT-SGD-PATE,sub25100,nopa,Unlocking,0.2,RandResponseMechanism,{'Optimal': 40},3122577,243521,22560,12695,4823,2144,3109882,238698,20416,1093,1164,1181,10,38,121,1083,1126,1060,poisson-block-composition
373,sp_workloads,1690805680,wl_small_mem,88,mixed:GM-LM-RR-LSVT-SGD-PATE-sub25100-defpa,1,greedy,block-composition,poisson,ncd,mixed:GM-LM-RR-LSVT-SGD-PATE,sub25100,nopa,Unlocking,0.2,SVTLaplaceMechanism,{'Optimal': 40},3189411,227364,20784,10430,5900,1616,3178981,221464,19168,1178,1127,1089,8,33,93,1170,1094,996,poisson-block-composition
374,sp_workloads,1690805680,wl_small_mem,89,mixed:GM-LM-RR-LSVT-SGD-PATE-sub25100-defpa,1,greedy,block-composition,poisson,ncd,mixed:GM-LM-RR-LSVT-SGD-PATE,sub25100,nopa,Unlocking,0.4,GaussianMechanism,{'Optimal': 40},3139319,215782,21216,21854,8437,1952,3117465,207345,19264,1075,1140,1126,18,50,113,1057,1090,1013,poisson-block-composition
375,sp_workloads,1690805680,wl_small_mem,89,mixed:GM-LM-RR-LSVT-SGD-PATE-sub25100-defpa,1,greedy,block-composition,poisson,ncd,mixed:GM-LM-RR-LSVT-SGD-PATE,sub25100,nopa,Unlocking,0.4,LaplaceMechanism,{'Optimal': 40},3080200,239601,21344,34066,5639,1904,3046134,233962,19440,1140,1163,1130,11,38,109,1129,1125,1021,poisson-block-composition
376,sp_workloads,1690805680,wl_small_mem,89,mixed:GM-LM-RR-LSVT-SGD-PATE-sub25100-defpa,1,greedy,block-composition,poisson,ncd,mixed:GM-LM-RR-LSVT-SGD-PATE,sub25100,nopa,Unlocking,0.4,MLNoisySGDMechanism,{'Optimal': 40},3197047,217314,22128,41384,4644,2176,3155663,212670,19952,1145,1089,1161,21,35,122,1124,1054,1039,poisson-block-composition
377,sp_workloads,1690805680,wl_small_mem,89,mixed:GM-LM-RR-LSVT-SGD-PATE-sub25100-defpa,1,greedy,block-composition,poisson,ncd,mixed:GM-LM-RR-LSVT-SGD-PATE,sub25100,nopa,Unlocking,0.4,MLPateGaussianMechanism,{'Optimal': 40},3203621,231498,21632,26562,9069,1952,3177059,222429,19680,1163,1144,1138,18,51,108,1145,1093,1030,poisson-block-composition
378,sp_workloads,1690805680,wl_small_mem,89,mixed:GM-LM-RR-LSVT-SGD-PATE-sub25100-defpa,1,greedy,block-composition,poisson,ncd,mixed:GM-LM-RR-LSVT-SGD-PATE,sub25100,nopa,Unlocking,0.4,RandResponseMechanism,{'Optimal': 40},3122577,243521,22560,20863,3476,1936,3101714,240045,20624,1093,1164,1181,9,30,109,1084,1134,1072,poisson-block-composition
379,sp_workloads,1690805680,wl_small_mem,89,mixed:GM-LM-RR-LSVT-SGD-PATE-sub25100-defpa,1,greedy,block-composition,poisson,ncd,mixed:GM-LM-RR-LSVT-SGD-PATE,sub25100,nopa,Unlocking,0.4,SVTLaplaceMechanism,{'Optimal': 40},3189411,227364,20784,23063,3313,1696,3166348,224051,19088,1178,1127,1089,10,23,98,1168,1104,991,poisson-block-composition
380,sp_workloads,1690805680,wl_small_mem,90,mixed:GM-LM-RR-LSVT-SGD-PATE-sub25100-defpa,1,greedy,block-composition,upc,ncd,mixed:GM-LM-RR-LSVT-SGD-PATE,sub25100,nopa,Unlocking,0.2,GaussianMechanism,{'Optimal': 40},3132487,230731,21232,13727,13877,5168,3118760,216854,16064,1075,1140,1126,16,132,306,1059,1008,820,upc-block-composition
381,sp_workloads,1690805680,wl_small_mem,90,mixed:GM-LM-RR-LSVT-SGD-PATE-sub25100-defpa,1,greedy,block-composition,upc,ncd,mixed:GM-LM-RR-LSVT-SGD-PATE,sub25100,nopa,Unlocking,0.2,LaplaceMechanism,{'Optimal': 40},3099847,241488,21408,6517,4899,4704,3093330,236589,16704,1140,1163,1130,4,43,282,1136,1120,848,upc-block-composition
382,sp_workloads,1690805680,wl_small_mem,90,mixed:GM-LM-RR-LSVT-SGD-PATE-sub25100-defpa,1,greedy,block-composition,upc,ncd,mixed:GM-LM-RR-LSVT-SGD-PATE,sub25100,nopa,Unlocking,0.2,MLNoisySGDMechanism,{'Optimal': 40},3154870,213434,22336,47982,11051,5408,3106888,202383,16928,1145,1089,1161,33,117,321,1112,972,840,upc-block-composition
383,sp_workloads,1690805680,wl_small_mem,90,mixed:GM-LM-RR-LSVT-SGD-PATE-sub25100-defpa,1,greedy,block-composition,upc,ncd,mixed:GM-LM-RR-LSVT-SGD-PATE,sub25100,nopa,Unlocking,0.2,MLPateGaussianMechanism,{'Optimal': 40},3325335,225275,21360,15589,11090,5056,3309746,214185,16304,1163,1144,1138,14,100,302,1149,1044,836,upc-block-composition
384,sp_workloads,1690805680,wl_small_mem,90,mixed:GM-LM-RR-LSVT-SGD-PATE-sub25100-defpa,1,greedy,block-composition,upc,ncd,mixed:GM-LM-RR-LSVT-SGD-PATE,sub25100,nopa,Unlocking,0.2,RandResponseMechanism,{'Optimal': 40},2890868,228789,22304,11643,5577,4736,2879225,223212,17568,1093,1164,1181,7,48,283,1086,1116,898,upc-block-composition
385,sp_workloads,1690805680,wl_small_mem,90,mixed:GM-LM-RR-LSVT-SGD-PATE-sub25100-defpa,1,greedy,block-composition,upc,ncd,mixed:GM-LM-RR-LSVT-SGD-PATE,sub25100,nopa,Unlocking,0.2,SVTLaplaceMechanism,{'Optimal': 40},3335945,229922,20624,5256,2992,4640,3330689,226930,15984,1178,1127,1089,5,39,281,1173,1088,808,upc-block-composition
386,sp_workloads,1690805680,wl_small_mem,91,mixed:GM-LM-RR-LSVT-SGD-PATE-sub25100-defpa,1,greedy,block-composition,upc,ncd,mixed:GM-LM-RR-LSVT-SGD-PATE,sub25100,nopa,Unlocking,0.4,GaussianMechanism,{'Optimal': 40},3132487,230731,21232,12580,8946,4656,3119907,221785,16576,1075,1140,1126,12,87,279,1063,1053,847,upc-block-composition
387,sp_workloads,1690805680,wl_small_mem,91,mixed:GM-LM-RR-LSVT-SGD-PATE-sub25100-defpa,1,greedy,block-composition,upc,ncd,mixed:GM-LM-RR-LSVT-SGD-PATE,sub25100,nopa,Unlocking,0.4,LaplaceMechanism,{'Optimal': 40},3099847,241488,21408,11303,3542,4272,3088544,237946,17136,1140,1163,1130,11,41,254,1129,1122,876,upc-block-composition
388,sp_workloads,1690805680,wl_small_mem,91,mixed:GM-LM-RR-LSVT-SGD-PATE-sub25100-defpa,1,greedy,block-composition,upc,ncd,mixed:GM-LM-RR-LSVT-SGD-PATE,sub25100,nopa,Unlocking,0.4,MLNoisySGDMechanism,{'Optimal': 40},3154870,213434,22336,46478,7905,4896,3108392,205529,17440,1145,1089,1161,28,94,291,1117,995,870,upc-block-composition
389,sp_workloads,1690805680,wl_small_mem,91,mixed:GM-LM-RR-LSVT-SGD-PATE-sub25100-defpa,1,greedy,block-composition,upc,ncd,mixed:GM-LM-RR-LSVT-SGD-PATE,sub25100,nopa,Unlocking,0.4,MLPateGaussianMechanism,{'Optimal': 40},3325335,225275,21360,11886,8172,4400,3313449,217103,16960,1163,1144,1138,12,76,263,1151,1068,875,upc-block-composition
390,sp_workloads,1690805680,wl_small_mem,91,mixed:GM-LM-RR-LSVT-SGD-PATE-sub25100-defpa,1,greedy,block-composition,upc,ncd,mixed:GM-LM-RR-LSVT-SGD-PATE,sub25100,nopa,Unlocking,0.4,RandResponseMechanism,{'Optimal': 40},2890868,228789,22304,17998,4849,4512,2872870,223940,17792,1093,1164,1181,16,50,268,1077,1114,913,upc-block-composition
391,sp_workloads,1690805680,wl_small_mem,91,mixed:GM-LM-RR-LSVT-SGD-PATE-sub25100-defpa,1,greedy,block-composition,upc,ncd,mixed:GM-LM-RR-LSVT-SGD-PATE,sub25100,nopa,Unlocking,0.4,SVTLaplaceMechanism,{'Optimal': 40},3335945,229922,20624,11447,2186,4240,3324498,227736,16384,1178,1127,1089,14,33,255,1164,1094,834,upc-block-composition
392,sp_workloads,1690805680,wl_small_mem,92,mixed:GM-LM-RR-LSVT-SGD-PATE-sub25100-defpa,1,greedy,block-composition,poisson,equal-ncd,mixed:GM-LM-RR-LSVT-SGD-PATE,sub25100,nopa,Unlocking,0.2,GaussianMechanism,{'Optimal': 40},1075,1140,1126,22,60,121,1053,1080,1005,1075,1140,1126,22,60,121,1053,1080,1005,poisson-block-composition
393,sp_workloads,1690805680,wl_small_mem,92,mixed:GM-LM-RR-LSVT-SGD-PATE-sub25100-defpa,1,greedy,block-composition,poisson,equal-ncd,mixed:GM-LM-RR-LSVT-SGD-PATE,sub25100,nopa,Unlocking,0.2,LaplaceMechanism,{'Optimal': 40},1140,1163,1130,11,41,126,1129,1122,1004,1140,1163,1130,11,41,126,1129,1122,1004,poisson-block-composition
394,sp_workloads,1690805680,wl_small_mem,92,mixed:GM-LM-RR-LSVT-SGD-PATE-sub25100-defpa,1,greedy,block-composition,poisson,equal-ncd,mixed:GM-LM-RR-LSVT-SGD-PATE,sub25100,nopa,Unlocking,0.2,MLNoisySGDMechanism,{'Optimal': 40},1145,1089,1161,23,51,122,1122,1038,1039,1145,1089,1161,23,51,122,1122,1038,1039,poisson-block-composition
395,sp_workloads,1690805680,wl_small_mem,92,mixed:GM-LM-RR-LSVT-SGD-PATE-sub25100-defpa,1,greedy,block-composition,poisson,equal-ncd,mixed:GM-LM-RR-LSVT-SGD-PATE,sub25100,nopa,Unlocking,0.2,MLPateGaussianMechanism,{'Optimal': 40},1163,1144,1138,27,58,112,1136,1086,1026,1163,1144,1138,27,58,112,1136,1086,1026,poisson-block-composition
396,sp_workloads,1690805680,wl_small_mem,92,mixed:GM-LM-RR-LSVT-SGD-PATE-sub25100-defpa,1,greedy,block-composition,poisson,equal-ncd,mixed:GM-LM-RR-LSVT-SGD-PATE,sub25100,nopa,Unlocking,0.2,RandResponseMechanism,{'Optimal': 40},1093,1164,1181,10,38,121,1083,1126,1060,1093,1164,1181,10,38,121,1083,1126,1060,poisson-block-composition
397,sp_workloads,1690805680,wl_small_mem,92,mixed:GM-LM-RR-LSVT-SGD-PATE-sub25100-defpa,1,greedy,block-composition,poisson,equal-ncd,mixed:GM-LM-RR-LSVT-SGD-PATE,sub25100,nopa,Unlocking,0.2,SVTLaplaceMechanism,{'Optimal': 40},1178,1127,1089,8,33,93,1170,1094,996,1178,1127,1089,8,33,93,1170,1094,996,poisson-block-composition
398,sp_workloads,1690805680,wl_small_mem,93,mixed:GM-LM-RR-LSVT-SGD-PATE-sub25100-defpa,1,greedy,block-composition,poisson,equal-ncd,mixed:GM-LM-RR-LSVT-SGD-PATE,sub25100,nopa,Unlocking,0.4,GaussianMechanism,{'Optimal': 40},1075,1140,1126,18,50,113,1057,1090,1013,1075,1140,1126,18,50,113,1057,1090,1013,poisson-block-composition
399,sp_workloads,1690805680,wl_small_mem,93,mixed:GM-LM-RR-LSVT-SGD-PATE-sub25100-defpa,1,greedy,block-composition,poisson,equal-ncd,mixed:GM-LM-RR-LSVT-SGD-PATE,sub25100,nopa,Unlocking,0.4,LaplaceMechanism,{'Optimal': 40},1140,1163,1130,11,38,109,1129,1125,1021,1140,1163,1130,11,38,109,1129,1125,1021,poisson-block-composition
400,sp_workloads,1690805680,wl_small_mem,93,mixed:GM-LM-RR-LSVT-SGD-PATE-sub25100-defpa,1,greedy,block-composition,poisson,equal-ncd,mixed:GM-LM-RR-LSVT-SGD-PATE,sub25100,nopa,Unlocking,0.4,MLNoisySGDMechanism,{'Optimal': 40},1145,1089,1161,21,35,122,1124,1054,1039,1145,1089,1161,21,35,122,1124,1054,1039,poisson-block-composition
401,sp_workloads,1690805680,wl_small_mem,93,mixed:GM-LM-RR-LSVT-SGD-PATE-sub25100-defpa,1,greedy,block-composition,poisson,equal-ncd,mixed:GM-LM-RR-LSVT-SGD-PATE,sub25100,nopa,Unlocking,0.4,MLPateGaussianMechanism,{'Optimal': 40},1163,1144,1138,18,51,108,1145,1093,1030,1163,1144,1138,18,51,108,1145,1093,1030,poisson-block-composition
402,sp_workloads,1690805680,wl_small_mem,93,mixed:GM-LM-RR-LSVT-SGD-PATE-sub25100-defpa,1,greedy,block-composition,poisson,equal-ncd,mixed:GM-LM-RR-LSVT-SGD-PATE,sub25100,nopa,Unlocking,0.4,RandResponseMechanism,{'Optimal': 40},1093,1164,1181,9,30,109,1084,1134,1072,1093,1164,1181,9,30,109,1084,1134,1072,poisson-block-composition
403,sp_workloads,1690805680,wl_small_mem,93,mixed:GM-LM-RR-LSVT-SGD-PATE-sub25100-defpa,1,greedy,block-composition,poisson,equal-ncd,mixed:GM-LM-RR-LSVT-SGD-PATE,sub25100,nopa,Unlocking,0.4,SVTLaplaceMechanism,{'Optimal': 40},1178,1127,1089,10,23,98,1168,1104,991,1178,1127,1089,10,23,98,1168,1104,991,poisson-block-composition
404,sp_workloads,1690805680,wl_small_mem,94,mixed:GM-LM-RR-LSVT-SGD-PATE-sub25100-defpa,1,greedy,block-composition,upc,equal-ncd,mixed:GM-LM-RR-LSVT-SGD-PATE,sub25100,nopa,Unlocking,0.2,GaussianMechanism,{'Optimal': 40},1075,1140,1126,16,132,306,1059,1008,820,1075,1140,1126,16,132,306,1059,1008,820,upc-block-composition
405,sp_workloads,1690805680,wl_small_mem,94,mixed:GM-LM-RR-LSVT-SGD-PATE-sub25100-defpa,1,greedy,block-composition,upc,equal-ncd,mixed:GM-LM-RR-LSVT-SGD-PATE,sub25100,nopa,Unlocking,0.2,LaplaceMechanism,{'Optimal': 40},1140,1163,1130,4,43,282,1136,1120,848,1140,1163,1130,4,43,282,1136,1120,848,upc-block-composition
406,sp_workloads,1690805680,wl_small_mem,94,mixed:GM-LM-RR-LSVT-SGD-PATE-sub25100-defpa,1,greedy,block-composition,upc,equal-ncd,mixed:GM-LM-RR-LSVT-SGD-PATE,sub25100,nopa,Unlocking,0.2,MLNoisySGDMechanism,{'Optimal': 40},1145,1089,1161,33,117,321,1112,972,840,1145,1089,1161,33,117,321,1112,972,840,upc-block-composition
407,sp_workloads,1690805680,wl_small_mem,94,mixed:GM-LM-RR-LSVT-SGD-PATE-sub25100-defpa,1,greedy,block-composition,upc,equal-ncd,mixed:GM-LM-RR-LSVT-SGD-PATE,sub25100,nopa,Unlocking,0.2,MLPateGaussianMechanism,{'Optimal': 40},1163,1144,1138,14,100,302,1149,1044,836,1163,1144,1138,14,100,302,1149,1044,836,upc-block-composition
408,sp_workloads,1690805680,wl_small_mem,94,mixed:GM-LM-RR-LSVT-SGD-PATE-sub25100-defpa,1,greedy,block-composition,upc,equal-ncd,mixed:GM-LM-RR-LSVT-SGD-PATE,sub25100,nopa,Unlocking,0.2,RandResponseMechanism,{'Optimal': 40},1093,1164,1181,7,48,283,1086,1116,898,1093,1164,1181,7,48,283,1086,1116,898,upc-block-composition
409,sp_workloads,1690805680,wl_small_mem,94,mixed:GM-LM-RR-LSVT-SGD-PATE-sub25100-defpa,1,greedy,block-composition,upc,equal-ncd,mixed:GM-LM-RR-LSVT-SGD-PATE,sub25100,nopa,Unlocking,0.2,SVTLaplaceMechanism,{'Optimal': 40},1178,1127,1089,5,39,281,1173,1088,808,1178,1127,1089,5,39,281,1173,1088,808,upc-block-composition
410,sp_workloads,1690805680,wl_small_mem,95,mixed:GM-LM-RR-LSVT-SGD-PATE-sub25100-defpa,1,greedy,block-composition,upc,equal-ncd,mixed:GM-LM-RR-LSVT-SGD-PATE,sub25100,nopa,Unlocking,0.4,GaussianMechanism,{'Optimal': 40},1075,1140,1126,12,87,279,1063,1053,847,1075,1140,1126,12,87,279,1063,1053,847,upc-block-composition
411,sp_workloads,1690805680,wl_small_mem,95,mixed:GM-LM-RR-LSVT-SGD-PATE-sub25100-defpa,1,greedy,block-composition,upc,equal-ncd,mixed:GM-LM-RR-LSVT-SGD-PATE,sub25100,nopa,Unlocking,0.4,LaplaceMechanism,{'Optimal': 40},1140,1163,1130,11,41,254,1129,1122,876,1140,1163,1130,11,41,254,1129,1122,876,upc-block-composition
412,sp_workloads,1690805680,wl_small_mem,95,mixed:GM-LM-RR-LSVT-SGD-PATE-sub25100-defpa,1,greedy,block-composition,upc,equal-ncd,mixed:GM-LM-RR-LSVT-SGD-PATE,sub25100,nopa,Unlocking,0.4,MLNoisySGDMechanism,{'Optimal': 40},1145,1089,1161,28,94,291,1117,995,870,1145,1089,1161,28,94,291,1117,995,870,upc-block-composition
413,sp_workloads,1690805680,wl_small_mem,95,mixed:GM-LM-RR-LSVT-SGD-PATE-sub25100-defpa,1,greedy,block-composition,upc,equal-ncd,mixed:GM-LM-RR-LSVT-SGD-PATE,sub25100,nopa,Unlocking,0.4,MLPateGaussianMechanism,{'Optimal': 40},1163,1144,1138,12,76,263,1151,1068,875,1163,1144,1138,12,76,263,1151,1068,875,upc-block-composition
414,sp_workloads,1690805680,wl_small_mem,95,mixed:GM-LM-RR-LSVT-SGD-PATE-sub25100-defpa,1,greedy,block-composition,upc,equal-ncd,mixed:GM-LM-RR-LSVT-SGD-PATE,sub25100,nopa,Unlocking,0.4,RandResponseMechanism,{'Optimal': 40},1093,1164,1181,16,50,268,1077,1114,913,1093,1164,1181,16,50,268,1077,1114,913,upc-block-composition
415,sp_workloads,1690805680,wl_small_mem,95,mixed:GM-LM-RR-LSVT-SGD-PATE-sub25100-defpa,1,greedy,block-composition,upc,equal-ncd,mixed:GM-LM-RR-LSVT-SGD-PATE,sub25100,nopa,Unlocking,0.4,SVTLaplaceMechanism,{'Optimal': 40},1178,1127,1089,14,33,255,1164,1094,834,1178,1127,1089,14,33,255,1164,1094,834,upc-block-composition
416,sp_workloads,1690805680,wl_small_mem,96,mixed:GM-LM-RR-LSVT-SGD-PATE-sub25100-defpa,2,greedy,block-composition,poisson,ncd,mixed:GM-LM-RR-LSVT-SGD-PATE,sub25100,nopa,Unlocking,0.2,GaussianMechanism,{'Optimal': 40},3297557,222693,20889,45996,7976,2140,3251561,214717,18749,1107,1156,1159,24,66,132,1083,1090,1027,poisson-block-composition
417,sp_workloads,1690805680,wl_small_mem,96,mixed:GM-LM-RR-LSVT-SGD-PATE-sub25100-defpa,2,greedy,block-composition,poisson,ncd,mixed:GM-LM-RR-LSVT-SGD-PATE,sub25100,nopa,Unlocking,0.2,LaplaceMechanism,{'Optimal': 40},2847135,226653,20024,8467,3104,1974,2838668,223549,18050,1061,1136,1112,10,30,122,1051,1106,990,poisson-block-composition
418,sp_workloads,1690805680,wl_small_mem,96,mixed:GM-LM-RR-LSVT-SGD-PATE-sub25100-defpa,2,greedy,block-composition,poisson,ncd,mixed:GM-LM-RR-LSVT-SGD-PATE,sub25100,nopa,Unlocking,0.2,MLNoisySGDMechanism,{'Optimal': 40},3065470,217531,20600,50241,14390,1965,3015229,203141,18635,1088,1113,1144,26,74,115,1062,1039,1029,poisson-block-composition
419,sp_workloads,1690805680,wl_small_mem,96,mixed:GM-LM-RR-LSVT-SGD-PATE-sub25100-defpa,2,greedy,block-composition,poisson,ncd,mixed:GM-LM-RR-LSVT-SGD-PATE,sub25100,nopa,Unlocking,0.2,MLPateGaussianMechanism,{'Optimal': 40},3183074,228777,19443,28347,12763,2175,3154727,216014,17268,1123,1178,1085,20,73,129,1103,1105,956,poisson-block-composition
420,sp_workloads,1690805680,wl_small_mem,96,mixed:GM-LM-RR-LSVT-SGD-PATE-sub25100-defpa,2,greedy,block-composition,poisson,ncd,mixed:GM-LM-RR-LSVT-SGD-PATE,sub25100,nopa,Unlocking,0.2,RandResponseMechanism,{'Optimal': 40},3253029,217115,19830,13480,5607,1902,3239549,211508,17928,1136,1135,1114,11,36,114,1125,1099,1000,poisson-block-composition
421,sp_workloads,1690805680,wl_small_mem,96,mixed:GM-LM-RR-LSVT-SGD-PATE-sub25100-defpa,2,greedy,block-composition,poisson,ncd,mixed:GM-LM-RR-LSVT-SGD-PATE,sub25100,nopa,Unlocking,0.2,SVTLaplaceMechanism,{'Optimal': 40},3041723,217557,19755,14816,5469,2082,3026907,212088,17673,1106,1092,1109,16,30,126,1090,1062,983,poisson-block-composition
422,sp_workloads,1690805680,wl_small_mem,97,mixed:GM-LM-RR-LSVT-SGD-PATE-sub25100-defpa,2,greedy,block-composition,poisson,ncd,mixed:GM-LM-RR-LSVT-SGD-PATE,sub25100,nopa,Unlocking,0.4,GaussianMechanism,{'Optimal': 40},3297557,222693,20889,36262,7832,2184,3261295,214861,18705,1107,1156,1159,22,67,136,1085,1089,1023,poisson-block-composition
423,sp_workloads,1690805680,wl_small_mem,97,mixed:GM-LM-RR-LSVT-SGD-PATE-sub25100-defpa,2,greedy,block-composition,poisson,ncd,mixed:GM-LM-RR-LSVT-SGD-PATE,sub25100,nopa,Unlocking,0.4,LaplaceMechanism,{'Optimal': 40},2847135,226653,20024,13000,2102,2248,2834135,224551,17776,1061,1136,1112,9,25,136,1052,1111,976,poisson-block-composition
424,sp_workloads,1690805680,wl_small_mem,97,mixed:GM-LM-RR-LSVT-SGD-PATE-sub25100-defpa,2,greedy,block-composition,poisson,ncd,mixed:GM-LM-RR-LSVT-SGD-PATE,sub25100,nopa,Unlocking,0.4,MLNoisySGDMechanism,{'Optimal': 40},3065470,217531,20600,44099,11460,1900,3021371,206071,18700,1088,1113,1144,20,63,116,1068,1050,1028,poisson-block-composition
425,sp_workloads,1690805680,wl_small_mem,97,mixed:GM-LM-RR-LSVT-SGD-PATE-sub25100-defpa,2,greedy,block-composition,poisson,ncd,mixed:GM-LM-RR-LSVT-SGD-PATE,sub25100,nopa,Unlocking,0.4,MLPateGaussianMechanism,{'Optimal': 40},3183074,228777,19443,21615,7856,2127,3161459,220921,17316,1123,1178,1085,15,58,129,1108,1120,956,poisson-block-composition
426,sp_workloads,1690805680,wl_small_mem,97,mixed:GM-LM-RR-LSVT-SGD-PATE-sub25100-defpa,2,greedy,block-composition,poisson,ncd,mixed:GM-LM-RR-LSVT-SGD-PATE,sub25100,nopa,Unlocking,0.4,RandResponseMechanism,{'Optimal': 40},3253029,217115,19830,27347,3523,1901,3225682,213592,17929,1136,1135,1114,12,26,115,1124,1109,999,poisson-block-composition
427,sp_workloads,1690805680,wl_small_mem,97,mixed:GM-LM-RR-LSVT-SGD-PATE-sub25100-defpa,2,greedy,block-composition,poisson,ncd,mixed:GM-LM-RR-LSVT-SGD-PATE,sub25100,nopa,Unlocking,0.4,SVTLaplaceMechanism,{'Optimal': 40},3041723,217557,19755,26066,5168,1854,3015657,212389,17901,1106,1092,1109,18,27,114,1088,1065,995,poisson-block-composition
428,sp_workloads,1690805680,wl_small_mem,98,mixed:GM-LM-RR-LSVT-SGD-PATE-sub25100-defpa,2,greedy,block-composition,upc,ncd,mixed:GM-LM-RR-LSVT-SGD-PATE,sub25100,nopa,Unlocking,0.2,GaussianMechanism,{'Optimal': 40},3028685,226201,22304,14899,15105,4816,3013786,211096,17488,1107,1156,1159,16,132,288,1091,1024,871,upc-block-composition
429,sp_workloads,1690805680,wl_small_mem,98,mixed:GM-LM-RR-LSVT-SGD-PATE-sub25100-defpa,2,greedy,block-composition,upc,ncd,mixed:GM-LM-RR-LSVT-SGD-PATE,sub25100,nopa,Unlocking,0.2,LaplaceMechanism,{'Optimal': 40},2820488,216183,20704,2268,5069,4720,2818220,211114,15984,1061,1136,1112,1,36,283,1060,1100,829,upc-block-composition
430,sp_workloads,1690805680,wl_small_mem,98,mixed:GM-LM-RR-LSVT-SGD-PATE-sub25100-defpa,2,greedy,block-composition,upc,ncd,mixed:GM-LM-RR-LSVT-SGD-PATE,sub25100,nopa,Unlocking,0.2,MLNoisySGDMechanism,{'Optimal': 40},3179489,220472,21440,41847,17568,5024,3137642,202904,16416,1088,1113,1144,35,117,299,1053,996,845,upc-block-composition
431,sp_workloads,1690805680,wl_small_mem,98,mixed:GM-LM-RR-LSVT-SGD-PATE-sub25100-defpa,2,greedy,block-composition,upc,ncd,mixed:GM-LM-RR-LSVT-SGD-PATE,sub25100,nopa,Unlocking,0.2,MLPateGaussianMechanism,{'Optimal': 40},3159577,225347,20608,27924,11623,4864,3131653,213724,15744,1123,1178,1085,19,128,291,1104,1050,794,upc-block-composition
432,sp_workloads,1690805680,wl_small_mem,98,mixed:GM-LM-RR-LSVT-SGD-PATE-sub25100-defpa,2,greedy,block-composition,upc,ncd,mixed:GM-LM-RR-LSVT-SGD-PATE,sub25100,nopa,Unlocking,0.2,RandResponseMechanism,{'Optimal': 40},3276567,216246,21344,177,4888,5072,3276390,211358,16272,1136,1135,1114,4,44,299,1132,1091,815,upc-block-composition
433,sp_workloads,1690805680,wl_small_mem,98,mixed:GM-LM-RR-LSVT-SGD-PATE-sub25100-defpa,2,greedy,block-composition,upc,ncd,mixed:GM-LM-RR-LSVT-SGD-PATE,sub25100,nopa,Unlocking,0.2,SVTLaplaceMechanism,{'Optimal': 40},3232745,216520,21504,1764,3222,4816,3230981,213298,16688,1106,1092,1109,6,40,282,1100,1052,827,upc-block-composition
434,sp_workloads,1690805680,wl_small_mem,99,mixed:GM-LM-RR-LSVT-SGD-PATE-sub25100-defpa,2,greedy,block-composition,upc,ncd,mixed:GM-LM-RR-LSVT-SGD-PATE,sub25100,nopa,Unlocking,0.4,GaussianMechanism,{'Optimal': 40},3028685,226201,22304,20018,9996,4080,3008667,216205,18224,1107,1156,1159,15,108,248,1092,1048,911,upc-block-composition
435,sp_workloads,1690805680,wl_small_mem,99,mixed:GM-LM-RR-LSVT-SGD-PATE-sub25100-defpa,2,greedy,block-composition,upc,ncd,mixed:GM-LM-RR-LSVT-SGD-PATE,sub25100,nopa,Unlocking,0.4,LaplaceMechanism,{'Optimal': 40},2820488,216183,20704,7126,3469,4112,2813362,212714,16592,1061,1136,1112,5,28,250,1056,1108,862,upc-block-composition
436,sp_workloads,1690805680,wl_small_mem,99,mixed:GM-LM-RR-LSVT-SGD-PATE-sub25100-defpa,2,greedy,block-composition,upc,ncd,mixed:GM-LM-RR-LSVT-SGD-PATE,sub25100,nopa,Unlocking,0.4,MLNoisySGDMechanism,{'Optimal': 40},3179489,220472,21440,27999,14523,4432,3151490,205949,17008,1088,1113,1144,27,112,268,1061,1001,876,upc-block-composition
437,sp_workloads,1690805680,wl_small_mem,99,mixed:GM-LM-RR-LSVT-SGD-PATE-sub25100-defpa,2,greedy,block-composition,upc,ncd,mixed:GM-LM-RR-LSVT-SGD-PATE,sub25100,nopa,Unlocking,0.4,MLPateGaussianMechanism,{'Optimal': 40},3159577,225347,20608,14366,9041,4464,3145211,216306,16144,1123,1178,1085,13,104,269,1110,1074,816,upc-block-composition
438,sp_workloads,1690805680,wl_small_mem,99,mixed:GM-LM-RR-LSVT-SGD-PATE-sub25100-defpa,2,greedy,block-composition,upc,ncd,mixed:GM-LM-RR-LSVT-SGD-PATE,sub25100,nopa,Unlocking,0.4,RandResponseMechanism,{'Optimal': 40},3276567,216246,21344,7399,4598,4256,3269168,211648,17088,1136,1135,1114,11,39,254,1125,1096,860,upc-block-composition
439,sp_workloads,1690805680,wl_small_mem,99,mixed:GM-LM-RR-LSVT-SGD-PATE-sub25100-defpa,2,greedy,block-composition,upc,ncd,mixed:GM-LM-RR-LSVT-SGD-PATE,sub25100,nopa,Unlocking,0.4,SVTLaplaceMechanism,{'Optimal': 40},3232745,216520,21504,12112,2851,4240,3220633,213669,17264,1106,1092,1109,21,36,251,1085,1056,858,upc-block-composition
440,sp_workloads,1690805680,wl_small_mem,100,mixed:GM-LM-RR-LSVT-SGD-PATE-sub25100-defpa,2,greedy,block-composition,poisson,equal-ncd,mixed:GM-LM-RR-LSVT-SGD-PATE,sub25100,nopa,Unlocking,0.2,GaussianMechanism,{'Optimal': 40},1107,1156,1159,24,66,132,1083,1090,1027,1107,1156,1159,24,66,132,1083,1090,1027,poisson-block-composition
441,sp_workloads,1690805680,wl_small_mem,100,mixed:GM-LM-RR-LSVT-SGD-PATE-sub25100-defpa,2,greedy,block-composition,poisson,equal-ncd,mixed:GM-LM-RR-LSVT-SGD-PATE,sub25100,nopa,Unlocking,0.2,LaplaceMechanism,{'Optimal': 40},1061,1136,1112,10,30,122,1051,1106,990,1061,1136,1112,10,30,122,1051,1106,990,poisson-block-composition
442,sp_workloads,1690805680,wl_small_mem,100,mixed:GM-LM-RR-LSVT-SGD-PATE-sub25100-defpa,2,greedy,block-composition,poisson,equal-ncd,mixed:GM-LM-RR-LSVT-SGD-PATE,sub25100,nopa,Unlocking,0.2,MLNoisySGDMechanism,{'Optimal': 40},1088,1113,1144,26,74,115,1062,1039,1029,1088,1113,1144,26,74,115,1062,1039,1029,poisson-block-composition
443,sp_workloads,1690805680,wl_small_mem,100,mixed:GM-LM-RR-LSVT-SGD-PATE-sub25100-defpa,2,greedy,block-composition,poisson,equal-ncd,mixed:GM-LM-RR-LSVT-SGD-PATE,sub25100,nopa,Unlocking,0.2,MLPateGaussianMechanism,{'Optimal': 40},1123,1178,1085,20,73,129,1103,1105,956,1123,1178,1085,20,73,129,1103,1105,956,poisson-block-composition
444,sp_workloads,1690805680,wl_small_mem,100,mixed:GM-LM-RR-LSVT-SGD-PATE-sub25100-defpa,2,greedy,block-composition,poisson,equal-ncd,mixed:GM-LM-RR-LSVT-SGD-PATE,sub25100,nopa,Unlocking,0.2,RandResponseMechanism,{'Optimal': 40},1136,1135,1114,11,36,114,1125,1099,1000,1136,1135,1114,11,36,114,1125,1099,1000,poisson-block-composition
445,sp_workloads,1690805680,wl_small_mem,100,mixed:GM-LM-RR-LSVT-SGD-PATE-sub25100-defpa,2,greedy,block-composition,poisson,equal-ncd,mixed:GM-LM-RR-LSVT-SGD-PATE,sub25100,nopa,Unlocking,0.2,SVTLaplaceMechanism,{'Optimal': 40},1106,1092,1109,16,30,126,1090,1062,983,1106,1092,1109,16,30,126,1090,1062,983,poisson-block-composition
446,sp_workloads,1690805680,wl_small_mem,101,mixed:GM-LM-RR-LSVT-SGD-PATE-sub25100-defpa,2,greedy,block-composition,poisson,equal-ncd,mixed:GM-LM-RR-LSVT-SGD-PATE,sub25100,nopa,Unlocking,0.4,GaussianMechanism,{'Optimal': 40},1107,1156,1159,22,67,136,1085,1089,1023,1107,1156,1159,22,67,136,1085,1089,1023,poisson-block-composition
447,sp_workloads,1690805680,wl_small_mem,101,mixed:GM-LM-RR-LSVT-SGD-PATE-sub25100-defpa,2,greedy,block-composition,poisson,equal-ncd,mixed:GM-LM-RR-LSVT-SGD-PATE,sub25100,nopa,Unlocking,0.4,LaplaceMechanism,{'Optimal': 40},1061,1136,1112,9,25,136,1052,1111,976,1061,1136,1112,9,25,136,1052,1111,976,poisson-block-composition
448,sp_workloads,1690805680,wl_small_mem,101,mixed:GM-LM-RR-LSVT-SGD-PATE-sub25100-defpa,2,greedy,block-composition,poisson,equal-ncd,mixed:GM-LM-RR-LSVT-SGD-PATE,sub25100,nopa,Unlocking,0.4,MLNoisySGDMechanism,{'Optimal': 40},1088,1113,1144,20,63,116,1068,1050,1028,1088,1113,1144,20,63,116,1068,1050,1028,poisson-block-composition
449,sp_workloads,1690805680,wl_small_mem,101,mixed:GM-LM-RR-LSVT-SGD-PATE-sub25100-defpa,2,greedy,block-composition,poisson,equal-ncd,mixed:GM-LM-RR-LSVT-SGD-PATE,sub25100,nopa,Unlocking,0.4,MLPateGaussianMechanism,{'Optimal': 40},1123,1178,1085,15,58,129,1108,1120,956,1123,1178,1085,15,58,129,1108,1120,956,poisson-block-composition
450,sp_workloads,1690805680,wl_small_mem,101,mixed:GM-LM-RR-LSVT-SGD-PATE-sub25100-defpa,2,greedy,block-composition,poisson,equal-ncd,mixed:GM-LM-RR-LSVT-SGD-PATE,sub25100,nopa,Unlocking,0.4,RandResponseMechanism,{'Optimal': 40},1136,1135,1114,12,26,115,1124,1109,999,1136,1135,1114,12,26,115,1124,1109,999,poisson-block-composition
451,sp_workloads,1690805680,wl_small_mem,101,mixed:GM-LM-RR-LSVT-SGD-PATE-sub25100-defpa,2,greedy,block-composition,poisson,equal-ncd,mixed:GM-LM-RR-LSVT-SGD-PATE,sub25100,nopa,Unlocking,0.4,SVTLaplaceMechanism,{'Optimal': 40},1106,1092,1109,18,27,114,1088,1065,995,1106,1092,1109,18,27,114,1088,1065,995,poisson-block-composition
452,sp_workloads,1690805680,wl_small_mem,102,mixed:GM-LM-RR-LSVT-SGD-PATE-sub25100-defpa,2,greedy,block-composition,upc,equal-ncd,mixed:GM-LM-RR-LSVT-SGD-PATE,sub25100,nopa,Unlocking,0.2,GaussianMechanism,{'Optimal': 40},1107,1156,1159,16,132,288,1091,1024,871,1107,1156,1159,16,132,288,1091,1024,871,upc-block-composition
453,sp_workloads,1690805680,wl_small_mem,102,mixed:GM-LM-RR-LSVT-SGD-PATE-sub25100-defpa,2,greedy,block-composition,upc,equal-ncd,mixed:GM-LM-RR-LSVT-SGD-PATE,sub25100,nopa,Unlocking,0.2,LaplaceMechanism,{'Optimal': 40},1061,1136,1112,1,36,283,1060,1100,829,1061,1136,1112,1,36,283,1060,1100,829,upc-block-composition
454,sp_workloads,1690805680,wl_small_mem,102,mixed:GM-LM-RR-LSVT-SGD-PATE-sub25100-defpa,2,greedy,block-composition,upc,equal-ncd,mixed:GM-LM-RR-LSVT-SGD-PATE,sub25100,nopa,Unlocking,0.2,MLNoisySGDMechanism,{'Optimal': 40},1088,1113,1144,35,117,299,1053,996,845,1088,1113,1144,35,117,299,1053,996,845,upc-block-composition
455,sp_workloads,1690805680,wl_small_mem,102,mixed:GM-LM-RR-LSVT-SGD-PATE-sub25100-defpa,2,greedy,block-composition,upc,equal-ncd,mixed:GM-LM-RR-LSVT-SGD-PATE,sub25100,nopa,Unlocking,0.2,MLPateGaussianMechanism,{'Optimal': 40},1123,1178,1085,19,128,291,1104,1050,794,1123,1178,1085,19,128,291,1104,1050,794,upc-block-composition
456,sp_workloads,1690805680,wl_small_mem,102,mixed:GM-LM-RR-LSVT-SGD-PATE-sub25100-defpa,2,greedy,block-composition,upc,equal-ncd,mixed:GM-LM-RR-LSVT-SGD-PATE,sub25100,nopa,Unlocking,0.2,RandResponseMechanism,{'Optimal': 40},1136,1135,1114,4,44,299,1132,1091,815,1136,1135,1114,4,44,299,1132,1091,815,upc-block-composition
457,sp_workloads,1690805680,wl_small_mem,102,mixed:GM-LM-RR-LSVT-SGD-PATE-sub25100-defpa,2,greedy,block-composition,upc,equal-ncd,mixed:GM-LM-RR-LSVT-SGD-PATE,sub25100,nopa,Unlocking,0.2,SVTLaplaceMechanism,{'Optimal': 40},1106,1092,1109,6,40,282,1100,1052,827,1106,1092,1109,6,40,282,1100,1052,827,upc-block-composition
458,sp_workloads,1690805680,wl_small_mem,103,mixed:GM-LM-RR-LSVT-SGD-PATE-sub25100-defpa,2,greedy,block-composition,upc,equal-ncd,mixed:GM-LM-RR-LSVT-SGD-PATE,sub25100,nopa,Unlocking,0.4,GaussianMechanism,{'Optimal': 40},1107,1156,1159,15,108,248,1092,1048,911,1107,1156,1159,15,108,248,1092,1048,911,upc-block-composition
459,sp_workloads,1690805680,wl_small_mem,103,mixed:GM-LM-RR-LSVT-SGD-PATE-sub25100-defpa,2,greedy,block-composition,upc,equal-ncd,mixed:GM-LM-RR-LSVT-SGD-PATE,sub25100,nopa,Unlocking,0.4,LaplaceMechanism,{'Optimal': 40},1061,1136,1112,5,28,250,1056,1108,862,1061,1136,1112,5,28,250,1056,1108,862,upc-block-composition
460,sp_workloads,1690805680,wl_small_mem,103,mixed:GM-LM-RR-LSVT-SGD-PATE-sub25100-defpa,2,greedy,block-composition,upc,equal-ncd,mixed:GM-LM-RR-LSVT-SGD-PATE,sub25100,nopa,Unlocking,0.4,MLNoisySGDMechanism,{'Optimal': 40},1088,1113,1144,27,112,268,1061,1001,876,1088,1113,1144,27,112,268,1061,1001,876,upc-block-composition
461,sp_workloads,1690805680,wl_small_mem,103,mixed:GM-LM-RR-LSVT-SGD-PATE-sub25100-defpa,2,greedy,block-composition,upc,equal-ncd,mixed:GM-LM-RR-LSVT-SGD-PATE,sub25100,nopa,Unlocking,0.4,MLPateGaussianMechanism,{'Optimal': 40},1123,1178,1085,13,104,269,1110,1074,816,1123,1178,1085,13,104,269,1110,1074,816,upc-block-composition
462,sp_workloads,1690805680,wl_small_mem,103,mixed:GM-LM-RR-LSVT-SGD-PATE-sub25100-defpa,2,greedy,block-composition,upc,equal-ncd,mixed:GM-LM-RR-LSVT-SGD-PATE,sub25100,nopa,Unlocking,0.4,RandResponseMechanism,{'Optimal': 40},1136,1135,1114,11,39,254,1125,1096,860,1136,1135,1114,11,39,254,1125,1096,860,upc-block-composition
463,sp_workloads,1690805680,wl_small_mem,103,mixed:GM-LM-RR-LSVT-SGD-PATE-sub25100-defpa,2,greedy,block-composition,upc,equal-ncd,mixed:GM-LM-RR-LSVT-SGD-PATE,sub25100,nopa,Unlocking,0.4,SVTLaplaceMechanism,{'Optimal': 40},1106,1092,1109,21,36,251,1085,1056,858,1106,1092,1109,21,36,251,1085,1056,858,upc-block-composition
464,sp_workloads,1690805680,wl_small_mem,104,mixed:GM-LM-RR-LSVT-SGD-PATE-sub25100-defpa,3,greedy,block-composition,poisson,ncd,mixed:GM-LM-RR-LSVT-SGD-PATE,sub25100,nopa,Unlocking,0.2,GaussianMechanism,{'Optimal': 40},3014106,221031,21056,20173,9583,2000,2993933,211448,19056,1094,1113,1104,19,53,110,1075,1060,994,poisson-block-composition
465,sp_workloads,1690805680,wl_small_mem,104,mixed:GM-LM-RR-LSVT-SGD-PATE-sub25100-defpa,3,greedy,block-composition,poisson,ncd,mixed:GM-LM-RR-LSVT-SGD-PATE,sub25100,nopa,Unlocking,0.2,LaplaceMechanism,{'Optimal': 40},3356641,218178,20864,26254,7232,2048,3330387,210946,18816,1169,1154,1119,16,44,121,1153,1110,998,poisson-block-composition
466,sp_workloads,1690805680,wl_small_mem,104,mixed:GM-LM-RR-LSVT-SGD-PATE-sub25100-defpa,3,greedy,block-composition,poisson,ncd,mixed:GM-LM-RR-LSVT-SGD-PATE,sub25100,nopa,Unlocking,0.2,MLNoisySGDMechanism,{'Optimal': 40},2886113,212328,21728,34478,6311,1936,2851635,206017,19792,1057,1087,1124,28,42,108,1029,1045,1016,poisson-block-composition
467,sp_workloads,1690805680,wl_small_mem,104,mixed:GM-LM-RR-LSVT-SGD-PATE-sub25100-defpa,3,greedy,block-composition,poisson,ncd,mixed:GM-LM-RR-LSVT-SGD-PATE,sub25100,nopa,Unlocking,0.2,MLPateGaussianMechanism,{'Optimal': 40},3286989,218751,22304,31577,7709,2064,3255412,211042,20240,1114,1105,1168,20,59,116,1094,1046,1052,poisson-block-composition
468,sp_workloads,1690805680,wl_small_mem,104,mixed:GM-LM-RR-LSVT-SGD-PATE-sub25100-defpa,3,greedy,block-composition,poisson,ncd,mixed:GM-LM-RR-LSVT-SGD-PATE,sub25100,nopa,Unlocking,0.2,RandResponseMechanism,{'Optimal': 40},3304405,225397,21760,6950,5958,1632,3297455,219439,20128,1160,1175,1154,9,32,94,1151,1143,1060,poisson-block-composition
469,sp_workloads,1690805680,wl_small_mem,104,mixed:GM-LM-RR-LSVT-SGD-PATE-sub25100-defpa,3,greedy,block-composition,poisson,ncd,mixed:GM-LM-RR-LSVT-SGD-PATE,sub25100,nopa,Unlocking,0.2,SVTLaplaceMechanism,{'Optimal': 40},2975196,221951,22352,20109,5203,2176,2955087,216748,20176,1080,1132,1168,17,32,125,1063,1100,1043,poisson-block-composition
470,sp_workloads,1690805680,wl_small_mem,105,mixed:GM-LM-RR-LSVT-SGD-PATE-sub25100-defpa,3,greedy,block-composition,poisson,ncd,mixed:GM-LM-RR-LSVT-SGD-PATE,sub25100,nopa,Unlocking,0.4,GaussianMechanism,{'Optimal': 40},3014106,221031,21056,11917,6520,2128,3002189,214511,18928,1094,1113,1104,11,46,119,1083,1067,985,poisson-block-composition
471,sp_workloads,1690805680,wl_small_mem,105,mixed:GM-LM-RR-LSVT-SGD-PATE-sub25100-defpa,3,greedy,block-composition,poisson,ncd,mixed:GM-LM-RR-LSVT-SGD-PATE,sub25100,nopa,Unlocking,0.4,LaplaceMechanism,{'Optimal': 40},3356641,218178,20864,25401,5750,2384,3331240,212428,18480,1169,1154,1119,13,34,141,1156,1120,978,poisson-block-composition
472,sp_workloads,1690805680,wl_small_mem,105,mixed:GM-LM-RR-LSVT-SGD-PATE-sub25100-defpa,3,greedy,block-composition,poisson,ncd,mixed:GM-LM-RR-LSVT-SGD-PATE,sub25100,nopa,Unlocking,0.4,MLNoisySGDMechanism,{'Optimal': 40},2886113,212328,21728,25236,5862,2128,2860877,206466,19600,1057,1087,1124,25,38,119,1032,1049,1005,poisson-block-composition
473,sp_workloads,1690805680,wl_small_mem,105,mixed:GM-LM-RR-LSVT-SGD-PATE-sub25100-defpa,3,greedy,block-composition,poisson,ncd,mixed:GM-LM-RR-LSVT-SGD-PATE,sub25100,nopa,Unlocking,0.4,MLPateGaussianMechanism,{'Optimal': 40},3286989,218751,22304,41788,8386,2496,3245201,210365,19808,1114,1105,1168,23,66,140,1091,1039,1028,poisson-block-composition
474,sp_workloads,1690805680,wl_small_mem,105,mixed:GM-LM-RR-LSVT-SGD-PATE-sub25100-defpa,3,greedy,block-composition,poisson,ncd,mixed:GM-LM-RR-LSVT-SGD-PATE,sub25100,nopa,Unlocking,0.4,RandResponseMechanism,{'Optimal': 40},3304405,225397,21760,22951,5990,2016,3281454,219407,19744,1160,1175,1154,11,33,118,1149,1142,1036,poisson-block-composition
475,sp_workloads,1690805680,wl_small_mem,105,mixed:GM-LM-RR-LSVT-SGD-PATE-sub25100-defpa,3,greedy,block-composition,poisson,ncd,mixed:GM-LM-RR-LSVT-SGD-PATE,sub25100,nopa,Unlocking,0.4,SVTLaplaceMechanism,{'Optimal': 40},2975196,221951,22352,13692,4091,2368,2961504,217860,19984,1080,1132,1168,10,24,139,1070,1108,1029,poisson-block-composition
476,sp_workloads,1690805680,wl_small_mem,106,mixed:GM-LM-RR-LSVT-SGD-PATE-sub25100-defpa,3,greedy,block-composition,upc,ncd,mixed:GM-LM-RR-LSVT-SGD-PATE,sub25100,nopa,Unlocking,0.2,GaussianMechanism,{'Optimal': 40},3015210,216424,20816,15637,8748,4704,2999573,207676,16112,1094,1113,1104,18,106,285,1076,1007,819,upc-block-composition
477,sp_workloads,1690805680,wl_small_mem,106,mixed:GM-LM-RR-LSVT-SGD-PATE-sub25100-defpa,3,greedy,block-composition,upc,ncd,mixed:GM-LM-RR-LSVT-SGD-PATE,sub25100,nopa,Unlocking,0.2,LaplaceMechanism,{'Optimal': 40},3318690,224507,21008,8642,7181,5072,3310048,217326,15936,1169,1154,1119,7,49,303,1162,1105,816,upc-block-composition
478,sp_workloads,1690805680,wl_small_mem,106,mixed:GM-LM-RR-LSVT-SGD-PATE-sub25100-defpa,3,greedy,block-composition,upc,ncd,mixed:GM-LM-RR-LSVT-SGD-PATE,sub25100,nopa,Unlocking,0.2,MLNoisySGDMechanism,{'Optimal': 40},3049040,216655,21456,52328,8699,5024,2996712,207956,16432,1057,1087,1124,31,104,295,1026,983,829,upc-block-composition
479,sp_workloads,1690805680,wl_small_mem,106,mixed:GM-LM-RR-LSVT-SGD-PATE-sub25100-defpa,3,greedy,block-composition,upc,ncd,mixed:GM-LM-RR-LSVT-SGD-PATE,sub25100,nopa,Unlocking,0.2,MLPateGaussianMechanism,{'Optimal': 40},3068572,223959,21712,12913,13260,5072,3055659,210699,16640,1114,1105,1168,15,117,300,1099,988,868,upc-block-composition
480,sp_workloads,1690805680,wl_small_mem,106,mixed:GM-LM-RR-LSVT-SGD-PATE-sub25100-defpa,3,greedy,block-composition,upc,ncd,mixed:GM-LM-RR-LSVT-SGD-PATE,sub25100,nopa,Unlocking,0.2,RandResponseMechanism,{'Optimal': 40},3242042,226884,21536,9304,5089,4720,3232738,221795,16816,1160,1175,1154,6,37,283,1154,1138,871,upc-block-composition
481,sp_workloads,1690805680,wl_small_mem,106,mixed:GM-LM-RR-LSVT-SGD-PATE-sub25100-defpa,3,greedy,block-composition,upc,ncd,mixed:GM-LM-RR-LSVT-SGD-PATE,sub25100,nopa,Unlocking,0.2,SVTLaplaceMechanism,{'Optimal': 40},3121265,219086,22384,2064,4393,5168,3119201,214693,17216,1080,1132,1168,2,39,308,1078,1093,860,upc-block-composition
482,sp_workloads,1690805680,wl_small_mem,107,mixed:GM-LM-RR-LSVT-SGD-PATE-sub25100-defpa,3,greedy,block-composition,upc,ncd,mixed:GM-LM-RR-LSVT-SGD-PATE,sub25100,nopa,Unlocking,0.4,GaussianMechanism,{'Optimal': 40},3015210,216424,20816,16815,9332,4416,2998395,207092,16400,1094,1113,1104,16,98,268,1078,1015,836,upc-block-composition
483,sp_workloads,1690805680,wl_small_mem,107,mixed:GM-LM-RR-LSVT-SGD-PATE-sub25100-defpa,3,greedy,block-composition,upc,ncd,mixed:GM-LM-RR-LSVT-SGD-PATE,sub25100,nopa,Unlocking,0.4,LaplaceMechanism,{'Optimal': 40},3318690,224507,21008,16850,5151,4736,3301840,219356,16272,1169,1154,1119,13,40,286,1156,1114,833,upc-block-composition
484,sp_workloads,1690805680,wl_small_mem,107,mixed:GM-LM-RR-LSVT-SGD-PATE-sub25100-defpa,3,greedy,block-composition,upc,ncd,mixed:GM-LM-RR-LSVT-SGD-PATE,sub25100,nopa,Unlocking,0.4,MLNoisySGDMechanism,{'Optimal': 40},3049040,216655,21456,50071,8848,4592,2998969,207807,16864,1057,1087,1124,26,97,273,1031,990,851,upc-block-composition
485,sp_workloads,1690805680,wl_small_mem,107,mixed:GM-LM-RR-LSVT-SGD-PATE-sub25100-defpa,3,greedy,block-composition,upc,ncd,mixed:GM-LM-RR-LSVT-SGD-PATE,sub25100,nopa,Unlocking,0.4,MLPateGaussianMechanism,{'Optimal': 40},3068572,223959,21712,10544,8895,4576,3058028,215064,17136,1114,1105,1168,12,98,276,1102,1007,892,upc-block-composition
486,sp_workloads,1690805680,wl_small_mem,107,mixed:GM-LM-RR-LSVT-SGD-PATE-sub25100-defpa,3,greedy,block-composition,upc,ncd,mixed:GM-LM-RR-LSVT-SGD-PATE,sub25100,nopa,Unlocking,0.4,RandResponseMechanism,{'Optimal': 40},3242042,226884,21536,17333,3429,4336,3224709,223455,17200,1160,1175,1154,12,32,261,1148,1143,893,upc-block-composition
487,sp_workloads,1690805680,wl_small_mem,107,mixed:GM-LM-RR-LSVT-SGD-PATE-sub25100-defpa,3,greedy,block-composition,upc,ncd,mixed:GM-LM-RR-LSVT-SGD-PATE,sub25100,nopa,Unlocking,0.4,SVTLaplaceMechanism,{'Optimal': 40},3121265,219086,22384,12349,4200,4576,3108916,214886,17808,1080,1132,1168,10,36,278,1070,1096,890,upc-block-composition
488,sp_workloads,1690805680,wl_small_mem,108,mixed:GM-LM-RR-LSVT-SGD-PATE-sub25100-defpa,3,greedy,block-composition,poisson,equal-ncd,mixed:GM-LM-RR-LSVT-SGD-PATE,sub25100,nopa,Unlocking,0.2,GaussianMechanism,{'Optimal': 40},1094,1113,1104,19,53,110,1075,1060,994,1094,1113,1104,19,53,110,1075,1060,994,poisson-block-composition
489,sp_workloads,1690805680,wl_small_mem,108,mixed:GM-LM-RR-LSVT-SGD-PATE-sub25100-defpa,3,greedy,block-composition,poisson,equal-ncd,mixed:GM-LM-RR-LSVT-SGD-PATE,sub25100,nopa,Unlocking,0.2,LaplaceMechanism,{'Optimal': 40},1169,1154,1119,16,44,121,1153,1110,998,1169,1154,1119,16,44,121,1153,1110,998,poisson-block-composition
490,sp_workloads,1690805680,wl_small_mem,108,mixed:GM-LM-RR-LSVT-SGD-PATE-sub25100-defpa,3,greedy,block-composition,poisson,equal-ncd,mixed:GM-LM-RR-LSVT-SGD-PATE,sub25100,nopa,Unlocking,0.2,MLNoisySGDMechanism,{'Optimal': 40},1057,1087,1124,28,42,108,1029,1045,1016,1057,1087,1124,28,42,108,1029,1045,1016,poisson-block-composition
491,sp_workloads,1690805680,wl_small_mem,108,mixed:GM-LM-RR-LSVT-SGD-PATE-sub25100-defpa,3,greedy,block-composition,poisson,equal-ncd,mixed:GM-LM-RR-LSVT-SGD-PATE,sub25100,nopa,Unlocking,0.2,MLPateGaussianMechanism,{'Optimal': 40},1114,1105,1168,20,59,116,1094,1046,1052,1114,1105,1168,20,59,116,1094,1046,1052,poisson-block-composition
492,sp_workloads,1690805680,wl_small_mem,108,mixed:GM-LM-RR-LSVT-SGD-PATE-sub25100-defpa,3,greedy,block-composition,poisson,equal-ncd,mixed:GM-LM-RR-LSVT-SGD-PATE,sub25100,nopa,Unlocking,0.2,RandResponseMechanism,{'Optimal': 40},1160,1175,1154,9,32,94,1151,1143,1060,1160,1175,1154,9,32,94,1151,1143,1060,poisson-block-composition
493,sp_workloads,1690805680,wl_small_mem,108,mixed:GM-LM-RR-LSVT-SGD-PATE-sub25100-defpa,3,greedy,block-composition,poisson,equal-ncd,mixed:GM-LM-RR-LSVT-SGD-PATE,sub25100,nopa,Unlocking,0.2,SVTLaplaceMechanism,{'Optimal': 40},1080,1132,1168,17,32,125,1063,1100,1043,1080,1132,1168,17,32,125,1063,1100,1043,poisson-block-composition
494,sp_workloads,1690805680,wl_small_mem,109,mixed:GM-LM-RR-LSVT-SGD-PATE-sub25100-defpa,3,greedy,block-composition,poisson,equal-ncd,mixed:GM-LM-RR-LSVT-SGD-PATE,sub25100,nopa,Unlocking,0.4,GaussianMechanism,{'Optimal': 40},1094,1113,1104,11,46,119,1083,1067,985,1094,1113,1104,11,46,119,1083,1067,985,poisson-block-composition
495,sp_workloads,1690805680,wl_small_mem,109,mixed:GM-LM-RR-LSVT-SGD-PATE-sub25100-defpa,3,greedy,block-composition,poisson,equal-ncd,mixed:GM-LM-RR-LSVT-SGD-PATE,sub25100,nopa,Unlocking,0.4,LaplaceMechanism,{'Optimal': 40},1169,1154,1119,13,34,141,1156,1120,978,1169,1154,1119,13,34,141,1156,1120,978,poisson-block-composition
496,sp_workloads,1690805680,wl_small_mem,109,mixed:GM-LM-RR-LSVT-SGD-PATE-sub25100-defpa,3,greedy,block-composition,poisson,equal-ncd,mixed:GM-LM-RR-LSVT-SGD-PATE,sub25100,nopa,Unlocking,0.4,MLNoisySGDMechanism,{'Optimal': 40},1057,1087,1124,25,38,119,1032,1049,1005,1057,1087,1124,25,38,119,1032,1049,1005,poisson-block-composition
497,sp_workloads,1690805680,wl_small_mem,109,mixed:GM-LM-RR-LSVT-SGD-PATE-sub25100-defpa,3,greedy,block-composition,poisson,equal-ncd,mixed:GM-LM-RR-LSVT-SGD-PATE,sub25100,nopa,Unlocking,0.4,MLPateGaussianMechanism,{'Optimal': 40},1114,1105,1168,23,66,140,1091,1039,1028,1114,1105,1168,23,66,140,1091,1039,1028,poisson-block-composition
498,sp_workloads,1690805680,wl_small_mem,109,mixed:GM-LM-RR-LSVT-SGD-PATE-sub25100-defpa,3,greedy,block-composition,poisson,equal-ncd,mixed:GM-LM-RR-LSVT-SGD-PATE,sub25100,nopa,Unlocking,0.4,RandResponseMechanism,{'Optimal': 40},1160,1175,1154,11,33,118,1149,1142,1036,1160,1175,1154,11,33,118,1149,1142,1036,poisson-block-composition
499,sp_workloads,1690805680,wl_small_mem,109,mixed:GM-LM-RR-LSVT-SGD-PATE-sub25100-defpa,3,greedy,block-composition,poisson,equal-ncd,mixed:GM-LM-RR-LSVT-SGD-PATE,sub25100,nopa,Unlocking,0.4,SVTLaplaceMechanism,{'Optimal': 40},1080,1132,1168,10,24,139,1070,1108,1029,1080,1132,1168,10,24,139,1070,1108,1029,poisson-block-composition
500,sp_workloads,1690805680,wl_small_mem,110,mixed:GM-LM-RR-LSVT-SGD-PATE-sub25100-defpa,3,greedy,block-composition,upc,equal-ncd,mixed:GM-LM-RR-LSVT-SGD-PATE,sub25100,nopa,Unlocking,0.2,GaussianMechanism,{'Optimal': 40},1094,1113,1104,18,106,285,1076,1007,819,1094,1113,1104,18,106,285,1076,1007,819,upc-block-composition
501,sp_workloads,1690805680,wl_small_mem,110,mixed:GM-LM-RR-LSVT-SGD-PATE-sub25100-defpa,3,greedy,block-composition,upc,equal-ncd,mixed:GM-LM-RR-LSVT-SGD-PATE,sub25100,nopa,Unlocking,0.2,LaplaceMechanism,{'Optimal': 40},1169,1154,1119,7,49,303,1162,1105,816,1169,1154,1119,7,49,303,1162,1105,816,upc-block-composition
502,sp_workloads,1690805680,wl_small_mem,110,mixed:GM-LM-RR-LSVT-SGD-PATE-sub25100-defpa,3,greedy,block-composition,upc,equal-ncd,mixed:GM-LM-RR-LSVT-SGD-PATE,sub25100,nopa,Unlocking,0.2,MLNoisySGDMechanism,{'Optimal': 40},1057,1087,1124,31,104,295,1026,983,829,1057,1087,1124,31,104,295,1026,983,829,upc-block-composition
503,sp_workloads,1690805680,wl_small_mem,110,mixed:GM-LM-RR-LSVT-SGD-PATE-sub25100-defpa,3,greedy,block-composition,upc,equal-ncd,mixed:GM-LM-RR-LSVT-SGD-PATE,sub25100,nopa,Unlocking,0.2,MLPateGaussianMechanism,{'Optimal': 40},1114,1105,1168,15,117,300,1099,988,868,1114,1105,1168,15,117,300,1099,988,868,upc-block-composition
504,sp_workloads,1690805680,wl_small_mem,110,mixed:GM-LM-RR-LSVT-SGD-PATE-sub25100-defpa,3,greedy,block-composition,upc,equal-ncd,mixed:GM-LM-RR-LSVT-SGD-PATE,sub25100,nopa,Unlocking,0.2,RandResponseMechanism,{'Optimal': 40},1160,1175,1154,6,37,283,1154,1138,871,1160,1175,1154,6,37,283,1154,1138,871,upc-block-composition
505,sp_workloads,1690805680,wl_small_mem,110,mixed:GM-LM-RR-LSVT-SGD-PATE-sub25100-defpa,3,greedy,block-composition,upc,equal-ncd,mixed:GM-LM-RR-LSVT-SGD-PATE,sub25100,nopa,Unlocking,0.2,SVTLaplaceMechanism,{'Optimal': 40},1080,1132,1168,2,39,308,1078,1093,860,1080,1132,1168,2,39,308,1078,1093,860,upc-block-composition
506,sp_workloads,1690805680,wl_small_mem,111,mixed:GM-LM-RR-LSVT-SGD-PATE-sub25100-defpa,3,greedy,block-composition,upc,equal-ncd,mixed:GM-LM-RR-LSVT-SGD-PATE,sub25100,nopa,Unlocking,0.4,GaussianMechanism,{'Optimal': 40},1094,1113,1104,16,98,268,1078,1015,836,1094,1113,1104,16,98,268,1078,1015,836,upc-block-composition
507,sp_workloads,1690805680,wl_small_mem,111,mixed:GM-LM-RR-LSVT-SGD-PATE-sub25100-defpa,3,greedy,block-composition,upc,equal-ncd,mixed:GM-LM-RR-LSVT-SGD-PATE,sub25100,nopa,Unlocking,0.4,LaplaceMechanism,{'Optimal': 40},1169,1154,1119,13,40,286,1156,1114,833,1169,1154,1119,13,40,286,1156,1114,833,upc-block-composition
508,sp_workloads,1690805680,wl_small_mem,111,mixed:GM-LM-RR-LSVT-SGD-PATE-sub25100-defpa,3,greedy,block-composition,upc,equal-ncd,mixed:GM-LM-RR-LSVT-SGD-PATE,sub25100,nopa,Unlocking,0.4,MLNoisySGDMechanism,{'Optimal': 40},1057,1087,1124,26,97,273,1031,990,851,1057,1087,1124,26,97,273,1031,990,851,upc-block-composition
509,sp_workloads,1690805680,wl_small_mem,111,mixed:GM-LM-RR-LSVT-SGD-PATE-sub25100-defpa,3,greedy,block-composition,upc,equal-ncd,mixed:GM-LM-RR-LSVT-SGD-PATE,sub25100,nopa,Unlocking,0.4,MLPateGaussianMechanism,{'Optimal': 40},1114,1105,1168,12,98,276,1102,1007,892,1114,1105,1168,12,98,276,1102,1007,892,upc-block-composition
510,sp_workloads,1690805680,wl_small_mem,111,mixed:GM-LM-RR-LSVT-SGD-PATE-sub25100-defpa,3,greedy,block-composition,upc,equal-ncd,mixed:GM-LM-RR-LSVT-SGD-PATE,sub25100,nopa,Unlocking,0.4,RandResponseMechanism,{'Optimal': 40},1160,1175,1154,12,32,261,1148,1143,893,1160,1175,1154,12,32,261,1148,1143,893,upc-block-composition
511,sp_workloads,1690805680,wl_small_mem,111,mixed:GM-LM-RR-LSVT-SGD-PATE-sub25100-defpa,3,greedy,block-composition,upc,equal-ncd,mixed:GM-LM-RR-LSVT-SGD-PATE,sub25100,nopa,Unlocking,0.4,SVTLaplaceMechanism,{'Optimal': 40},1080,1132,1168,10,36,278,1070,1096,890,1080,1132,1168,10,36,278,1070,1096,890,upc-block-composition
512,sp_workloads,1690805680,wl_small_mem,112,mixed:GM-LM-RR-LSVT-SGD-PATE-sub25100-defpa,4,greedy,block-composition,poisson,ncd,mixed:GM-LM-RR-LSVT-SGD-PATE,sub25100,nopa,Unlocking,0.2,GaussianMechanism,{'Optimal': 40},3164159,212016,19356,45563,6719,2194,3118596,205297,17162,1113,1088,1060,30,49,126,1083,1039,934,poisson-block-composition
513,sp_workloads,1690805680,wl_small_mem,112,mixed:GM-LM-RR-LSVT-SGD-PATE-sub25100-defpa,4,greedy,block-composition,poisson,ncd,mixed:GM-LM-RR-LSVT-SGD-PATE,sub25100,nopa,Unlocking,0.2,LaplaceMechanism,{'Optimal': 40},2854575,215653,19585,27346,3352,1952,2827229,212301,17633,1062,1115,1087,17,24,112,1045,1091,975,poisson-block-composition
514,sp_workloads,1690805680,wl_small_mem,112,mixed:GM-LM-RR-LSVT-SGD-PATE-sub25100-defpa,4,greedy,block-composition,poisson,ncd,mixed:GM-LM-RR-LSVT-SGD-PATE,sub25100,nopa,Unlocking,0.2,MLNoisySGDMechanism,{'Optimal': 40},3215801,221736,20277,47673,10430,2054,3168128,211306,18223,1144,1128,1131,24,50,122,1120,1078,1009,poisson-block-composition
515,sp_workloads,1690805680,wl_small_mem,112,mixed:GM-LM-RR-LSVT-SGD-PATE-sub25100-defpa,4,greedy,block-composition,poisson,ncd,mixed:GM-LM-RR-LSVT-SGD-PATE,sub25100,nopa,Unlocking,0.2,MLPateGaussianMechanism,{'Optimal': 40},3246364,219077,18914,26640,6717,2081,3219724,212360,16833,1154,1099,1070,17,51,127,1137,1048,943,poisson-block-composition
516,sp_workloads,1690805680,wl_small_mem,112,mixed:GM-LM-RR-LSVT-SGD-PATE-sub25100-defpa,4,greedy,block-composition,poisson,ncd,mixed:GM-LM-RR-LSVT-SGD-PATE,sub25100,nopa,Unlocking,0.2,RandResponseMechanism,{'Optimal': 40},3086084,218125,20774,23636,4957,1902,3062448,213168,18872,1149,1123,1162,14,35,114,1135,1088,1048,poisson-block-composition
517,sp_workloads,1690805680,wl_small_mem,112,mixed:GM-LM-RR-LSVT-SGD-PATE-sub25100-defpa,4,greedy,block-composition,poisson,ncd,mixed:GM-LM-RR-LSVT-SGD-PATE,sub25100,nopa,Unlocking,0.2,SVTLaplaceMechanism,{'Optimal': 40},3076541,223346,21123,11997,4300,1869,3064544,219046,19254,1073,1134,1197,13,36,115,1060,1098,1082,poisson-block-composition
518,sp_workloads,1690805680,wl_small_mem,113,mixed:GM-LM-RR-LSVT-SGD-PATE-sub25100-defpa,4,greedy,block-composition,poisson,ncd,mixed:GM-LM-RR-LSVT-SGD-PATE,sub25100,nopa,Unlocking,0.4,GaussianMechanism,{'Optimal': 40},3164159,212016,19356,35397,6185,2116,3128762,205831,17240,1113,1088,1060,27,55,124,1086,1033,936,poisson-block-composition
519,sp_workloads,1690805680,wl_small_mem,113,mixed:GM-LM-RR-LSVT-SGD-PATE-sub25100-defpa,4,greedy,block-composition,poisson,ncd,mixed:GM-LM-RR-LSVT-SGD-PATE,sub25100,nopa,Unlocking,0.4,LaplaceMechanism,{'Optimal': 40},2854575,215653,19585,37288,2330,1877,2817287,213323,17708,1062,1115,1087,19,22,107,1043,1093,980,poisson-block-composition
520,sp_workloads,1690805680,wl_small_mem,113,mixed:GM-LM-RR-LSVT-SGD-PATE-sub25100-defpa,4,greedy,block-composition,poisson,ncd,mixed:GM-LM-RR-LSVT-SGD-PATE,sub25100,nopa,Unlocking,0.4,MLNoisySGDMechanism,{'Optimal': 40},3215801,221736,20277,73828,6568,1901,3141973,215168,18376,1144,1128,1131,25,40,115,1119,1088,1016,poisson-block-composition
521,sp_workloads,1690805680,wl_small_mem,113,mixed:GM-LM-RR-LSVT-SGD-PATE-sub25100-defpa,4,greedy,block-composition,poisson,ncd,mixed:GM-LM-RR-LSVT-SGD-PATE,sub25100,nopa,Unlocking,0.4,MLPateGaussianMechanism,{'Optimal': 40},3246364,219077,18914,36854,9350,1702,3209510,209727,17212,1154,1099,1070,19,58,106,1135,1041,964,poisson-block-composition
522,sp_workloads,1690805680,wl_small_mem,113,mixed:GM-LM-RR-LSVT-SGD-PATE-sub25100-defpa,4,greedy,block-composition,poisson,ncd,mixed:GM-LM-RR-LSVT-SGD-PATE,sub25100,nopa,Unlocking,0.4,RandResponseMechanism,{'Optimal': 40},3086084,218125,20774,19544,3798,1704,3066540,214327,19070,1149,1123,1162,12,26,104,1137,1097,1058,poisson-block-composition
523,sp_workloads,1690805680,wl_small_mem,113,mixed:GM-LM-RR-LSVT-SGD-PATE-sub25100-defpa,4,greedy,block-composition,poisson,ncd,mixed:GM-LM-RR-LSVT-SGD-PATE,sub25100,nopa,Unlocking,0.4,SVTLaplaceMechanism,{'Optimal': 40},3076541,223346,21123,17434,4185,1885,3059107,219161,19238,1073,1134,1197,11,39,115,1062,1095,1082,poisson-block-composition
524,sp_workloads,1690805680,wl_small_mem,114,mixed:GM-LM-RR-LSVT-SGD-PATE-sub25100-defpa,4,greedy,block-composition,upc,ncd,mixed:GM-LM-RR-LSVT-SGD-PATE,sub25100,nopa,Unlocking,0.2,GaussianMechanism,{'Optimal': 40},3153220,205905,19356,28288,12588,4428,3124932,193317,14928,1113,1088,1060,29,112,276,1084,976,784,upc-block-composition
525,sp_workloads,1690805680,wl_small_mem,114,mixed:GM-LM-RR-LSVT-SGD-PATE-sub25100-defpa,4,greedy,block-composition,upc,ncd,mixed:GM-LM-RR-LSVT-SGD-PATE,sub25100,nopa,Unlocking,0.2,LaplaceMechanism,{'Optimal': 40},2793843,215187,19457,5630,2986,4292,2788213,212201,15165,1062,1115,1087,4,36,268,1058,1079,819,upc-block-composition
526,sp_workloads,1690805680,wl_small_mem,114,mixed:GM-LM-RR-LSVT-SGD-PATE-sub25100-defpa,4,greedy,block-composition,upc,ncd,mixed:GM-LM-RR-LSVT-SGD-PATE,sub25100,nopa,Unlocking,0.2,MLNoisySGDMechanism,{'Optimal': 40},3134809,228778,20357,35942,11300,4710,3098867,217478,15647,1144,1128,1131,29,105,298,1115,1023,833,upc-block-composition
527,sp_workloads,1690805680,wl_small_mem,114,mixed:GM-LM-RR-LSVT-SGD-PATE-sub25100-defpa,4,greedy,block-composition,upc,ncd,mixed:GM-LM-RR-LSVT-SGD-PATE,sub25100,nopa,Unlocking,0.2,MLPateGaussianMechanism,{'Optimal': 40},3244641,218308,19042,24014,13243,4515,3220627,205065,14527,1154,1099,1070,15,112,285,1139,987,785,upc-block-composition
528,sp_workloads,1690805680,wl_small_mem,114,mixed:GM-LM-RR-LSVT-SGD-PATE-sub25100-defpa,4,greedy,block-composition,upc,ncd,mixed:GM-LM-RR-LSVT-SGD-PATE,sub25100,nopa,Unlocking,0.2,RandResponseMechanism,{'Optimal': 40},3229961,212087,20918,683,2871,4469,3229278,209216,16449,1149,1123,1162,2,39,283,1147,1084,879,upc-block-composition
529,sp_workloads,1690805680,wl_small_mem,114,mixed:GM-LM-RR-LSVT-SGD-PATE-sub25100-defpa,4,greedy,block-composition,upc,ncd,mixed:GM-LM-RR-LSVT-SGD-PATE,sub25100,nopa,Unlocking,0.2,SVTLaplaceMechanism,{'Optimal': 40},3098261,219430,21459,6553,4587,4624,3091708,214843,16835,1073,1134,1197,4,47,288,1069,1087,909,upc-block-composition
530,sp_workloads,1690805680,wl_small_mem,115,mixed:GM-LM-RR-LSVT-SGD-PATE-sub25100-defpa,4,greedy,block-composition,upc,ncd,mixed:GM-LM-RR-LSVT-SGD-PATE,sub25100,nopa,Unlocking,0.4,GaussianMechanism,{'Optimal': 40},3153220,205905,19356,21610,7415,3851,3131610,198490,15505,1113,1088,1060,20,82,245,1093,1006,815,upc-block-composition
531,sp_workloads,1690805680,wl_small_mem,115,mixed:GM-LM-RR-LSVT-SGD-PATE-sub25100-defpa,4,greedy,block-composition,upc,ncd,mixed:GM-LM-RR-LSVT-SGD-PATE,sub25100,nopa,Unlocking,0.4,LaplaceMechanism,{'Optimal': 40},2793843,215187,19457,26368,2277,3631,2767475,212910,15826,1062,1115,1087,18,25,225,1044,1090,862,upc-block-composition
532,sp_workloads,1690805680,wl_small_mem,115,mixed:GM-LM-RR-LSVT-SGD-PATE-sub25100-defpa,4,greedy,block-composition,upc,ncd,mixed:GM-LM-RR-LSVT-SGD-PATE,sub25100,nopa,Unlocking,0.4,MLNoisySGDMechanism,{'Optimal': 40},3134809,228778,20357,24967,12812,4420,3109842,215966,15937,1144,1128,1131,21,102,284,1123,1026,847,upc-block-composition
533,sp_workloads,1690805680,wl_small_mem,115,mixed:GM-LM-RR-LSVT-SGD-PATE-sub25100-defpa,4,greedy,block-composition,upc,ncd,mixed:GM-LM-RR-LSVT-SGD-PATE,sub25100,nopa,Unlocking,0.4,MLPateGaussianMechanism,{'Optimal': 40},3244641,218308,19042,16171,9592,4274,3228470,208716,14768,1154,1099,1070,13,94,270,1141,1005,800,upc-block-composition
534,sp_workloads,1690805680,wl_small_mem,115,mixed:GM-LM-RR-LSVT-SGD-PATE-sub25100-defpa,4,greedy,block-composition,upc,ncd,mixed:GM-LM-RR-LSVT-SGD-PATE,sub25100,nopa,Unlocking,0.4,RandResponseMechanism,{'Optimal': 40},3229961,212087,20918,8537,3351,4344,3221424,208736,16574,1149,1123,1162,12,36,280,1137,1087,882,upc-block-composition
535,sp_workloads,1690805680,wl_small_mem,115,mixed:GM-LM-RR-LSVT-SGD-PATE-sub25100-defpa,4,greedy,block-composition,upc,ncd,mixed:GM-LM-RR-LSVT-SGD-PATE,sub25100,nopa,Unlocking,0.4,SVTLaplaceMechanism,{'Optimal': 40},3098261,219430,21459,10051,3524,4413,3088210,215906,17046,1073,1134,1197,9,41,275,1064,1093,922,upc-block-composition
536,sp_workloads,1690805680,wl_small_mem,116,mixed:GM-LM-RR-LSVT-SGD-PATE-sub25100-defpa,4,greedy,block-composition,poisson,equal-ncd,mixed:GM-LM-RR-LSVT-SGD-PATE,sub25100,nopa,Unlocking,0.2,GaussianMechanism,{'Optimal': 40},1113,1088,1060,30,49,126,1083,1039,934,1113,1088,1060,30,49,126,1083,1039,934,poisson-block-composition
537,sp_workloads,1690805680,wl_small_mem,116,mixed:GM-LM-RR-LSVT-SGD-PATE-sub25100-defpa,4,greedy,block-composition,poisson,equal-ncd,mixed:GM-LM-RR-LSVT-SGD-PATE,sub25100,nopa,Unlocking,0.2,LaplaceMechanism,{'Optimal': 40},1062,1115,1087,17,24,112,1045,1091,975,1062,1115,1087,17,24,112,1045,1091,975,poisson-block-composition
538,sp_workloads,1690805680,wl_small_mem,116,mixed:GM-LM-RR-LSVT-SGD-PATE-sub25100-defpa,4,greedy,block-composition,poisson,equal-ncd,mixed:GM-LM-RR-LSVT-SGD-PATE,sub25100,nopa,Unlocking,0.2,MLNoisySGDMechanism,{'Optimal': 40},1144,1128,1131,24,50,122,1120,1078,1009,1144,1128,1131,24,50,122,1120,1078,1009,poisson-block-composition
539,sp_workloads,1690805680,wl_small_mem,116,mixed:GM-LM-RR-LSVT-SGD-PATE-sub25100-defpa,4,greedy,block-composition,poisson,equal-ncd,mixed:GM-LM-RR-LSVT-SGD-PATE,sub25100,nopa,Unlocking,0.2,MLPateGaussianMechanism,{'Optimal': 40},1154,1099,1070,17,51,127,1137,1048,943,1154,1099,1070,17,51,127,1137,1048,943,poisson-block-composition
540,sp_workloads,1690805680,wl_small_mem,116,mixed:GM-LM-RR-LSVT-SGD-PATE-sub25100-defpa,4,greedy,block-composition,poisson,equal-ncd,mixed:GM-LM-RR-LSVT-SGD-PATE,sub25100,nopa,Unlocking,0.2,RandResponseMechanism,{'Optimal': 40},1149,1123,1162,14,35,114,1135,1088,1048,1149,1123,1162,14,35,114,1135,1088,1048,poisson-block-composition
541,sp_workloads,1690805680,wl_small_mem,116,mixed:GM-LM-RR-LSVT-SGD-PATE-sub25100-defpa,4,greedy,block-composition,poisson,equal-ncd,mixed:GM-LM-RR-LSVT-SGD-PATE,sub25100,nopa,Unlocking,0.2,SVTLaplaceMechanism,{'Optimal': 40},1073,1134,1197,13,36,115,1060,1098,1082,1073,1134,1197,13,36,115,1060,1098,1082,poisson-block-composition
542,sp_workloads,1690805680,wl_small_mem,117,mixed:GM-LM-RR-LSVT-SGD-PATE-sub25100-defpa,4,greedy,block-composition,poisson,equal-ncd,mixed:GM-LM-RR-LSVT-SGD-PATE,sub25100,nopa,Unlocking,0.4,GaussianMechanism,{'Optimal': 40},1113,1088,1060,27,55,124,1086,1033,936,1113,1088,1060,27,55,124,1086,1033,936,poisson-block-composition
543,sp_workloads,1690805680,wl_small_mem,117,mixed:GM-LM-RR-LSVT-SGD-PATE-sub25100-defpa,4,greedy,block-composition,poisson,equal-ncd,mixed:GM-LM-RR-LSVT-SGD-PATE,sub25100,nopa,Unlocking,0.4,LaplaceMechanism,{'Optimal': 40},1062,1115,1087,19,22,107,1043,1093,980,1062,1115,1087,19,22,107,1043,1093,980,poisson-block-composition
544,sp_workloads,1690805680,wl_small_mem,117,mixed:GM-LM-RR-LSVT-SGD-PATE-sub25100-defpa,4,greedy,block-composition,poisson,equal-ncd,mixed:GM-LM-RR-LSVT-SGD-PATE,sub25100,nopa,Unlocking,0.4,MLNoisySGDMechanism,{'Optimal': 40},1144,1128,1131,25,40,115,1119,1088,1016,1144,1128,1131,25,40,115,1119,1088,1016,poisson-block-composition
545,sp_workloads,1690805680,wl_small_mem,117,mixed:GM-LM-RR-LSVT-SGD-PATE-sub25100-defpa,4,greedy,block-composition,poisson,equal-ncd,mixed:GM-LM-RR-LSVT-SGD-PATE,sub25100,nopa,Unlocking,0.4,MLPateGaussianMechanism,{'Optimal': 40},1154,1099,1070,19,58,106,1135,1041,964,1154,1099,1070,19,58,106,1135,1041,964,poisson-block-composition
546,sp_workloads,1690805680,wl_small_mem,117,mixed:GM-LM-RR-LSVT-SGD-PATE-sub25100-defpa,4,greedy,block-composition,poisson,equal-ncd,mixed:GM-LM-RR-LSVT-SGD-PATE,sub25100,nopa,Unlocking,0.4,RandResponseMechanism,{'Optimal': 40},1149,1123,1162,12,26,104,1137,1097,1058,1149,1123,1162,12,26,104,1137,1097,1058,poisson-block-composition
547,sp_workloads,1690805680,wl_small_mem,117,mixed:GM-LM-RR-LSVT-SGD-PATE-sub25100-defpa,4,greedy,block-composition,poisson,equal-ncd,mixed:GM-LM-RR-LSVT-SGD-PATE,sub25100,nopa,Unlocking,0.4,SVTLaplaceMechanism,{'Optimal': 40},1073,1134,1197,11,39,115,1062,1095,1082,1073,1134,1197,11,39,115,1062,1095,1082,poisson-block-composition
548,sp_workloads,1690805680,wl_small_mem,118,mixed:GM-LM-RR-LSVT-SGD-PATE-sub25100-defpa,4,greedy,block-composition,upc,equal-ncd,mixed:GM-LM-RR-LSVT-SGD-PATE,sub25100,nopa,Unlocking,0.2,GaussianMechanism,{'Optimal': 40},1113,1088,1060,29,112,276,1084,976,784,1113,1088,1060,29,112,276,1084,976,784,upc-block-composition
549,sp_workloads,1690805680,wl_small_mem,118,mixed:GM-LM-RR-LSVT-SGD-PATE-sub25100-defpa,4,greedy,block-composition,upc,equal-ncd,mixed:GM-LM-RR-LSVT-SGD-PATE,sub25100,nopa,Unlocking,0.2,LaplaceMechanism,{'Optimal': 40},1062,1115,1087,4,36,268,1058,1079,819,1062,1115,1087,4,36,268,1058,1079,819,upc-block-composition
550,sp_workloads,1690805680,wl_small_mem,118,mixed:GM-LM-RR-LSVT-SGD-PATE-sub25100-defpa,4,greedy,block-composition,upc,equal-ncd,mixed:GM-LM-RR-LSVT-SGD-PATE,sub25100,nopa,Unlocking,0.2,MLNoisySGDMechanism,{'Optimal': 40},1144,1128,1131,29,105,298,1115,1023,833,1144,1128,1131,29,105,298,1115,1023,833,upc-block-composition
551,sp_workloads,1690805680,wl_small_mem,118,mixed:GM-LM-RR-LSVT-SGD-PATE-sub25100-defpa,4,greedy,block-composition,upc,equal-ncd,mixed:GM-LM-RR-LSVT-SGD-PATE,sub25100,nopa,Unlocking,0.2,MLPateGaussianMechanism,{'Optimal': 40},1154,1099,1070,15,112,285,1139,987,785,1154,1099,1070,15,112,285,1139,987,785,upc-block-composition
552,sp_workloads,1690805680,wl_small_mem,118,mixed:GM-LM-RR-LSVT-SGD-PATE-sub25100-defpa,4,greedy,block-composition,upc,equal-ncd,mixed:GM-LM-RR-LSVT-SGD-PATE,sub25100,nopa,Unlocking,0.2,RandResponseMechanism,{'Optimal': 40},1149,1123,1162,2,39,283,1147,1084,879,1149,1123,1162,2,39,283,1147,1084,879,upc-block-composition
553,sp_workloads,1690805680,wl_small_mem,118,mixed:GM-LM-RR-LSVT-SGD-PATE-sub25100-defpa,4,greedy,block-composition,upc,equal-ncd,mixed:GM-LM-RR-LSVT-SGD-PATE,sub25100,nopa,Unlocking,0.2,SVTLaplaceMechanism,{'Optimal': 40},1073,1134,1197,4,47,288,1069,1087,909,1073,1134,1197,4,47,288,1069,1087,909,upc-block-composition
554,sp_workloads,1690805680,wl_small_mem,119,mixed:GM-LM-RR-LSVT-SGD-PATE-sub25100-defpa,4,greedy,block-composition,upc,equal-ncd,mixed:GM-LM-RR-LSVT-SGD-PATE,sub25100,nopa,Unlocking,0.4,GaussianMechanism,{'Optimal': 40},1113,1088,1060,20,82,245,1093,1006,815,1113,1088,1060,20,82,245,1093,1006,815,upc-block-composition
555,sp_workloads,1690805680,wl_small_mem,119,mixed:GM-LM-RR-LSVT-SGD-PATE-sub25100-defpa,4,greedy,block-composition,upc,equal-ncd,mixed:GM-LM-RR-LSVT-SGD-PATE,sub25100,nopa,Unlocking,0.4,LaplaceMechanism,{'Optimal': 40},1062,1115,1087,18,25,225,1044,1090,862,1062,1115,1087,18,25,225,1044,1090,862,upc-block-composition
556,sp_workloads,1690805680,wl_small_mem,119,mixed:GM-LM-RR-LSVT-SGD-PATE-sub25100-defpa,4,greedy,block-composition,upc,equal-ncd,mixed:GM-LM-RR-LSVT-SGD-PATE,sub25100,nopa,Unlocking,0.4,MLNoisySGDMechanism,{'Optimal': 40},1144,1128,1131,21,102,284,1123,1026,847,1144,1128,1131,21,102,284,1123,1026,847,upc-block-composition
557,sp_workloads,1690805680,wl_small_mem,119,mixed:GM-LM-RR-LSVT-SGD-PATE-sub25100-defpa,4,greedy,block-composition,upc,equal-ncd,mixed:GM-LM-RR-LSVT-SGD-PATE,sub25100,nopa,Unlocking,0.4,MLPateGaussianMechanism,{'Optimal': 40},1154,1099,1070,13,94,270,1141,1005,800,1154,1099,1070,13,94,270,1141,1005,800,upc-block-composition
558,sp_workloads,1690805680,wl_small_mem,119,mixed:GM-LM-RR-LSVT-SGD-PATE-sub25100-defpa,4,greedy,block-composition,upc,equal-ncd,mixed:GM-LM-RR-LSVT-SGD-PATE,sub25100,nopa,Unlocking,0.4,RandResponseMechanism,{'Optimal': 40},1149,1123,1162,12,36,280,1137,1087,882,1149,1123,1162,12,36,280,1137,1087,882,upc-block-composition
559,sp_workloads,1690805680,wl_small_mem,119,mixed:GM-LM-RR-LSVT-SGD-PATE-sub25100-defpa,4,greedy,block-composition,upc,equal-ncd,mixed:GM-LM-RR-LSVT-SGD-PATE,sub25100,nopa,Unlocking,0.4,SVTLaplaceMechanism,{'Optimal': 40},1073,1134,1197,9,41,275,1064,1093,922,1073,1134,1197,9,41,275,1064,1093,922,upc-block-composition
560,sp_workloads,1690805680,wl_small_mem,120,basic:GM-LM-RR-LSVT-sub25100-defpa,0,greedy,block-composition,poisson,ncd,basic:GM-LM-RR-LSVT,sub25100,nopa,Unlocking,0.2,GaussianMechanism,{'Optimal': 40},4847751,317174,28905,27235,11603,2841,4820516,305571,26064,1760,1618,1607,29,78,167,1731,1540,1440,poisson-block-composition
561,sp_workloads,1690805680,wl_small_mem,120,basic:GM-LM-RR-LSVT-sub25100-defpa,0,greedy,block-composition,poisson,ncd,basic:GM-LM-RR-LSVT,sub25100,nopa,Unlocking,0.2,LaplaceMechanism,{'Optimal': 40},4580618,310999,29482,27143,6207,3062,4553475,304792,26420,1690,1679,1654,23,50,186,1667,1629,1468,poisson-block-composition
562,sp_workloads,1690805680,wl_small_mem,120,basic:GM-LM-RR-LSVT-sub25100-defpa,0,greedy,block-composition,poisson,ncd,basic:GM-LM-RR-LSVT,sub25100,nopa,Unlocking,0.2,RandResponseMechanism,{'Optimal': 40},4834309,320190,30099,26184,7419,2718,4808125,312771,27381,1752,1677,1693,15,49,162,1737,1628,1531,poisson-block-composition
563,sp_workloads,1690805680,wl_small_mem,120,basic:GM-LM-RR-LSVT-sub25100-defpa,0,greedy,block-composition,poisson,ncd,basic:GM-LM-RR-LSVT,sub25100,nopa,Unlocking,0.2,SVTLaplaceMechanism,{'Optimal': 40},4502539,307841,30348,16743,6233,2969,4485796,301608,27379,1685,1652,1684,18,52,167,1667,1600,1517,poisson-block-composition
564,sp_workloads,1690805680,wl_small_mem,121,basic:GM-LM-RR-LSVT-sub25100-defpa,0,greedy,block-composition,poisson,ncd,basic:GM-LM-RR-LSVT,sub25100,nopa,Unlocking,0.4,GaussianMechanism,{'Optimal': 40},4847751,317174,28905,28497,9751,2660,4819254,307423,26245,1760,1618,1607,25,75,156,1735,1543,1451,poisson-block-composition
565,sp_workloads,1690805680,wl_small_mem,121,basic:GM-LM-RR-LSVT-sub25100-defpa,0,greedy,block-composition,poisson,ncd,basic:GM-LM-RR-LSVT,sub25100,nopa,Unlocking,0.4,LaplaceMechanism,{'Optimal': 40},4580618,310999,29482,23630,4948,2834,4556988,306051,26648,1690,1679,1654,21,46,174,1669,1633,1480,poisson-block-composition
566,sp_workloads,1690805680,wl_small_mem,121,basic:GM-LM-RR-LSVT-sub25100-defpa,0,greedy,block-composition,poisson,ncd,basic:GM-LM-RR-LSVT,sub25100,nopa,Unlocking,0.4,RandResponseMechanism,{'Optimal': 40},4834309,320190,30099,24831,5866,2631,4809478,314324,27468,1752,1677,1693,14,44,153,1738,1633,1540,poisson-block-composition
567,sp_workloads,1690805680,wl_small_mem,121,basic:GM-LM-RR-LSVT-sub25100-defpa,0,greedy,block-composition,poisson,ncd,basic:GM-LM-RR-LSVT,sub25100,nopa,Unlocking,0.4,SVTLaplaceMechanism,{'Optimal': 40},4502539,307841,30348,25842,5632,2818,4476697,302209,27530,1685,1652,1684,12,44,158,1673,1608,1526,poisson-block-composition
568,sp_workloads,1690805680,wl_small_mem,122,basic:GM-LM-RR-LSVT-sub25100-defpa,0,greedy,block-composition,upc,ncd,basic:GM-LM-RR-LSVT,sub25100,nopa,Unlocking,0.2,GaussianMechanism,{'Optimal': 40},4839540,325950,29705,32800,21766,7543,4806740,304184,22162,1760,1618,1607,25,226,489,1735,1392,1118,upc-block-composition
569,sp_workloads,1690805680,wl_small_mem,122,basic:GM-LM-RR-LSVT-sub25100-defpa,0,greedy,block-composition,upc,ncd,basic:GM-LM-RR-LSVT,sub25100,nopa,Unlocking,0.2,LaplaceMechanism,{'Optimal': 40},4568749,317398,30234,9201,6079,8392,4559548,311319,21842,1690,1679,1654,9,68,536,1681,1611,1118,upc-block-composition
570,sp_workloads,1690805680,wl_small_mem,122,basic:GM-LM-RR-LSVT-sub25100-defpa,0,greedy,block-composition,upc,ncd,basic:GM-LM-RR-LSVT,sub25100,nopa,Unlocking,0.2,RandResponseMechanism,{'Optimal': 40},4657750,323549,30931,7817,5356,8108,4649933,318193,22823,1752,1677,1693,7,63,516,1745,1614,1177,upc-block-composition
571,sp_workloads,1690805680,wl_small_mem,122,basic:GM-LM-RR-LSVT-sub25100-defpa,0,greedy,block-composition,upc,ncd,basic:GM-LM-RR-LSVT,sub25100,nopa,Unlocking,0.2,SVTLaplaceMechanism,{'Optimal': 40},4659614,324927,30284,8558,6403,8607,4651056,318524,21677,1685,1652,1684,7,74,545,1678,1578,1139,upc-block-composition
572,sp_workloads,1690805680,wl_small_mem,123,basic:GM-LM-RR-LSVT-sub25100-defpa,0,greedy,block-composition,upc,ncd,basic:GM-LM-RR-LSVT,sub25100,nopa,Unlocking,0.4,GaussianMechanism,{'Optimal': 40},4839540,325950,29705,30505,22641,7851,4809035,303309,21854,1760,1618,1607,22,207,501,1738,1411,1106,upc-block-composition
573,sp_workloads,1690805680,wl_small_mem,123,basic:GM-LM-RR-LSVT-sub25100-defpa,0,greedy,block-composition,upc,ncd,basic:GM-LM-RR-LSVT,sub25100,nopa,Unlocking,0.4,LaplaceMechanism,{'Optimal': 40},4568749,317398,30234,7452,4487,8812,4561297,312911,21422,1690,1679,1654,12,46,564,1678,1633,1090,upc-block-composition
574,sp_workloads,1690805680,wl_small_mem,123,basic:GM-LM-RR-LSVT-sub25100-defpa,0,greedy,block-composition,upc,ncd,basic:GM-LM-RR-LSVT,sub25100,nopa,Unlocking,0.4,RandResponseMechanism,{'Optimal': 40},4657750,323549,30931,19254,4957,8718,4638496,318592,22213,1752,1677,1693,16,48,546,1736,1629,1147,upc-block-composition
575,sp_workloads,1690805680,wl_small_mem,123,basic:GM-LM-RR-LSVT-sub25100-defpa,0,greedy,block-composition,upc,ncd,basic:GM-LM-RR-LSVT,sub25100,nopa,Unlocking,0.4,SVTLaplaceMechanism,{'Optimal': 40},4659614,324927,30284,18847,5050,8971,4640767,319877,21313,1685,1652,1684,17,50,565,1668,1602,1119,upc-block-composition
576,sp_workloads,1690805680,wl_small_mem,124,basic:GM-LM-RR-LSVT-sub25100-defpa,0,greedy,block-composition,poisson,equal-ncd,basic:GM-LM-RR-LSVT,sub25100,nopa,Unlocking,0.2,GaussianMechanism,{'Optimal': 40},1760,1618,1607,29,78,167,1731,1540,1440,1760,1618,1607,29,78,167,1731,1540,1440,poisson-block-composition
577,sp_workloads,1690805680,wl_small_mem,124,basic:GM-LM-RR-LSVT-sub25100-defpa,0,greedy,block-composition,poisson,equal-ncd,basic:GM-LM-RR-LSVT,sub25100,nopa,Unlocking,0.2,LaplaceMechanism,{'Optimal': 40},1690,1679,1654,23,50,186,1667,1629,1468,1690,1679,1654,23,50,186,1667,1629,1468,poisson-block-composition
578,sp_workloads,1690805680,wl_small_mem,124,basic:GM-LM-RR-LSVT-sub25100-defpa,0,greedy,block-composition,poisson,equal-ncd,basic:GM-LM-RR-LSVT,sub25100,nopa,Unlocking,0.2,RandResponseMechanism,{'Optimal': 40},1752,1677,1693,15,49,162,1737,1628,1531,1752,1677,1693,15,49,162,1737,1628,1531,poisson-block-composition
579,sp_workloads,1690805680,wl_small_mem,124,basic:GM-LM-RR-LSVT-sub25100-defpa,0,greedy,block-composition,poisson,equal-ncd,basic:GM-LM-RR-LSVT,sub25100,nopa,Unlocking,0.2,SVTLaplaceMechanism,{'Optimal': 40},1685,1652,1684,18,52,167,1667,1600,1517,1685,1652,1684,18,52,167,1667,1600,1517,poisson-block-composition
580,sp_workloads,1690805680,wl_small_mem,125,basic:GM-LM-RR-LSVT-sub25100-defpa,0,greedy,block-composition,poisson,equal-ncd,basic:GM-LM-RR-LSVT,sub25100,nopa,Unlocking,0.4,GaussianMechanism,{'Optimal': 40},1760,1618,1607,25,75,156,1735,1543,1451,1760,1618,1607,25,75,156,1735,1543,1451,poisson-block-composition
581,sp_workloads,1690805680,wl_small_mem,125,basic:GM-LM-RR-LSVT-sub25100-defpa,0,greedy,block-composition,poisson,equal-ncd,basic:GM-LM-RR-LSVT,sub25100,nopa,Unlocking,0.4,LaplaceMechanism,{'Optimal': 40},1690,1679,1654,21,46,174,1669,1633,1480,1690,1679,1654,21,46,174,1669,1633,1480,poisson-block-composition
582,sp_workloads,1690805680,wl_small_mem,125,basic:GM-LM-RR-LSVT-sub25100-defpa,0,greedy,block-composition,poisson,equal-ncd,basic:GM-LM-RR-LSVT,sub25100,nopa,Unlocking,0.4,RandResponseMechanism,{'Optimal': 40},1752,1677,1693,14,44,153,1738,1633,1540,1752,1677,1693,14,44,153,1738,1633,1540,poisson-block-composition
583,sp_workloads,1690805680,wl_small_mem,125,basic:GM-LM-RR-LSVT-sub25100-defpa,0,greedy,block-composition,poisson,equal-ncd,basic:GM-LM-RR-LSVT,sub25100,nopa,Unlocking,0.4,SVTLaplaceMechanism,{'Optimal': 40},1685,1652,1684,12,44,158,1673,1608,1526,1685,1652,1684,12,44,158,1673,1608,1526,poisson-block-composition
584,sp_workloads,1690805680,wl_small_mem,126,basic:GM-LM-RR-LSVT-sub25100-defpa,0,greedy,block-composition,upc,equal-ncd,basic:GM-LM-RR-LSVT,sub25100,nopa,Unlocking,0.2,GaussianMechanism,{'Optimal': 40},1760,1618,1607,25,226,489,1735,1392,1118,1760,1618,1607,25,226,489,1735,1392,1118,upc-block-composition
585,sp_workloads,1690805680,wl_small_mem,126,basic:GM-LM-RR-LSVT-sub25100-defpa,0,greedy,block-composition,upc,equal-ncd,basic:GM-LM-RR-LSVT,sub25100,nopa,Unlocking,0.2,LaplaceMechanism,{'Optimal': 40},1690,1679,1654,9,68,536,1681,1611,1118,1690,1679,1654,9,68,536,1681,1611,1118,upc-block-composition
586,sp_workloads,1690805680,wl_small_mem,126,basic:GM-LM-RR-LSVT-sub25100-defpa,0,greedy,block-composition,upc,equal-ncd,basic:GM-LM-RR-LSVT,sub25100,nopa,Unlocking,0.2,RandResponseMechanism,{'Optimal': 40},1752,1677,1693,7,63,516,1745,1614,1177,1752,1677,1693,7,63,516,1745,1614,1177,upc-block-composition
587,sp_workloads,1690805680,wl_small_mem,126,basic:GM-LM-RR-LSVT-sub25100-defpa,0,greedy,block-composition,upc,equal-ncd,basic:GM-LM-RR-LSVT,sub25100,nopa,Unlocking,0.2,SVTLaplaceMechanism,{'Optimal': 40},1685,1652,1684,7,74,545,1678,1578,1139,1685,1652,1684,7,74,545,1678,1578,1139,upc-block-composition
588,sp_workloads,1690805680,wl_small_mem,127,basic:GM-LM-RR-LSVT-sub25100-defpa,0,greedy,block-composition,upc,equal-ncd,basic:GM-LM-RR-LSVT,sub25100,nopa,Unlocking,0.4,GaussianMechanism,{'Optimal': 40},1760,1618,1607,22,207,501,1738,1411,1106,1760,1618,1607,22,207,501,1738,1411,1106,upc-block-composition
589,sp_workloads,1690805680,wl_small_mem,127,basic:GM-LM-RR-LSVT-sub25100-defpa,0,greedy,block-composition,upc,equal-ncd,basic:GM-LM-RR-LSVT,sub25100,nopa,Unlocking,0.4,LaplaceMechanism,{'Optimal': 40},1690,1679,1654,12,46,564,1678,1633,1090,1690,1679,1654,12,46,564,1678,1633,1090,upc-block-composition
590,sp_workloads,1690805680,wl_small_mem,127,basic:GM-LM-RR-LSVT-sub25100-defpa,0,greedy,block-composition,upc,equal-ncd,basic:GM-LM-RR-LSVT,sub25100,nopa,Unlocking,0.4,RandResponseMechanism,{'Optimal': 40},1752,1677,1693,16,48,546,1736,1629,1147,1752,1677,1693,16,48,546,1736,1629,1147,upc-block-composition
591,sp_workloads,1690805680,wl_small_mem,127,basic:GM-LM-RR-LSVT-sub25100-defpa,0,greedy,block-composition,upc,equal-ncd,basic:GM-LM-RR-LSVT,sub25100,nopa,Unlocking,0.4,SVTLaplaceMechanism,{'Optimal': 40},1685,1652,1684,17,50,565,1668,1602,1119,1685,1652,1684,17,50,565,1668,1602,1119,upc-block-composition
592,sp_workloads,1690805680,wl_small_mem,128,basic:GM-LM-RR-LSVT-sub25100-defpa,1,greedy,block-composition,poisson,ncd,basic:GM-LM-RR-LSVT,sub25100,nopa,Unlocking,0.2,GaussianMechanism,{'Optimal': 40},4674135,351804,29818,64538,17368,2781,4609597,334436,27037,1725,1745,1670,42,113,163,1683,1632,1507,poisson-block-composition
593,sp_workloads,1690805680,wl_small_mem,128,basic:GM-LM-RR-LSVT-sub25100-defpa,1,greedy,block-composition,poisson,ncd,basic:GM-LM-RR-LSVT,sub25100,nopa,Unlocking,0.2,LaplaceMechanism,{'Optimal': 40},4701336,316959,30901,10440,7808,3480,4690896,309151,27421,1705,1659,1707,16,57,200,1689,1602,1507,poisson-block-composition
594,sp_workloads,1690805680,wl_small_mem,128,basic:GM-LM-RR-LSVT-sub25100-defpa,1,greedy,block-composition,poisson,ncd,basic:GM-LM-RR-LSVT,sub25100,nopa,Unlocking,0.2,RandResponseMechanism,{'Optimal': 40},4751311,334074,30363,16030,4960,2981,4735281,329114,27382,1634,1678,1701,15,38,171,1619,1640,1530,poisson-block-composition
595,sp_workloads,1690805680,wl_small_mem,128,basic:GM-LM-RR-LSVT-sub25100-defpa,1,greedy,block-composition,poisson,ncd,basic:GM-LM-RR-LSVT,sub25100,nopa,Unlocking,0.2,SVTLaplaceMechanism,{'Optimal': 40},4658717,301226,29963,14469,6451,2794,4644248,294775,27169,1700,1628,1669,13,53,166,1687,1575,1503,poisson-block-composition
596,sp_workloads,1690805680,wl_small_mem,129,basic:GM-LM-RR-LSVT-sub25100-defpa,1,greedy,block-composition,poisson,ncd,basic:GM-LM-RR-LSVT,sub25100,nopa,Unlocking,0.4,GaussianMechanism,{'Optimal': 40},4674135,351804,29818,58107,16634,3117,4616028,335170,26701,1725,1745,1670,35,112,179,1690,1633,1491,poisson-block-composition
597,sp_workloads,1690805680,wl_small_mem,129,basic:GM-LM-RR-LSVT-sub25100-defpa,1,greedy,block-composition,poisson,ncd,basic:GM-LM-RR-LSVT,sub25100,nopa,Unlocking,0.4,LaplaceMechanism,{'Optimal': 40},4701336,316959,30901,16233,6253,4147,4685103,310706,26754,1705,1659,1707,18,44,237,1687,1615,1470,poisson-block-composition
598,sp_workloads,1690805680,wl_small_mem,129,basic:GM-LM-RR-LSVT-sub25100-defpa,1,greedy,block-composition,poisson,ncd,basic:GM-LM-RR-LSVT,sub25100,nopa,Unlocking,0.4,RandResponseMechanism,{'Optimal': 40},4751311,334074,30363,21994,4085,3024,4729317,329989,27339,1634,1678,1701,17,37,176,1617,1641,1525,poisson-block-composition
599,sp_workloads,1690805680,wl_small_mem,129,basic:GM-LM-RR-LSVT-sub25100-defpa,1,greedy,block-composition,poisson,ncd,basic:GM-LM-RR-LSVT,sub25100,nopa,Unlocking,0.4,SVTLaplaceMechanism,{'Optimal': 40},4658717,301226,29963,12425,4336,3008,4646292,296890,26955,1700,1628,1669,10,38,176,1690,1590,1493,poisson-block-composition
600,sp_workloads,1690805680,wl_small_mem,130,basic:GM-LM-RR-LSVT-sub25100-defpa,1,greedy,block-composition,upc,ncd,basic:GM-LM-RR-LSVT,sub25100,nopa,Unlocking,0.2,GaussianMechanism,{'Optimal': 40},4676698,329662,29265,24015,27882,7860,4652683,301780,21405,1725,1745,1670,24,261,506,1701,1484,1164,upc-block-composition
601,sp_workloads,1690805680,wl_small_mem,130,basic:GM-LM-RR-LSVT-sub25100-defpa,1,greedy,block-composition,upc,ncd,basic:GM-LM-RR-LSVT,sub25100,nopa,Unlocking,0.2,LaplaceMechanism,{'Optimal': 40},4681859,300972,30705,3321,9378,7815,4678538,291594,22890,1705,1659,1707,3,72,499,1702,1587,1208,upc-block-composition
602,sp_workloads,1690805680,wl_small_mem,130,basic:GM-LM-RR-LSVT-sub25100-defpa,1,greedy,block-composition,upc,ncd,basic:GM-LM-RR-LSVT,sub25100,nopa,Unlocking,0.2,RandResponseMechanism,{'Optimal': 40},4647322,315319,30810,5020,4353,7665,4642302,310966,23145,1634,1678,1701,5,52,487,1629,1626,1214,upc-block-composition
603,sp_workloads,1690805680,wl_small_mem,130,basic:GM-LM-RR-LSVT-sub25100-defpa,1,greedy,block-composition,upc,ncd,basic:GM-LM-RR-LSVT,sub25100,nopa,Unlocking,0.2,SVTLaplaceMechanism,{'Optimal': 40},4823541,315411,30210,4178,6905,7860,4819363,308506,22350,1700,1628,1669,5,64,491,1695,1564,1178,upc-block-composition
604,sp_workloads,1690805680,wl_small_mem,131,basic:GM-LM-RR-LSVT-sub25100-defpa,1,greedy,block-composition,upc,ncd,basic:GM-LM-RR-LSVT,sub25100,nopa,Unlocking,0.4,GaussianMechanism,{'Optimal': 40},4676698,329662,29265,20953,22772,7200,4655745,306890,22065,1725,1745,1670,25,226,463,1700,1519,1207,upc-block-composition
605,sp_workloads,1690805680,wl_small_mem,131,basic:GM-LM-RR-LSVT-sub25100-defpa,1,greedy,block-composition,upc,ncd,basic:GM-LM-RR-LSVT,sub25100,nopa,Unlocking,0.4,LaplaceMechanism,{'Optimal': 40},4681859,300972,30705,15811,5715,7440,4666048,295257,23265,1705,1659,1707,12,46,471,1693,1613,1236,upc-block-composition
606,sp_workloads,1690805680,wl_small_mem,131,basic:GM-LM-RR-LSVT-sub25100-defpa,1,greedy,block-composition,upc,ncd,basic:GM-LM-RR-LSVT,sub25100,nopa,Unlocking,0.4,RandResponseMechanism,{'Optimal': 40},4647322,315319,30810,15076,2904,7245,4632246,312415,23565,1634,1678,1701,12,42,461,1622,1636,1240,upc-block-composition
607,sp_workloads,1690805680,wl_small_mem,131,basic:GM-LM-RR-LSVT-sub25100-defpa,1,greedy,block-composition,upc,ncd,basic:GM-LM-RR-LSVT,sub25100,nopa,Unlocking,0.4,SVTLaplaceMechanism,{'Optimal': 40},4823541,315411,30210,22563,5039,6960,4800978,310372,23250,1700,1628,1669,15,58,438,1685,1570,1231,upc-block-composition
608,sp_workloads,1690805680,wl_small_mem,132,basic:GM-LM-RR-LSVT-sub25100-defpa,1,greedy,block-composition,poisson,equal-ncd,basic:GM-LM-RR-LSVT,sub25100,nopa,Unlocking,0.2,GaussianMechanism,{'Optimal': 40},1725,1745,1670,42,113,163,1683,1632,1507,1725,1745,1670,42,113,163,1683,1632,1507,poisson-block-composition
609,sp_workloads,1690805680,wl_small_mem,132,basic:GM-LM-RR-LSVT-sub25100-defpa,1,greedy,block-composition,poisson,equal-ncd,basic:GM-LM-RR-LSVT,sub25100,nopa,Unlocking,0.2,LaplaceMechanism,{'Optimal': 40},1705,1659,1707,16,57,200,1689,1602,1507,1705,1659,1707,16,57,200,1689,1602,1507,poisson-block-composition
610,sp_workloads,1690805680,wl_small_mem,132,basic:GM-LM-RR-LSVT-sub25100-defpa,1,greedy,block-composition,poisson,equal-ncd,basic:GM-LM-RR-LSVT,sub25100,nopa,Unlocking,0.2,RandResponseMechanism,{'Optimal': 40},1634,1678,1701,15,38,171,1619,1640,1530,1634,1678,1701,15,38,171,1619,1640,1530,poisson-block-composition
611,sp_workloads,1690805680,wl_small_mem,132,basic:GM-LM-RR-LSVT-sub25100-defpa,1,greedy,block-composition,poisson,equal-ncd,basic:GM-LM-RR-LSVT,sub25100,nopa,Unlocking,0.2,SVTLaplaceMechanism,{'Optimal': 40},1700,1628,1669,13,53,166,1687,1575,1503,1700,1628,1669,13,53,166,1687,1575,1503,poisson-block-composition
612,sp_workloads,1690805680,wl_small_mem,133,basic:GM-LM-RR-LSVT-sub25100-defpa,1,greedy,block-composition,poisson,equal-ncd,basic:GM-LM-RR-LSVT,sub25100,nopa,Unlocking,0.4,GaussianMechanism,{'Optimal': 40},1725,1745,1670,35,112,179,1690,1633,1491,1725,1745,1670,35,112,179,1690,1633,1491,poisson-block-composition
613,sp_workloads,1690805680,wl_small_mem,133,basic:GM-LM-RR-LSVT-sub25100-defpa,1,greedy,block-composition,poisson,equal-ncd,basic:GM-LM-RR-LSVT,sub25100,nopa,Unlocking,0.4,LaplaceMechanism,{'Optimal': 40},1705,1659,1707,18,44,237,1687,1615,1470,1705,1659,1707,18,44,237,1687,1615,1470,poisson-block-composition
614,sp_workloads,1690805680,wl_small_mem,133,basic:GM-LM-RR-LSVT-sub25100-defpa,1,greedy,block-composition,poisson,equal-ncd,basic:GM-LM-RR-LSVT,sub25100,nopa,Unlocking,0.4,RandResponseMechanism,{'Optimal': 40},1634,1678,1701,17,37,176,1617,1641,1525,1634,1678,1701,17,37,176,1617,1641,1525,poisson-block-composition
615,sp_workloads,1690805680,wl_small_mem,133,basic:GM-LM-RR-LSVT-sub25100-defpa,1,greedy,block-composition,poisson,equal-ncd,basic:GM-LM-RR-LSVT,sub25100,nopa,Unlocking,0.4,SVTLaplaceMechanism,{'Optimal': 40},1700,1628,1669,10,38,176,1690,1590,1493,1700,1628,1669,10,38,176,1690,1590,1493,poisson-block-composition
616,sp_workloads,1690805680,wl_small_mem,134,basic:GM-LM-RR-LSVT-sub25100-defpa,1,greedy,block-composition,upc,equal-ncd,basic:GM-LM-RR-LSVT,sub25100,nopa,Unlocking,0.2,GaussianMechanism,{'Optimal': 40},1725,1745,1670,24,261,506,1701,1484,1164,1725,1745,1670,24,261,506,1701,1484,1164,upc-block-composition
617,sp_workloads,1690805680,wl_small_mem,134,basic:GM-LM-RR-LSVT-sub25100-defpa,1,greedy,block-composition,upc,equal-ncd,basic:GM-LM-RR-LSVT,sub25100,nopa,Unlocking,0.2,LaplaceMechanism,{'Optimal': 40},1705,1659,1707,3,72,499,1702,1587,1208,1705,1659,1707,3,72,499,1702,1587,1208,upc-block-composition
618,sp_workloads,1690805680,wl_small_mem,134,basic:GM-LM-RR-LSVT-sub25100-defpa,1,greedy,block-composition,upc,equal-ncd,basic:GM-LM-RR-LSVT,sub25100,nopa,Unlocking,0.2,RandResponseMechanism,{'Optimal': 40},1634,1678,1701,5,52,487,1629,1626,1214,1634,1678,1701,5,52,487,1629,1626,1214,upc-block-composition
619,sp_workloads,1690805680,wl_small_mem,134,basic:GM-LM-RR-LSVT-sub25100-defpa,1,greedy,block-composition,upc,equal-ncd,basic:GM-LM-RR-LSVT,sub25100,nopa,Unlocking,0.2,SVTLaplaceMechanism,{'Optimal': 40},1700,1628,1669,5,64,491,1695,1564,1178,1700,1628,1669,5,64,491,1695,1564,1178,upc-block-composition
620,sp_workloads,1690805680,wl_small_mem,135,basic:GM-LM-RR-LSVT-sub25100-defpa,1,greedy,block-composition,upc,equal-ncd,basic:GM-LM-RR-LSVT,sub25100,nopa,Unlocking,0.4,GaussianMechanism,{'Optimal': 40},1725,1745,1670,25,226,463,1700,1519,1207,1725,1745,1670,25,226,463,1700,1519,1207,upc-block-composition
621,sp_workloads,1690805680,wl_small_mem,135,basic:GM-LM-RR-LSVT-sub25100-defpa,1,greedy,block-composition,upc,equal-ncd,basic:GM-LM-RR-LSVT,sub25100,nopa,Unlocking,0.4,LaplaceMechanism,{'Optimal': 40},1705,1659,1707,12,46,471,1693,1613,1236,1705,1659,1707,12,46,471,1693,1613,1236,upc-block-composition
622,sp_workloads,1690805680,wl_small_mem,135,basic:GM-LM-RR-LSVT-sub25100-defpa,1,greedy,block-composition,upc,equal-ncd,basic:GM-LM-RR-LSVT,sub25100,nopa,Unlocking,0.4,RandResponseMechanism,{'Optimal': 40},1634,1678,1701,12,42,461,1622,1636,1240,1634,1678,1701,12,42,461,1622,1636,1240,upc-block-composition
623,sp_workloads,1690805680,wl_small_mem,135,basic:GM-LM-RR-LSVT-sub25100-defpa,1,greedy,block-composition,upc,equal-ncd,basic:GM-LM-RR-LSVT,sub25100,nopa,Unlocking,0.4,SVTLaplaceMechanism,{'Optimal': 40},1700,1628,1669,15,58,438,1685,1570,1231,1700,1628,1669,15,58,438,1685,1570,1231,upc-block-composition
624,sp_workloads,1690805680,wl_small_mem,136,basic:GM-LM-RR-LSVT-sub25100-defpa,2,greedy,block-composition,poisson,ncd,basic:GM-LM-RR-LSVT,sub25100,nopa,Unlocking,0.2,GaussianMechanism,{'Optimal': 40},4344073,336565,33248,35403,15010,3184,4308670,321555,30064,1647,1671,1731,25,85,185,1622,1586,1546,poisson-block-composition
625,sp_workloads,1690805680,wl_small_mem,136,basic:GM-LM-RR-LSVT-sub25100-defpa,2,greedy,block-composition,poisson,ncd,basic:GM-LM-RR-LSVT,sub25100,nopa,Unlocking,0.2,LaplaceMechanism,{'Optimal': 40},4548967,333299,30800,25374,6087,2992,4523593,327212,27808,1660,1661,1646,14,45,176,1646,1616,1470,poisson-block-composition
626,sp_workloads,1690805680,wl_small_mem,136,basic:GM-LM-RR-LSVT-sub25100-defpa,2,greedy,block-composition,poisson,ncd,basic:GM-LM-RR-LSVT,sub25100,nopa,Unlocking,0.2,RandResponseMechanism,{'Optimal': 40},5016525,328891,32448,21903,8812,3376,4994622,320079,29072,1714,1690,1723,15,45,185,1699,1645,1538,poisson-block-composition
627,sp_workloads,1690805680,wl_small_mem,136,basic:GM-LM-RR-LSVT-sub25100-defpa,2,greedy,block-composition,poisson,ncd,basic:GM-LM-RR-LSVT,sub25100,nopa,Unlocking,0.2,SVTLaplaceMechanism,{'Optimal': 40},4781610,327880,32576,18691,7650,2912,4762919,320230,29664,1631,1679,1700,16,47,165,1615,1632,1535,poisson-block-composition
628,sp_workloads,1690805680,wl_small_mem,137,basic:GM-LM-RR-LSVT-sub25100-defpa,2,greedy,block-composition,poisson,ncd,basic:GM-LM-RR-LSVT,sub25100,nopa,Unlocking,0.4,GaussianMechanism,{'Optimal': 40},4344073,336565,33248,40341,12981,3504,4303732,323584,29744,1647,1671,1731,26,85,203,1621,1586,1528,poisson-block-composition
629,sp_workloads,1690805680,wl_small_mem,137,basic:GM-LM-RR-LSVT-sub25100-defpa,2,greedy,block-composition,poisson,ncd,basic:GM-LM-RR-LSVT,sub25100,nopa,Unlocking,0.4,LaplaceMechanism,{'Optimal': 40},4548967,333299,30800,25310,3926,3088,4523657,329373,27712,1660,1661,1646,10,44,181,1650,1617,1465,poisson-block-composition
630,sp_workloads,1690805680,wl_small_mem,137,basic:GM-LM-RR-LSVT-sub25100-defpa,2,greedy,block-composition,poisson,ncd,basic:GM-LM-RR-LSVT,sub25100,nopa,Unlocking,0.4,RandResponseMechanism,{'Optimal': 40},5016525,328891,32448,21196,7604,3584,4995329,321287,28864,1714,1690,1723,10,43,203,1704,1647,1520,poisson-block-composition
631,sp_workloads,1690805680,wl_small_mem,137,basic:GM-LM-RR-LSVT-sub25100-defpa,2,greedy,block-composition,poisson,ncd,basic:GM-LM-RR-LSVT,sub25100,nopa,Unlocking,0.4,SVTLaplaceMechanism,{'Optimal': 40},4781610,327880,32576,39760,7182,3152,4741850,320698,29424,1631,1679,1700,22,46,181,1609,1633,1519,poisson-block-composition
632,sp_workloads,1690805680,wl_small_mem,138,basic:GM-LM-RR-LSVT-sub25100-defpa,2,greedy,block-composition,upc,ncd,basic:GM-LM-RR-LSVT,sub25100,nopa,Unlocking,0.2,GaussianMechanism,{'Optimal': 40},4516798,323421,31309,27536,21387,7952,4489262,302034,23357,1647,1671,1731,24,216,512,1623,1455,1219,upc-block-composition
633,sp_workloads,1690805680,wl_small_mem,138,basic:GM-LM-RR-LSVT-sub25100-defpa,2,greedy,block-composition,upc,ncd,basic:GM-LM-RR-LSVT,sub25100,nopa,Unlocking,0.2,LaplaceMechanism,{'Optimal': 40},4830469,312603,29634,12347,5791,8216,4818122,306812,21418,1660,1661,1646,10,62,520,1650,1599,1126,upc-block-composition
634,sp_workloads,1690805680,wl_small_mem,138,basic:GM-LM-RR-LSVT-sub25100-defpa,2,greedy,block-composition,upc,ncd,basic:GM-LM-RR-LSVT,sub25100,nopa,Unlocking,0.2,RandResponseMechanism,{'Optimal': 40},4802902,316035,30613,14924,6320,8192,4787978,309715,22421,1714,1690,1723,9,71,528,1705,1619,1195,upc-block-composition
635,sp_workloads,1690805680,wl_small_mem,138,basic:GM-LM-RR-LSVT-sub25100-defpa,2,greedy,block-composition,upc,ncd,basic:GM-LM-RR-LSVT,sub25100,nopa,Unlocking,0.2,SVTLaplaceMechanism,{'Optimal': 40},4594159,320873,30876,2303,6816,8087,4591856,314057,22789,1631,1679,1700,4,69,521,1627,1610,1179,upc-block-composition
636,sp_workloads,1690805680,wl_small_mem,139,basic:GM-LM-RR-LSVT-sub25100-defpa,2,greedy,block-composition,upc,ncd,basic:GM-LM-RR-LSVT,sub25100,nopa,Unlocking,0.4,GaussianMechanism,{'Optimal': 40},4516798,323421,31309,22579,21102,7520,4494219,302319,23789,1647,1671,1731,19,213,480,1628,1458,1251,upc-block-composition
637,sp_workloads,1690805680,wl_small_mem,139,basic:GM-LM-RR-LSVT-sub25100-defpa,2,greedy,block-composition,upc,ncd,basic:GM-LM-RR-LSVT,sub25100,nopa,Unlocking,0.4,LaplaceMechanism,{'Optimal': 40},4830469,312603,29634,21006,4499,7617,4809463,308104,22017,1660,1661,1646,18,40,479,1642,1621,1167,upc-block-composition
638,sp_workloads,1690805680,wl_small_mem,139,basic:GM-LM-RR-LSVT-sub25100-defpa,2,greedy,block-composition,upc,ncd,basic:GM-LM-RR-LSVT,sub25100,nopa,Unlocking,0.4,RandResponseMechanism,{'Optimal': 40},4802902,316035,30613,23348,4295,7620,4779554,311740,22993,1714,1690,1723,16,51,492,1698,1639,1231,upc-block-composition
639,sp_workloads,1690805680,wl_small_mem,139,basic:GM-LM-RR-LSVT-sub25100-defpa,2,greedy,block-composition,upc,ncd,basic:GM-LM-RR-LSVT,sub25100,nopa,Unlocking,0.4,SVTLaplaceMechanism,{'Optimal': 40},4594159,320873,30876,13327,4408,7681,4580832,316465,23195,1631,1679,1700,17,52,495,1614,1627,1205,upc-block-composition
640,sp_workloads,1690805680,wl_small_mem,140,basic:GM-LM-RR-LSVT-sub25100-defpa,2,greedy,block-composition,poisson,equal-ncd,basic:GM-LM-RR-LSVT,sub25100,nopa,Unlocking,0.2,GaussianMechanism,{'Optimal': 40},1647,1671,1731,25,85,185,1622,1586,1546,1647,1671,1731,25,85,185,1622,1586,1546,poisson-block-composition
641,sp_workloads,1690805680,wl_small_mem,140,basic:GM-LM-RR-LSVT-sub25100-defpa,2,greedy,block-composition,poisson,equal-ncd,basic:GM-LM-RR-LSVT,sub25100,nopa,Unlocking,0.2,LaplaceMechanism,{'Optimal': 40},1660,1661,1646,14,45,176,1646,1616,1470,1660,1661,1646,14,45,176,1646,1616,1470,poisson-block-composition
642,sp_workloads,1690805680,wl_small_mem,140,basic:GM-LM-RR-LSVT-sub25100-defpa,2,greedy,block-composition,poisson,equal-ncd,basic:GM-LM-RR-LSVT,sub25100,nopa,Unlocking,0.2,RandResponseMechanism,{'Optimal': 40},1714,1690,1723,15,45,185,1699,1645,1538,1714,1690,1723,15,45,185,1699,1645,1538,poisson-block-composition
643,sp_workloads,1690805680,wl_small_mem,140,basic:GM-LM-RR-LSVT-sub25100-defpa,2,greedy,block-composition,poisson,equal-ncd,basic:GM-LM-RR-LSVT,sub25100,nopa,Unlocking,0.2,SVTLaplaceMechanism,{'Optimal': 40},1631,1679,1700,16,47,165,1615,1632,1535,1631,1679,1700,16,47,165,1615,1632,1535,poisson-block-composition
644,sp_workloads,1690805680,wl_small_mem,141,basic:GM-LM-RR-LSVT-sub25100-defpa,2,greedy,block-composition,poisson,equal-ncd,basic:GM-LM-RR-LSVT,sub25100,nopa,Unlocking,0.4,GaussianMechanism,{'Optimal': 40},1647,1671,1731,26,85,203,1621,1586,1528,1647,1671,1731,26,85,203,1621,1586,1528,poisson-block-composition
645,sp_workloads,1690805680,wl_small_mem,141,basic:GM-LM-RR-LSVT-sub25100-defpa,2,greedy,block-composition,poisson,equal-ncd,basic:GM-LM-RR-LSVT,sub25100,nopa,Unlocking,0.4,LaplaceMechanism,{'Optimal': 40},1660,1661,1646,10,44,181,1650,1617,1465,1660,1661,1646,10,44,181,1650,1617,1465,poisson-block-composition
646,sp_workloads,1690805680,wl_small_mem,141,basic:GM-LM-RR-LSVT-sub25100-defpa,2,greedy,block-composition,poisson,equal-ncd,basic:GM-LM-RR-LSVT,sub25100,nopa,Unlocking,0.4,RandResponseMechanism,{'Optimal': 40},1714,1690,1723,10,43,203,1704,1647,1520,1714,1690,1723,10,43,203,1704,1647,1520,poisson-block-composition
647,sp_workloads,1690805680,wl_small_mem,141,basic:GM-LM-RR-LSVT-sub25100-defpa,2,greedy,block-composition,poisson,equal-ncd,basic:GM-LM-RR-LSVT,sub25100,nopa,Unlocking,0.4,SVTLaplaceMechanism,{'Optimal': 40},1631,1679,1700,22,46,181,1609,1633,1519,1631,1679,1700,22,46,181,1609,1633,1519,poisson-block-composition
648,sp_workloads,1690805680,wl_small_mem,142,basic:GM-LM-RR-LSVT-sub25100-defpa,2,greedy,block-composition,upc,equal-ncd,basic:GM-LM-RR-LSVT,sub25100,nopa,Unlocking,0.2,GaussianMechanism,{'Optimal': 40},1647,1671,1731,24,216,512,1623,1455,1219,1647,1671,1731,24,216,512,1623,1455,1219,upc-block-composition
649,sp_workloads,1690805680,wl_small_mem,142,basic:GM-LM-RR-LSVT-sub25100-defpa,2,greedy,block-composition,upc,equal-ncd,basic:GM-LM-RR-LSVT,sub25100,nopa,Unlocking,0.2,LaplaceMechanism,{'Optimal': 40},1660,1661,1646,10,62,520,1650,1599,1126,1660,1661,1646,10,62,520,1650,1599,1126,upc-block-composition
650,sp_workloads,1690805680,wl_small_mem,142,basic:GM-LM-RR-LSVT-sub25100-defpa,2,greedy,block-composition,upc,equal-ncd,basic:GM-LM-RR-LSVT,sub25100,nopa,Unlocking,0.2,RandResponseMechanism,{'Optimal': 40},1714,1690,1723,9,71,528,1705,1619,1195,1714,1690,1723,9,71,528,1705,1619,1195,upc-block-composition
651,sp_workloads,1690805680,wl_small_mem,142,basic:GM-LM-RR-LSVT-sub25100-defpa,2,greedy,block-composition,upc,equal-ncd,basic:GM-LM-RR-LSVT,sub25100,nopa,Unlocking,0.2,SVTLaplaceMechanism,{'Optimal': 40},1631,1679,1700,4,69,521,1627,1610,1179,1631,1679,1700,4,69,521,1627,1610,1179,upc-block-composition
652,sp_workloads,1690805680,wl_small_mem,143,basic:GM-LM-RR-LSVT-sub25100-defpa,2,greedy,block-composition,upc,equal-ncd,basic:GM-LM-RR-LSVT,sub25100,nopa,Unlocking,0.4,GaussianMechanism,{'Optimal': 40},1647,1671,1731,19,213,480,1628,1458,1251,1647,1671,1731,19,213,480,1628,1458,1251,upc-block-composition
653,sp_workloads,1690805680,wl_small_mem,143,basic:GM-LM-RR-LSVT-sub25100-defpa,2,greedy,block-composition,upc,equal-ncd,basic:GM-LM-RR-LSVT,sub25100,nopa,Unlocking,0.4,LaplaceMechanism,{'Optimal': 40},1660,1661,1646,18,40,479,1642,1621,1167,1660,1661,1646,18,40,479,1642,1621,1167,upc-block-composition
654,sp_workloads,1690805680,wl_small_mem,143,basic:GM-LM-RR-LSVT-sub25100-defpa,2,greedy,block-composition,upc,equal-ncd,basic:GM-LM-RR-LSVT,sub25100,nopa,Unlocking,0.4,RandResponseMechanism,{'Optimal': 40},1714,1690,1723,16,51,492,1698,1639,1231,1714,1690,1723,16,51,492,1698,1639,1231,upc-block-composition
655,sp_workloads,1690805680,wl_small_mem,143,basic:GM-LM-RR-LSVT-sub25100-defpa,2,greedy,block-composition,upc,equal-ncd,basic:GM-LM-RR-LSVT,sub25100,nopa,Unlocking,0.4,SVTLaplaceMechanism,{'Optimal': 40},1631,1679,1700,17,52,495,1614,1627,1205,1631,1679,1700,17,52,495,1614,1627,1205,upc-block-composition
656,sp_workloads,1690805680,wl_small_mem,144,basic:GM-LM-RR-LSVT-sub25100-defpa,3,greedy,block-composition,poisson,ncd,basic:GM-LM-RR-LSVT,sub25100,nopa,Unlocking,0.2,GaussianMechanism,{'Optimal': 40},4431438,335185,30243,48672,15663,3025,4382766,319522,27218,1636,1707,1661,27,98,175,1609,1609,1486,poisson-block-composition
657,sp_workloads,1690805680,wl_small_mem,144,basic:GM-LM-RR-LSVT-sub25100-defpa,3,greedy,block-composition,poisson,ncd,basic:GM-LM-RR-LSVT,sub25100,nopa,Unlocking,0.2,LaplaceMechanism,{'Optimal': 40},4614241,302136,30909,35897,3569,3743,4578344,298567,27166,1669,1590,1731,24,43,225,1645,1547,1506,poisson-block-composition
658,sp_workloads,1690805680,wl_small_mem,144,basic:GM-LM-RR-LSVT-sub25100-defpa,3,greedy,block-composition,poisson,ncd,basic:GM-LM-RR-LSVT,sub25100,nopa,Unlocking,0.2,RandResponseMechanism,{'Optimal': 40},4710432,347409,29228,15306,7102,3081,4695126,340307,26147,1691,1685,1636,13,53,183,1678,1632,1453,poisson-block-composition
659,sp_workloads,1690805680,wl_small_mem,144,basic:GM-LM-RR-LSVT-sub25100-defpa,3,greedy,block-composition,poisson,ncd,basic:GM-LM-RR-LSVT,sub25100,nopa,Unlocking,0.2,SVTLaplaceMechanism,{'Optimal': 40},4781445,315437,29779,21115,6009,3023,4760330,309428,26756,1697,1624,1645,20,45,177,1677,1579,1468,poisson-block-composition
660,sp_workloads,1690805680,wl_small_mem,145,basic:GM-LM-RR-LSVT-sub25100-defpa,3,greedy,block-composition,poisson,ncd,basic:GM-LM-RR-LSVT,sub25100,nopa,Unlocking,0.4,GaussianMechanism,{'Optimal': 40},4431438,335185,30243,41618,13267,2446,4389820,321918,27797,1636,1707,1661,23,82,146,1613,1625,1515,poisson-block-composition
661,sp_workloads,1690805680,wl_small_mem,145,basic:GM-LM-RR-LSVT-sub25100-defpa,3,greedy,block-composition,poisson,ncd,basic:GM-LM-RR-LSVT,sub25100,nopa,Unlocking,0.4,LaplaceMechanism,{'Optimal': 40},4614241,302136,30909,35423,3304,3139,4578818,298832,27770,1669,1590,1731,19,36,189,1650,1554,1542,poisson-block-composition
662,sp_workloads,1690805680,wl_small_mem,145,basic:GM-LM-RR-LSVT-sub25100-defpa,3,greedy,block-composition,poisson,ncd,basic:GM-LM-RR-LSVT,sub25100,nopa,Unlocking,0.4,RandResponseMechanism,{'Optimal': 40},4710432,347409,29228,34980,3116,2825,4675452,344293,26403,1691,1685,1636,16,30,167,1675,1655,1469,poisson-block-composition
663,sp_workloads,1690805680,wl_small_mem,145,basic:GM-LM-RR-LSVT-sub25100-defpa,3,greedy,block-composition,poisson,ncd,basic:GM-LM-RR-LSVT,sub25100,nopa,Unlocking,0.4,SVTLaplaceMechanism,{'Optimal': 40},4781445,315437,29779,23888,5057,2813,4757557,310380,26966,1697,1624,1645,17,38,163,1680,1586,1482,poisson-block-composition
664,sp_workloads,1690805680,wl_small_mem,146,basic:GM-LM-RR-LSVT-sub25100-defpa,3,greedy,block-composition,upc,ncd,basic:GM-LM-RR-LSVT,sub25100,nopa,Unlocking,0.2,GaussianMechanism,{'Optimal': 40},4564359,342607,29747,31602,18147,7818,4532757,324460,21929,1636,1707,1661,21,203,502,1615,1504,1159,upc-block-composition
665,sp_workloads,1690805680,wl_small_mem,146,basic:GM-LM-RR-LSVT-sub25100-defpa,3,greedy,block-composition,upc,ncd,basic:GM-LM-RR-LSVT,sub25100,nopa,Unlocking,0.2,LaplaceMechanism,{'Optimal': 40},4480666,307160,31021,10986,5731,8827,4469680,301429,22194,1669,1590,1731,7,60,565,1662,1530,1166,upc-block-composition
666,sp_workloads,1690805680,wl_small_mem,146,basic:GM-LM-RR-LSVT-sub25100-defpa,3,greedy,block-composition,upc,ncd,basic:GM-LM-RR-LSVT,sub25100,nopa,Unlocking,0.2,RandResponseMechanism,{'Optimal': 40},4713077,327965,29084,6878,7056,8571,4706199,320909,20513,1691,1685,1636,10,79,549,1681,1606,1087,upc-block-composition
667,sp_workloads,1690805680,wl_small_mem,146,basic:GM-LM-RR-LSVT-sub25100-defpa,3,greedy,block-composition,upc,ncd,basic:GM-LM-RR-LSVT,sub25100,nopa,Unlocking,0.2,SVTLaplaceMechanism,{'Optimal': 40},4783523,317659,29347,14227,5729,7498,4769296,311930,21849,1697,1624,1645,7,63,486,1690,1561,1159,upc-block-composition
668,sp_workloads,1690805680,wl_small_mem,147,basic:GM-LM-RR-LSVT-sub25100-defpa,3,greedy,block-composition,upc,ncd,basic:GM-LM-RR-LSVT,sub25100,nopa,Unlocking,0.4,GaussianMechanism,{'Optimal': 40},4564359,342607,29747,24161,22714,7070,4540198,319893,22677,1636,1707,1661,16,227,450,1620,1480,1211,upc-block-composition
669,sp_workloads,1690805680,wl_small_mem,147,basic:GM-LM-RR-LSVT-sub25100-defpa,3,greedy,block-composition,upc,ncd,basic:GM-LM-RR-LSVT,sub25100,nopa,Unlocking,0.4,LaplaceMechanism,{'Optimal': 40},4480666,307160,31021,21553,3862,8291,4459113,303298,22730,1669,1590,1731,18,41,525,1651,1549,1206,upc-block-composition
670,sp_workloads,1690805680,wl_small_mem,147,basic:GM-LM-RR-LSVT-sub25100-defpa,3,greedy,block-composition,upc,ncd,basic:GM-LM-RR-LSVT,sub25100,nopa,Unlocking,0.4,RandResponseMechanism,{'Optimal': 40},4713077,327965,29084,12403,4388,7752,4700674,323577,21332,1691,1685,1636,14,60,488,1677,1625,1148,upc-block-composition
671,sp_workloads,1690805680,wl_small_mem,147,basic:GM-LM-RR-LSVT-sub25100-defpa,3,greedy,block-composition,upc,ncd,basic:GM-LM-RR-LSVT,sub25100,nopa,Unlocking,0.4,SVTLaplaceMechanism,{'Optimal': 40},4783523,317659,29347,22878,3951,7069,4760645,313708,22278,1697,1624,1645,18,49,451,1679,1575,1194,upc-block-composition
672,sp_workloads,1690805680,wl_small_mem,148,basic:GM-LM-RR-LSVT-sub25100-defpa,3,greedy,block-composition,poisson,equal-ncd,basic:GM-LM-RR-LSVT,sub25100,nopa,Unlocking,0.2,GaussianMechanism,{'Optimal': 40},1636,1707,1661,27,98,175,1609,1609,1486,1636,1707,1661,27,98,175,1609,1609,1486,poisson-block-composition
673,sp_workloads,1690805680,wl_small_mem,148,basic:GM-LM-RR-LSVT-sub25100-defpa,3,greedy,block-composition,poisson,equal-ncd,basic:GM-LM-RR-LSVT,sub25100,nopa,Unlocking,0.2,LaplaceMechanism,{'Optimal': 40},1669,1590,1731,24,43,225,1645,1547,1506,1669,1590,1731,24,43,225,1645,1547,1506,poisson-block-composition
674,sp_workloads,1690805680,wl_small_mem,148,basic:GM-LM-RR-LSVT-sub25100-defpa,3,greedy,block-composition,poisson,equal-ncd,basic:GM-LM-RR-LSVT,sub25100,nopa,Unlocking,0.2,RandResponseMechanism,{'Optimal': 40},1691,1685,1636,13,53,183,1678,1632,1453,1691,1685,1636,13,53,183,1678,1632,1453,poisson-block-composition
675,sp_workloads,1690805680,wl_small_mem,148,basic:GM-LM-RR-LSVT-sub25100-defpa,3,greedy,block-composition,poisson,equal-ncd,basic:GM-LM-RR-LSVT,sub25100,nopa,Unlocking,0.2,SVTLaplaceMechanism,{'Optimal': 40},1697,1624,1645,20,45,177,1677,1579,1468,1697,1624,1645,20,45,177,1677,1579,1468,poisson-block-composition
676,sp_workloads,1690805680,wl_small_mem,149,basic:GM-LM-RR-LSVT-sub25100-defpa,3,greedy,block-composition,poisson,equal-ncd,basic:GM-LM-RR-LSVT,sub25100,nopa,Unlocking,0.4,GaussianMechanism,{'Optimal': 40},1636,1707,1661,23,82,146,1613,1625,1515,1636,1707,1661,23,82,146,1613,1625,1515,poisson-block-composition
677,sp_workloads,1690805680,wl_small_mem,149,basic:GM-LM-RR-LSVT-sub25100-defpa,3,greedy,block-composition,poisson,equal-ncd,basic:GM-LM-RR-LSVT,sub25100,nopa,Unlocking,0.4,LaplaceMechanism,{'Optimal': 40},1669,1590,1731,19,36,189,1650,1554,1542,1669,1590,1731,19,36,189,1650,1554,1542,poisson-block-composition
678,sp_workloads,1690805680,wl_small_mem,149,basic:GM-LM-RR-LSVT-sub25100-defpa,3,greedy,block-composition,poisson,equal-ncd,basic:GM-LM-RR-LSVT,sub25100,nopa,Unlocking,0.4,RandResponseMechanism,{'Optimal': 40},1691,1685,1636,16,30,167,1675,1655,1469,1691,1685,1636,16,30,167,1675,1655,1469,poisson-block-composition
679,sp_workloads,1690805680,wl_small_mem,149,basic:GM-LM-RR-LSVT-sub25100-defpa,3,greedy,block-composition,poisson,equal-ncd,basic:GM-LM-RR-LSVT,sub25100,nopa,Unlocking,0.4,SVTLaplaceMechanism,{'Optimal': 40},1697,1624,1645,17,38,163,1680,1586,1482,1697,1624,1645,17,38,163,1680,1586,1482,poisson-block-composition
680,sp_workloads,1690805680,wl_small_mem,150,basic:GM-LM-RR-LSVT-sub25100-defpa,3,greedy,block-composition,upc,equal-ncd,basic:GM-LM-RR-LSVT,sub25100,nopa,Unlocking,0.2,GaussianMechanism,{'Optimal': 40},1636,1707,1661,21,203,502,1615,1504,1159,1636,1707,1661,21,203,502,1615,1504,1159,upc-block-composition
681,sp_workloads,1690805680,wl_small_mem,150,basic:GM-LM-RR-LSVT-sub25100-defpa,3,greedy,block-composition,upc,equal-ncd,basic:GM-LM-RR-LSVT,sub25100,nopa,Unlocking,0.2,LaplaceMechanism,{'Optimal': 40},1669,1590,1731,7,60,565,1662,1530,1166,1669,1590,1731,7,60,565,1662,1530,1166,upc-block-composition
682,sp_workloads,1690805680,wl_small_mem,150,basic:GM-LM-RR-LSVT-sub25100-defpa,3,greedy,block-composition,upc,equal-ncd,basic:GM-LM-RR-LSVT,sub25100,nopa,Unlocking,0.2,RandResponseMechanism,{'Optimal': 40},1691,1685,1636,10,79,549,1681,1606,1087,1691,1685,1636,10,79,549,1681,1606,1087,upc-block-composition
683,sp_workloads,1690805680,wl_small_mem,150,basic:GM-LM-RR-LSVT-sub25100-defpa,3,greedy,block-composition,upc,equal-ncd,basic:GM-LM-RR-LSVT,sub25100,nopa,Unlocking,0.2,SVTLaplaceMechanism,{'Optimal': 40},1697,1624,1645,7,63,486,1690,1561,1159,1697,1624,1645,7,63,486,1690,1561,1159,upc-block-composition
684,sp_workloads,1690805680,wl_small_mem,151,basic:GM-LM-RR-LSVT-sub25100-defpa,3,greedy,block-composition,upc,equal-ncd,basic:GM-LM-RR-LSVT,sub25100,nopa,Unlocking,0.4,GaussianMechanism,{'Optimal': 40},1636,1707,1661,16,227,450,1620,1480,1211,1636,1707,1661,16,227,450,1620,1480,1211,upc-block-composition
685,sp_workloads,1690805680,wl_small_mem,151,basic:GM-LM-RR-LSVT-sub25100-defpa,3,greedy,block-composition,upc,equal-ncd,basic:GM-LM-RR-LSVT,sub25100,nopa,Unlocking,0.4,LaplaceMechanism,{'Optimal': 40},1669,1590,1731,18,41,525,1651,1549,1206,1669,1590,1731,18,41,525,1651,1549,1206,upc-block-composition
686,sp_workloads,1690805680,wl_small_mem,151,basic:GM-LM-RR-LSVT-sub25100-defpa,3,greedy,block-composition,upc,equal-ncd,basic:GM-LM-RR-LSVT,sub25100,nopa,Unlocking,0.4,RandResponseMechanism,{'Optimal': 40},1691,1685,1636,14,60,488,1677,1625,1148,1691,1685,1636,14,60,488,1677,1625,1148,upc-block-composition
687,sp_workloads,1690805680,wl_small_mem,151,basic:GM-LM-RR-LSVT-sub25100-defpa,3,greedy,block-composition,upc,equal-ncd,basic:GM-LM-RR-LSVT,sub25100,nopa,Unlocking,0.4,SVTLaplaceMechanism,{'Optimal': 40},1697,1624,1645,18,49,451,1679,1575,1194,1697,1624,1645,18,49,451,1679,1575,1194,upc-block-composition
688,sp_workloads,1690805680,wl_small_mem,152,basic:GM-LM-RR-LSVT-sub25100-defpa,4,greedy,block-composition,poisson,ncd,basic:GM-LM-RR-LSVT,sub25100,nopa,Unlocking,0.2,GaussianMechanism,{'Optimal': 40},4571824,341651,31424,40362,15539,3136,4531462,326112,28288,1667,1683,1652,23,81,166,1644,1602,1486,poisson-block-composition
689,sp_workloads,1690805680,wl_small_mem,152,basic:GM-LM-RR-LSVT-sub25100-defpa,4,greedy,block-composition,poisson,ncd,basic:GM-LM-RR-LSVT,sub25100,nopa,Unlocking,0.2,LaplaceMechanism,{'Optimal': 40},4559498,310728,31904,18605,6741,2752,4540893,303987,29152,1705,1675,1674,18,55,152,1687,1620,1522,poisson-block-composition
690,sp_workloads,1690805680,wl_small_mem,152,basic:GM-LM-RR-LSVT-sub25100-defpa,4,greedy,block-composition,poisson,ncd,basic:GM-LM-RR-LSVT,sub25100,nopa,Unlocking,0.2,RandResponseMechanism,{'Optimal': 40},4915555,321907,33248,23164,8651,3008,4892391,313256,30240,1732,1682,1739,16,57,172,1716,1625,1567,poisson-block-composition
691,sp_workloads,1690805680,wl_small_mem,152,basic:GM-LM-RR-LSVT-sub25100-defpa,4,greedy,block-composition,poisson,ncd,basic:GM-LM-RR-LSVT,sub25100,nopa,Unlocking,0.2,SVTLaplaceMechanism,{'Optimal': 40},4827443,310825,33008,17675,6597,3248,4809768,304228,29760,1701,1631,1753,19,43,186,1682,1588,1567,poisson-block-composition
692,sp_workloads,1690805680,wl_small_mem,153,basic:GM-LM-RR-LSVT-sub25100-defpa,4,greedy,block-composition,poisson,ncd,basic:GM-LM-RR-LSVT,sub25100,nopa,Unlocking,0.4,GaussianMechanism,{'Optimal': 40},4571824,341651,31424,44097,16595,3632,4527727,325056,27792,1667,1683,1652,25,92,193,1642,1591,1459,poisson-block-composition
693,sp_workloads,1690805680,wl_small_mem,153,basic:GM-LM-RR-LSVT-sub25100-defpa,4,greedy,block-composition,poisson,ncd,basic:GM-LM-RR-LSVT,sub25100,nopa,Unlocking,0.4,LaplaceMechanism,{'Optimal': 40},4559498,310728,31904,14739,5939,3152,4544759,304789,28752,1705,1675,1674,18,62,173,1687,1613,1501,poisson-block-composition
694,sp_workloads,1690805680,wl_small_mem,153,basic:GM-LM-RR-LSVT-sub25100-defpa,4,greedy,block-composition,poisson,ncd,basic:GM-LM-RR-LSVT,sub25100,nopa,Unlocking,0.4,RandResponseMechanism,{'Optimal': 40},4915555,321907,33248,29886,8122,3248,4885669,313785,30000,1732,1682,1739,15,57,182,1717,1625,1557,poisson-block-composition
695,sp_workloads,1690805680,wl_small_mem,153,basic:GM-LM-RR-LSVT-sub25100-defpa,4,greedy,block-composition,poisson,ncd,basic:GM-LM-RR-LSVT,sub25100,nopa,Unlocking,0.4,SVTLaplaceMechanism,{'Optimal': 40},4827443,310825,33008,22970,6966,3424,4804473,303859,29584,1701,1631,1753,11,47,196,1690,1584,1557,poisson-block-composition
696,sp_workloads,1690805680,wl_small_mem,154,basic:GM-LM-RR-LSVT-sub25100-defpa,4,greedy,block-composition,upc,ncd,basic:GM-LM-RR-LSVT,sub25100,nopa,Unlocking,0.2,GaussianMechanism,{'Optimal': 40},4695849,326924,29724,28038,19842,7070,4667811,307082,22654,1667,1683,1652,21,204,450,1646,1479,1202,upc-block-composition
697,sp_workloads,1690805680,wl_small_mem,154,basic:GM-LM-RR-LSVT-sub25100-defpa,4,greedy,block-composition,upc,ncd,basic:GM-LM-RR-LSVT,sub25100,nopa,Unlocking,0.2,LaplaceMechanism,{'Optimal': 40},4679017,325790,30262,7203,7903,6994,4671814,317887,23268,1705,1675,1674,7,71,446,1698,1604,1228,upc-block-composition
698,sp_workloads,1690805680,wl_small_mem,154,basic:GM-LM-RR-LSVT-sub25100-defpa,4,greedy,block-composition,upc,ncd,basic:GM-LM-RR-LSVT,sub25100,nopa,Unlocking,0.2,RandResponseMechanism,{'Optimal': 40},4775505,333039,31541,3701,9082,7789,4771804,323957,23752,1732,1682,1739,7,71,499,1725,1611,1240,upc-block-composition
699,sp_workloads,1690805680,wl_small_mem,154,basic:GM-LM-RR-LSVT-sub25100-defpa,4,greedy,block-composition,upc,ncd,basic:GM-LM-RR-LSVT,sub25100,nopa,Unlocking,0.2,SVTLaplaceMechanism,{'Optimal': 40},4720990,300216,31735,9752,6793,8231,4711238,293423,23504,1701,1631,1753,7,76,521,1694,1555,1232,upc-block-composition
700,sp_workloads,1690805680,wl_small_mem,155,basic:GM-LM-RR-LSVT-sub25100-defpa,4,greedy,block-composition,upc,ncd,basic:GM-LM-RR-LSVT,sub25100,nopa,Unlocking,0.4,GaussianMechanism,{'Optimal': 40},4695849,326924,29724,26011,21016,7644,4669838,305908,22080,1667,1683,1652,21,225,484,1646,1458,1168,upc-block-composition
701,sp_workloads,1690805680,wl_small_mem,155,basic:GM-LM-RR-LSVT-sub25100-defpa,4,greedy,block-composition,upc,ncd,basic:GM-LM-RR-LSVT,sub25100,nopa,Unlocking,0.4,LaplaceMechanism,{'Optimal': 40},4679017,325790,30262,13755,5307,7690,4665262,320483,22572,1705,1675,1674,15,47,486,1690,1628,1188,upc-block-composition
702,sp_workloads,1690805680,wl_small_mem,155,basic:GM-LM-RR-LSVT-sub25100-defpa,4,greedy,block-composition,upc,ncd,basic:GM-LM-RR-LSVT,sub25100,nopa,Unlocking,0.4,RandResponseMechanism,{'Optimal': 40},4775505,333039,31541,17271,7523,8557,4758234,325516,22984,1732,1682,1739,15,56,547,1717,1626,1192,upc-block-composition
703,sp_workloads,1690805680,wl_small_mem,155,basic:GM-LM-RR-LSVT-sub25100-defpa,4,greedy,block-composition,upc,ncd,basic:GM-LM-RR-LSVT,sub25100,nopa,Unlocking,0.4,SVTLaplaceMechanism,{'Optimal': 40},4720990,300216,31735,12346,4733,8798,4708644,295483,22937,1701,1631,1753,12,51,546,1689,1580,1207,upc-block-composition
704,sp_workloads,1690805680,wl_small_mem,156,basic:GM-LM-RR-LSVT-sub25100-defpa,4,greedy,block-composition,poisson,equal-ncd,basic:GM-LM-RR-LSVT,sub25100,nopa,Unlocking,0.2,GaussianMechanism,{'Optimal': 40},1667,1683,1652,23,81,166,1644,1602,1486,1667,1683,1652,23,81,166,1644,1602,1486,poisson-block-composition
705,sp_workloads,1690805680,wl_small_mem,156,basic:GM-LM-RR-LSVT-sub25100-defpa,4,greedy,block-composition,poisson,equal-ncd,basic:GM-LM-RR-LSVT,sub25100,nopa,Unlocking,0.2,LaplaceMechanism,{'Optimal': 40},1705,1675,1674,18,55,152,1687,1620,1522,1705,1675,1674,18,55,152,1687,1620,1522,poisson-block-composition
706,sp_workloads,1690805680,wl_small_mem,156,basic:GM-LM-RR-LSVT-sub25100-defpa,4,greedy,block-composition,poisson,equal-ncd,basic:GM-LM-RR-LSVT,sub25100,nopa,Unlocking,0.2,RandResponseMechanism,{'Optimal': 40},1732,1682,1739,16,57,172,1716,1625,1567,1732,1682,1739,16,57,172,1716,1625,1567,poisson-block-composition
707,sp_workloads,1690805680,wl_small_mem,156,basic:GM-LM-RR-LSVT-sub25100-defpa,4,greedy,block-composition,poisson,equal-ncd,basic:GM-LM-RR-LSVT,sub25100,nopa,Unlocking,0.2,SVTLaplaceMechanism,{'Optimal': 40},1701,1631,1753,19,43,186,1682,1588,1567,1701,1631,1753,19,43,186,1682,1588,1567,poisson-block-composition
708,sp_workloads,1690805680,wl_small_mem,157,basic:GM-LM-RR-LSVT-sub25100-defpa,4,greedy,block-composition,poisson,equal-ncd,basic:GM-LM-RR-LSVT,sub25100,nopa,Unlocking,0.4,GaussianMechanism,{'Optimal': 40},1667,1683,1652,25,92,193,1642,1591,1459,1667,1683,1652,25,92,193,1642,1591,1459,poisson-block-composition
709,sp_workloads,1690805680,wl_small_mem,157,basic:GM-LM-RR-LSVT-sub25100-defpa,4,greedy,block-composition,poisson,equal-ncd,basic:GM-LM-RR-LSVT,sub25100,nopa,Unlocking,0.4,LaplaceMechanism,{'Optimal': 40},1705,1675,1674,18,62,173,1687,1613,1501,1705,1675,1674,18,62,173,1687,1613,1501,poisson-block-composition
710,sp_workloads,1690805680,wl_small_mem,157,basic:GM-LM-RR-LSVT-sub25100-defpa,4,greedy,block-composition,poisson,equal-ncd,basic:GM-LM-RR-LSVT,sub25100,nopa,Unlocking,0.4,RandResponseMechanism,{'Optimal': 40},1732,1682,1739,15,57,182,1717,1625,1557,1732,1682,1739,15,57,182,1717,1625,1557,poisson-block-composition
711,sp_workloads,1690805680,wl_small_mem,157,basic:GM-LM-RR-LSVT-sub25100-defpa,4,greedy,block-composition,poisson,equal-ncd,basic:GM-LM-RR-LSVT,sub25100,nopa,Unlocking,0.4,SVTLaplaceMechanism,{'Optimal': 40},1701,1631,1753,11,47,196,1690,1584,1557,1701,1631,1753,11,47,196,1690,1584,1557,poisson-block-composition
712,sp_workloads,1690805680,wl_small_mem,158,basic:GM-LM-RR-LSVT-sub25100-defpa,4,greedy,block-composition,upc,equal-ncd,basic:GM-LM-RR-LSVT,sub25100,nopa,Unlocking,0.2,GaussianMechanism,{'Optimal': 40},1667,1683,1652,21,204,450,1646,1479,1202,1667,1683,1652,21,204,450,1646,1479,1202,upc-block-composition
713,sp_workloads,1690805680,wl_small_mem,158,basic:GM-LM-RR-LSVT-sub25100-defpa,4,greedy,block-composition,upc,equal-ncd,basic:GM-LM-RR-LSVT,sub25100,nopa,Unlocking,0.2,LaplaceMechanism,{'Optimal': 40},1705,1675,1674,7,71,446,1698,1604,1228,1705,1675,1674,7,71,446,1698,1604,1228,upc-block-composition
714,sp_workloads,1690805680,wl_small_mem,158,basic:GM-LM-RR-LSVT-sub25100-defpa,4,greedy,block-composition,upc,equal-ncd,basic:GM-LM-RR-LSVT,sub25100,nopa,Unlocking,0.2,RandResponseMechanism,{'Optimal': 40},1732,1682,1739,7,71,499,1725,1611,1240,1732,1682,1739,7,71,499,1725,1611,1240,upc-block-composition
715,sp_workloads,1690805680,wl_small_mem,158,basic:GM-LM-RR-LSVT-sub25100-defpa,4,greedy,block-composition,upc,equal-ncd,basic:GM-LM-RR-LSVT,sub25100,nopa,Unlocking,0.2,SVTLaplaceMechanism,{'Optimal': 40},1701,1631,1753,7,76,521,1694,1555,1232,1701,1631,1753,7,76,521,1694,1555,1232,upc-block-composition
716,sp_workloads,1690805680,wl_small_mem,159,basic:GM-LM-RR-LSVT-sub25100-defpa,4,greedy,block-composition,upc,equal-ncd,basic:GM-LM-RR-LSVT,sub25100,nopa,Unlocking,0.4,GaussianMechanism,{'Optimal': 40},1667,1683,1652,21,225,484,1646,1458,1168,1667,1683,1652,21,225,484,1646,1458,1168,upc-block-composition
717,sp_workloads,1690805680,wl_small_mem,159,basic:GM-LM-RR-LSVT-sub25100-defpa,4,greedy,block-composition,upc,equal-ncd,basic:GM-LM-RR-LSVT,sub25100,nopa,Unlocking,0.4,LaplaceMechanism,{'Optimal': 40},1705,1675,1674,15,47,486,1690,1628,1188,1705,1675,1674,15,47,486,1690,1628,1188,upc-block-composition
718,sp_workloads,1690805680,wl_small_mem,159,basic:GM-LM-RR-LSVT-sub25100-defpa,4,greedy,block-composition,upc,equal-ncd,basic:GM-LM-RR-LSVT,sub25100,nopa,Unlocking,0.4,RandResponseMechanism,{'Optimal': 40},1732,1682,1739,15,56,547,1717,1626,1192,1732,1682,1739,15,56,547,1717,1626,1192,upc-block-composition
719,sp_workloads,1690805680,wl_small_mem,159,basic:GM-LM-RR-LSVT-sub25100-defpa,4,greedy,block-composition,upc,equal-ncd,basic:GM-LM-RR-LSVT,sub25100,nopa,Unlocking,0.4,SVTLaplaceMechanism,{'Optimal': 40},1701,1631,1753,12,51,546,1689,1580,1207,1701,1631,1753,12,51,546,1689,1580,1207,upc-block-composition
720,sp_workloads,1690805680,wl_small_mem,160,gm:GM-sub25100-defpa,0,greedy,block-composition-pa,poisson,ncd,gm:GM,sub25100,defpa,Unlocking,0.2,GaussianMechanism,{'Optimal': 40},18864461,1345041,130912,3572564,668472,102016,15291897,676569,28896,6716,6728,6904,1972,3826,5523,4744,2902,1381,poisson-block-composition-pa
721,sp_workloads,1690805680,wl_small_mem,161,gm:GM-sub25100-defpa,0,greedy,block-composition-pa,poisson,ncd,gm:GM,sub25100,defpa,Unlocking,0.4,GaussianMechanism,{'Optimal': 40},18864461,1345041,130912,4203111,779179,109056,14661350,565862,21856,6716,6728,6904,2285,4419,5851,4431,2309,1053,poisson-block-composition-pa
722,sp_workloads,1690805680,wl_small_mem,162,gm:GM-sub25100-defpa,0,greedy,block-composition-pa,poisson,equal-ncd,gm:GM,sub25100,defpa,Unlocking,0.2,GaussianMechanism,{'Optimal': 40},6716,6728,6904,1972,3826,5523,4744,2902,1381,6716,6728,6904,1972,3826,5523,4744,2902,1381,poisson-block-composition-pa
723,sp_workloads,1690805680,wl_small_mem,163,gm:GM-sub25100-defpa,0,greedy,block-composition-pa,poisson,equal-ncd,gm:GM,sub25100,defpa,Unlocking,0.4,GaussianMechanism,{'Optimal': 40},6716,6728,6904,2285,4419,5851,4431,2309,1053,6716,6728,6904,2285,4419,5851,4431,2309,1053,poisson-block-composition-pa
724,sp_workloads,1690805680,wl_small_mem,164,gm:GM-sub25100-defpa,1,greedy,block-composition-pa,poisson,ncd,gm:GM,sub25100,defpa,Unlocking,0.2,GaussianMechanism,{'Optimal': 40},18715267,1320958,128176,3366448,643302,102544,15348819,677656,25632,6673,6765,6731,1876,3818,5518,4797,2947,1213,poisson-block-composition-pa
725,sp_workloads,1690805680,wl_small_mem,165,gm:GM-sub25100-defpa,1,greedy,block-composition-pa,poisson,ncd,gm:GM,sub25100,defpa,Unlocking,0.4,GaussianMechanism,{'Optimal': 40},18715267,1320958,128176,4190190,736320,107632,14525077,584638,20544,6673,6765,6731,2322,4315,5731,4351,2450,1000,poisson-block-composition-pa
726,sp_workloads,1690805680,wl_small_mem,166,gm:GM-sub25100-defpa,1,greedy,block-composition-pa,poisson,equal-ncd,gm:GM,sub25100,defpa,Unlocking,0.2,GaussianMechanism,{'Optimal': 40},6673,6765,6731,1876,3818,5518,4797,2947,1213,6673,6765,6731,1876,3818,5518,4797,2947,1213,poisson-block-composition-pa
727,sp_workloads,1690805680,wl_small_mem,167,gm:GM-sub25100-defpa,1,greedy,block-composition-pa,poisson,equal-ncd,gm:GM,sub25100,defpa,Unlocking,0.4,GaussianMechanism,{'Optimal': 40},6673,6765,6731,2322,4315,5731,4351,2450,1000,6673,6765,6731,2322,4315,5731,4351,2450,1000,poisson-block-composition-pa
728,sp_workloads,1690805680,wl_small_mem,168,gm:GM-sub25100-defpa,2,greedy,block-composition-pa,poisson,ncd,gm:GM,sub25100,defpa,Unlocking,0.2,GaussianMechanism,{'Optimal': 40},18806374,1355979,126784,3422124,632245,98960,15384250,723734,27824,6783,6833,6678,1853,3761,5368,4930,3072,1310,poisson-block-composition-pa
729,sp_workloads,1690805680,wl_small_mem,169,gm:GM-sub25100-defpa,2,greedy,block-composition-pa,poisson,ncd,gm:GM,sub25100,defpa,Unlocking,0.4,GaussianMechanism,{'Optimal': 40},18806374,1355979,126784,4049055,749535,105024,14757319,606444,21760,6783,6833,6678,2276,4387,5636,4507,2446,1042,poisson-block-composition-pa
730,sp_workloads,1690805680,wl_small_mem,170,gm:GM-sub25100-defpa,2,greedy,block-composition-pa,poisson,equal-ncd,gm:GM,sub25100,defpa,Unlocking,0.2,GaussianMechanism,{'Optimal': 40},6783,6833,6678,1853,3761,5368,4930,3072,1310,6783,6833,6678,1853,3761,5368,4930,3072,1310,poisson-block-composition-pa
731,sp_workloads,1690805680,wl_small_mem,171,gm:GM-sub25100-defpa,2,greedy,block-composition-pa,poisson,equal-ncd,gm:GM,sub25100,defpa,Unlocking,0.4,GaussianMechanism,{'Optimal': 40},6783,6833,6678,2276,4387,5636,4507,2446,1042,6783,6833,6678,2276,4387,5636,4507,2446,1042,poisson-block-composition-pa
732,sp_workloads,1690805680,wl_small_mem,172,gm:GM-sub25100-defpa,3,greedy,block-composition-pa,poisson,ncd,gm:GM,sub25100,defpa,Unlocking,0.2,GaussianMechanism,{'Optimal': 40},18672541,1292482,118587,3316564,587950,93514,15355977,704532,25073,6771,6693,6629,1871,3632,5350,4900,3061,1279,poisson-block-composition-pa
733,sp_workloads,1690805680,wl_small_mem,173,gm:GM-sub25100-defpa,3,greedy,block-composition-pa,poisson,ncd,gm:GM,sub25100,defpa,Unlocking,0.4,GaussianMechanism,{'Optimal': 40},18672541,1292482,118587,3970934,733916,100678,14701607,558566,17909,6771,6693,6629,2283,4331,5738,4488,2362,891,poisson-block-composition-pa
734,sp_workloads,1690805680,wl_small_mem,174,gm:GM-sub25100-defpa,3,greedy,block-composition-pa,poisson,equal-ncd,gm:GM,sub25100,defpa,Unlocking,0.2,GaussianMechanism,{'Optimal': 40},6771,6693,6629,1871,3632,5350,4900,3061,1279,6771,6693,6629,1871,3632,5350,4900,3061,1279,poisson-block-composition-pa
735,sp_workloads,1690805680,wl_small_mem,175,gm:GM-sub25100-defpa,3,greedy,block-composition-pa,poisson,equal-ncd,gm:GM,sub25100,defpa,Unlocking,0.4,GaussianMechanism,{'Optimal': 40},6771,6693,6629,2283,4331,5738,4488,2362,891,6771,6693,6629,2283,4331,5738,4488,2362,891,poisson-block-composition-pa
736,sp_workloads,1690805680,wl_small_mem,176,gm:GM-sub25100-defpa,4,greedy,block-composition-pa,poisson,ncd,gm:GM,sub25100,defpa,Unlocking,0.2,GaussianMechanism,{'Optimal': 40},18857452,1277663,120343,3365166,585717,92788,15492286,691946,27555,6862,6691,6713,1830,3626,5340,5032,3065,1373,poisson-block-composition-pa
737,sp_workloads,1690805680,wl_small_mem,177,gm:GM-sub25100-defpa,4,greedy,block-composition-pa,poisson,ncd,gm:GM,sub25100,defpa,Unlocking,0.4,GaussianMechanism,{'Optimal': 40},18857452,1277663,120343,3977918,718285,101665,14879534,559378,18678,6862,6691,6713,2270,4342,5759,4592,2349,954,poisson-block-composition-pa
738,sp_workloads,1690805680,wl_small_mem,178,gm:GM-sub25100-defpa,4,greedy,block-composition-pa,poisson,equal-ncd,gm:GM,sub25100,defpa,Unlocking,0.2,GaussianMechanism,{'Optimal': 40},6862,6691,6713,1830,3626,5340,5032,3065,1373,6862,6691,6713,1830,3626,5340,5032,3065,1373,poisson-block-composition-pa
739,sp_workloads,1690805680,wl_small_mem,179,gm:GM-sub25100-defpa,4,greedy,block-composition-pa,poisson,equal-ncd,gm:GM,sub25100,defpa,Unlocking,0.4,GaussianMechanism,{'Optimal': 40},6862,6691,6713,2270,4342,5759,4592,2349,954,6862,6691,6713,2270,4342,5759,4592,2349,954,poisson-block-composition-pa
740,sp_workloads,1690805680,wl_small_mem,180,ml:SGD-PATE-sub25100-defpa,0,greedy,block-composition-pa,poisson,ncd,ml:SGD-PATE,sub25100,defpa,Unlocking,0.2,MLNoisySGDMechanism,{'Optimal': 40},9320337,647144,60780,491147,101232,19095,8829190,545912,41685,3347,3348,3392,299,660,1106,3048,2688,2286,poisson-block-composition-pa
741,sp_workloads,1690805680,wl_small_mem,180,ml:SGD-PATE-sub25100-defpa,0,greedy,block-composition-pa,poisson,ncd,ml:SGD-PATE,sub25100,defpa,Unlocking,0.2,MLPateGaussianMechanism,{'Optimal': 40},9560711,630849,59490,256457,101924,19605,9304254,528925,39885,3488,3389,3328,220,607,1152,3268,2782,2176,poisson-block-composition-pa
742,sp_workloads,1690805680,wl_small_mem,181,ml:SGD-PATE-sub25100-defpa,0,greedy,block-composition-pa,poisson,ncd,ml:SGD-PATE,sub25100,defpa,Unlocking,0.4,MLNoisySGDMechanism,{'Optimal': 40},9320337,647144,60780,479996,108628,19995,8840341,538516,40785,3347,3348,3392,286,676,1169,3061,2672,2223,poisson-block-composition-pa
743,sp_workloads,1690805680,wl_small_mem,181,ml:SGD-PATE-sub25100-defpa,0,greedy,block-composition-pa,poisson,ncd,ml:SGD-PATE,sub25100,defpa,Unlocking,0.4,MLPateGaussianMechanism,{'Optimal': 40},9560711,630849,59490,272408,101231,19950,9288303,529618,39540,3488,3389,3328,218,602,1176,3270,2787,2152,poisson-block-composition-pa
744,sp_workloads,1690805680,wl_small_mem,182,ml:SGD-PATE-sub25100-defpa,0,greedy,block-composition-pa,poisson,equal-ncd,ml:SGD-PATE,sub25100,defpa,Unlocking,0.2,MLNoisySGDMechanism,{'Optimal': 40},3347,3348,3392,299,660,1106,3048,2688,2286,3347,3348,3392,299,660,1106,3048,2688,2286,poisson-block-composition-pa
745,sp_workloads,1690805680,wl_small_mem,182,ml:SGD-PATE-sub25100-defpa,0,greedy,block-composition-pa,poisson,equal-ncd,ml:SGD-PATE,sub25100,defpa,Unlocking,0.2,MLPateGaussianMechanism,{'Optimal': 40},3488,3389,3328,220,607,1152,3268,2782,2176,3488,3389,3328,220,607,1152,3268,2782,2176,poisson-block-composition-pa
746,sp_workloads,1690805680,wl_small_mem,183,ml:SGD-PATE-sub25100-defpa,0,greedy,block-composition-pa,poisson,equal-ncd,ml:SGD-PATE,sub25100,defpa,Unlocking,0.4,MLNoisySGDMechanism,{'Optimal': 40},3347,3348,3392,286,676,1169,3061,2672,2223,3347,3348,3392,286,676,1169,3061,2672,2223,poisson-block-composition-pa
747,sp_workloads,1690805680,wl_small_mem,183,ml:SGD-PATE-sub25100-defpa,0,greedy,block-composition-pa,poisson,equal-ncd,ml:SGD-PATE,sub25100,defpa,Unlocking,0.4,MLPateGaussianMechanism,{'Optimal': 40},3488,3389,3328,218,602,1176,3270,2787,2152,3488,3389,3328,218,602,1176,3270,2787,2152,poisson-block-composition-pa
748,sp_workloads,1690805680,wl_small_mem,184,ml:SGD-PATE-sub25100-defpa,1,greedy,block-composition-pa,poisson,ncd,ml:SGD-PATE,sub25100,defpa,Unlocking,0.2,MLNoisySGDMechanism,{'Optimal': 40},9612014,638642,60437,459347,89783,19742,9152667,548859,40695,3436,3336,3371,289,599,1154,3147,2737,2217,poisson-block-composition-pa
749,sp_workloads,1690805680,wl_small_mem,184,ml:SGD-PATE-sub25100-defpa,1,greedy,block-composition-pa,poisson,ncd,ml:SGD-PATE,sub25100,defpa,Unlocking,0.2,MLPateGaussianMechanism,{'Optimal': 40},9101816,660711,61026,327171,100335,20582,8774645,560376,40444,3337,3307,3358,249,655,1178,3088,2652,2180,poisson-block-composition-pa
750,sp_workloads,1690805680,wl_small_mem,185,ml:SGD-PATE-sub25100-defpa,1,greedy,block-composition-pa,poisson,ncd,ml:SGD-PATE,sub25100,defpa,Unlocking,0.4,MLNoisySGDMechanism,{'Optimal': 40},9612014,638642,60437,451467,93825,19820,9160547,544817,40617,3436,3336,3371,294,646,1156,3142,2690,2215,poisson-block-composition-pa
751,sp_workloads,1690805680,wl_small_mem,185,ml:SGD-PATE-sub25100-defpa,1,greedy,block-composition-pa,poisson,ncd,ml:SGD-PATE,sub25100,defpa,Unlocking,0.4,MLPateGaussianMechanism,{'Optimal': 40},9101816,660711,61026,369607,102219,21453,8732209,558492,39573,3337,3307,3358,256,667,1219,3081,2640,2139,poisson-block-composition-pa
752,sp_workloads,1690805680,wl_small_mem,186,ml:SGD-PATE-sub25100-defpa,1,greedy,block-composition-pa,poisson,equal-ncd,ml:SGD-PATE,sub25100,defpa,Unlocking,0.2,MLNoisySGDMechanism,{'Optimal': 40},3436,3336,3371,289,599,1154,3147,2737,2217,3436,3336,3371,289,599,1154,3147,2737,2217,poisson-block-composition-pa
753,sp_workloads,1690805680,wl_small_mem,186,ml:SGD-PATE-sub25100-defpa,1,greedy,block-composition-pa,poisson,equal-ncd,ml:SGD-PATE,sub25100,defpa,Unlocking,0.2,MLPateGaussianMechanism,{'Optimal': 40},3337,3307,3358,249,655,1178,3088,2652,2180,3337,3307,3358,249,655,1178,3088,2652,2180,poisson-block-composition-pa
754,sp_workloads,1690805680,wl_small_mem,187,ml:SGD-PATE-sub25100-defpa,1,greedy,block-composition-pa,poisson,equal-ncd,ml:SGD-PATE,sub25100,defpa,Unlocking,0.4,MLNoisySGDMechanism,{'Optimal': 40},3436,3336,3371,294,646,1156,3142,2690,2215,3436,3336,3371,294,646,1156,3142,2690,2215,poisson-block-composition-pa
755,sp_workloads,1690805680,wl_small_mem,187,ml:SGD-PATE-sub25100-defpa,1,greedy,block-composition-pa,poisson,equal-ncd,ml:SGD-PATE,sub25100,defpa,Unlocking,0.4,MLPateGaussianMechanism,{'Optimal': 40},3337,3307,3358,256,667,1219,3081,2640,2139,3337,3307,3358,256,667,1219,3081,2640,2139,poisson-block-composition-pa
756,sp_workloads,1690805680,wl_small_mem,188,ml:SGD-PATE-sub25100-defpa,2,greedy,block-composition-pa,poisson,ncd,ml:SGD-PATE,sub25100,defpa,Unlocking,0.2,MLNoisySGDMechanism,{'Optimal': 40},9102086,650387,61289,468511,96579,19797,8633575,553808,41492,3387,3344,3399,297,642,1147,3090,2702,2252,poisson-block-composition-pa
757,sp_workloads,1690805680,wl_small_mem,188,ml:SGD-PATE-sub25100-defpa,2,greedy,block-composition-pa,poisson,ncd,ml:SGD-PATE,sub25100,defpa,Unlocking,0.2,MLPateGaussianMechanism,{'Optimal': 40},9667159,651460,60587,296819,89854,19096,9370340,561606,41491,3356,3340,3381,224,618,1128,3132,2722,2253,poisson-block-composition-pa
758,sp_workloads,1690805680,wl_small_mem,189,ml:SGD-PATE-sub25100-defpa,2,greedy,block-composition-pa,poisson,ncd,ml:SGD-PATE,sub25100,defpa,Unlocking,0.4,MLNoisySGDMechanism,{'Optimal': 40},9102086,650387,61289,476207,97756,19493,8625879,552631,41796,3387,3344,3399,265,612,1115,3122,2732,2284,poisson-block-composition-pa
759,sp_workloads,1690805680,wl_small_mem,189,ml:SGD-PATE-sub25100-defpa,2,greedy,block-composition-pa,poisson,ncd,ml:SGD-PATE,sub25100,defpa,Unlocking,0.4,MLPateGaussianMechanism,{'Optimal': 40},9667159,651460,60587,335858,95990,18019,9331301,555470,42568,3356,3340,3381,254,649,1069,3102,2691,2312,poisson-block-composition-pa
760,sp_workloads,1690805680,wl_small_mem,190,ml:SGD-PATE-sub25100-defpa,2,greedy,block-composition-pa,poisson,equal-ncd,ml:SGD-PATE,sub25100,defpa,Unlocking,0.2,MLNoisySGDMechanism,{'Optimal': 40},3387,3344,3399,297,642,1147,3090,2702,2252,3387,3344,3399,297,642,1147,3090,2702,2252,poisson-block-composition-pa
761,sp_workloads,1690805680,wl_small_mem,190,ml:SGD-PATE-sub25100-defpa,2,greedy,block-composition-pa,poisson,equal-ncd,ml:SGD-PATE,sub25100,defpa,Unlocking,0.2,MLPateGaussianMechanism,{'Optimal': 40},3356,3340,3381,224,618,1128,3132,2722,2253,3356,3340,3381,224,618,1128,3132,2722,2253,poisson-block-composition-pa
762,sp_workloads,1690805680,wl_small_mem,191,ml:SGD-PATE-sub25100-defpa,2,greedy,block-composition-pa,poisson,equal-ncd,ml:SGD-PATE,sub25100,defpa,Unlocking,0.4,MLNoisySGDMechanism,{'Optimal': 40},3387,3344,3399,265,612,1115,3122,2732,2284,3387,3344,3399,265,612,1115,3122,2732,2284,poisson-block-composition-pa
763,sp_workloads,1690805680,wl_small_mem,191,ml:SGD-PATE-sub25100-defpa,2,greedy,block-composition-pa,poisson,equal-ncd,ml:SGD-PATE,sub25100,defpa,Unlocking,0.4,MLPateGaussianMechanism,{'Optimal': 40},3356,3340,3381,254,649,1069,3102,2691,2312,3356,3340,3381,254,649,1069,3102,2691,2312,poisson-block-composition-pa
764,sp_workloads,1690805680,wl_small_mem,192,ml:SGD-PATE-sub25100-defpa,3,greedy,block-composition-pa,poisson,ncd,ml:SGD-PATE,sub25100,defpa,Unlocking,0.2,MLNoisySGDMechanism,{'Optimal': 40},9538338,661542,60462,419205,97455,20279,9119133,564087,40183,3432,3504,3362,254,652,1193,3178,2852,2169,poisson-block-composition-pa
765,sp_workloads,1690805680,wl_small_mem,192,ml:SGD-PATE-sub25100-defpa,3,greedy,block-composition-pa,poisson,ncd,ml:SGD-PATE,sub25100,defpa,Unlocking,0.2,MLPateGaussianMechanism,{'Optimal': 40},9431567,656376,60193,289569,98384,20750,9141998,557992,39443,3379,3400,3343,209,642,1218,3170,2758,2125,poisson-block-composition-pa
766,sp_workloads,1690805680,wl_small_mem,193,ml:SGD-PATE-sub25100-defpa,3,greedy,block-composition-pa,poisson,ncd,ml:SGD-PATE,sub25100,defpa,Unlocking,0.4,MLNoisySGDMechanism,{'Optimal': 40},9538338,661542,60462,476839,101979,19823,9061499,559563,40639,3432,3504,3362,293,669,1153,3139,2835,2209,poisson-block-composition-pa
767,sp_workloads,1690805680,wl_small_mem,193,ml:SGD-PATE-sub25100-defpa,3,greedy,block-composition-pa,poisson,ncd,ml:SGD-PATE,sub25100,defpa,Unlocking,0.4,MLPateGaussianMechanism,{'Optimal': 40},9431567,656376,60193,341419,104004,19998,9090148,552372,40195,3379,3400,3343,244,663,1170,3135,2737,2173,poisson-block-composition-pa
768,sp_workloads,1690805680,wl_small_mem,194,ml:SGD-PATE-sub25100-defpa,3,greedy,block-composition-pa,poisson,equal-ncd,ml:SGD-PATE,sub25100,defpa,Unlocking,0.2,MLNoisySGDMechanism,{'Optimal': 40},3432,3504,3362,254,652,1193,3178,2852,2169,3432,3504,3362,254,652,1193,3178,2852,2169,poisson-block-composition-pa
769,sp_workloads,1690805680,wl_small_mem,194,ml:SGD-PATE-sub25100-defpa,3,greedy,block-composition-pa,poisson,equal-ncd,ml:SGD-PATE,sub25100,defpa,Unlocking,0.2,MLPateGaussianMechanism,{'Optimal': 40},3379,3400,3343,209,642,1218,3170,2758,2125,3379,3400,3343,209,642,1218,3170,2758,2125,poisson-block-composition-pa
770,sp_workloads,1690805680,wl_small_mem,195,ml:SGD-PATE-sub25100-defpa,3,greedy,block-composition-pa,poisson,equal-ncd,ml:SGD-PATE,sub25100,defpa,Unlocking,0.4,MLNoisySGDMechanism,{'Optimal': 40},3432,3504,3362,293,669,1153,3139,2835,2209,3432,3504,3362,293,669,1153,3139,2835,2209,poisson-block-composition-pa
771,sp_workloads,1690805680,wl_small_mem,195,ml:SGD-PATE-sub25100-defpa,3,greedy,block-composition-pa,poisson,equal-ncd,ml:SGD-PATE,sub25100,defpa,Unlocking,0.4,MLPateGaussianMechanism,{'Optimal': 40},3379,3400,3343,244,663,1170,3135,2737,2173,3379,3400,3343,244,663,1170,3135,2737,2173,poisson-block-composition-pa
772,sp_workloads,1690805680,wl_small_mem,196,ml:SGD-PATE-sub25100-defpa,4,greedy,block-composition-pa,poisson,ncd,ml:SGD-PATE,sub25100,defpa,Unlocking,0.2,MLNoisySGDMechanism,{'Optimal': 40},9619476,680600,63408,538122,104661,20144,9081354,575939,43264,3443,3381,3350,301,617,1097,3142,2764,2253,poisson-block-composition-pa
773,sp_workloads,1690805680,wl_small_mem,196,ml:SGD-PATE-sub25100-defpa,4,greedy,block-composition-pa,poisson,ncd,ml:SGD-PATE,sub25100,defpa,Unlocking,0.2,MLPateGaussianMechanism,{'Optimal': 40},9087643,650021,64528,314260,93432,20448,8773383,556589,44080,3245,3345,3408,244,640,1131,3001,2705,2277,poisson-block-composition-pa
774,sp_workloads,1690805680,wl_small_mem,197,ml:SGD-PATE-sub25100-defpa,4,greedy,block-composition-pa,poisson,ncd,ml:SGD-PATE,sub25100,defpa,Unlocking,0.4,MLNoisySGDMechanism,{'Optimal': 40},9619476,680600,63408,518966,99511,20192,9100510,581089,43216,3443,3381,3350,291,610,1090,3152,2771,2260,poisson-block-composition-pa
775,sp_workloads,1690805680,wl_small_mem,197,ml:SGD-PATE-sub25100-defpa,4,greedy,block-composition-pa,poisson,ncd,ml:SGD-PATE,sub25100,defpa,Unlocking,0.4,MLPateGaussianMechanism,{'Optimal': 40},9087643,650021,64528,358635,88297,19888,8729008,561724,44640,3245,3345,3408,255,606,1099,2990,2739,2309,poisson-block-composition-pa
776,sp_workloads,1690805680,wl_small_mem,198,ml:SGD-PATE-sub25100-defpa,4,greedy,block-composition-pa,poisson,equal-ncd,ml:SGD-PATE,sub25100,defpa,Unlocking,0.2,MLNoisySGDMechanism,{'Optimal': 40},3443,3381,3350,301,617,1097,3142,2764,2253,3443,3381,3350,301,617,1097,3142,2764,2253,poisson-block-composition-pa
777,sp_workloads,1690805680,wl_small_mem,198,ml:SGD-PATE-sub25100-defpa,4,greedy,block-composition-pa,poisson,equal-ncd,ml:SGD-PATE,sub25100,defpa,Unlocking,0.2,MLPateGaussianMechanism,{'Optimal': 40},3245,3345,3408,244,640,1131,3001,2705,2277,3245,3345,3408,244,640,1131,3001,2705,2277,poisson-block-composition-pa
778,sp_workloads,1690805680,wl_small_mem,199,ml:SGD-PATE-sub25100-defpa,4,greedy,block-composition-pa,poisson,equal-ncd,ml:SGD-PATE,sub25100,defpa,Unlocking,0.4,MLNoisySGDMechanism,{'Optimal': 40},3443,3381,3350,291,610,1090,3152,2771,2260,3443,3381,3350,291,610,1090,3152,2771,2260,poisson-block-composition-pa
779,sp_workloads,1690805680,wl_small_mem,199,ml:SGD-PATE-sub25100-defpa,4,greedy,block-composition-pa,poisson,equal-ncd,ml:SGD-PATE,sub25100,defpa,Unlocking,0.4,MLPateGaussianMechanism,{'Optimal': 40},3245,3345,3408,255,606,1099,2990,2739,2309,3245,3345,3408,255,606,1099,2990,2739,2309,poisson-block-composition-pa
780,sp_workloads,1690805680,wl_small_mem,200,mixed:GM-LM-RR-LSVT-SGD-PATE-sub25100-defpa,0,greedy,block-composition-pa,poisson,ncd,mixed:GM-LM-RR-LSVT-SGD-PATE,sub25100,defpa,Unlocking,0.2,GaussianMechanism,{'Optimal': 40},3326864,216518,19768,345330,127777,15701,2981534,88741,4067,1098,1121,1112,292,725,891,806,396,221,poisson-block-composition-pa
781,sp_workloads,1690805680,wl_small_mem,200,mixed:GM-LM-RR-LSVT-SGD-PATE-sub25100-defpa,0,greedy,block-composition-pa,poisson,ncd,mixed:GM-LM-RR-LSVT-SGD-PATE,sub25100,defpa,Unlocking,0.2,LaplaceMechanism,{'Optimal': 40},3160262,214484,19740,234519,55522,15809,2925743,158962,3931,1133,1141,1092,199,456,895,934,685,197,poisson-block-composition-pa
782,sp_workloads,1690805680,wl_small_mem,200,mixed:GM-LM-RR-LSVT-SGD-PATE-sub25100-defpa,0,greedy,block-composition-pa,poisson,ncd,mixed:GM-LM-RR-LSVT-SGD-PATE,sub25100,defpa,Unlocking,0.2,MLNoisySGDMechanism,{'Optimal': 40},3049683,202901,20644,149370,41041,7612,2900313,161860,13032,1124,1132,1148,105,269,436,1019,863,712,poisson-block-composition-pa
783,sp_workloads,1690805680,wl_small_mem,200,mixed:GM-LM-RR-LSVT-SGD-PATE-sub25100-defpa,0,greedy,block-composition-pa,poisson,ncd,mixed:GM-LM-RR-LSVT-SGD-PATE,sub25100,defpa,Unlocking,0.2,MLPateGaussianMechanism,{'Optimal': 40},3104776,219595,19804,113405,37970,6808,2991371,181625,12996,1159,1162,1108,92,252,408,1067,910,700,poisson-block-composition-pa
784,sp_workloads,1690805680,wl_small_mem,200,mixed:GM-LM-RR-LSVT-SGD-PATE-sub25100-defpa,0,greedy,block-composition-pa,poisson,ncd,mixed:GM-LM-RR-LSVT-SGD-PATE,sub25100,defpa,Unlocking,0.2,RandResponseMechanism,{'Optimal': 40},3027994,204361,19932,27390,11118,6722,3000604,193243,13210,1129,1138,1140,27,101,398,1102,1037,742,poisson-block-composition-pa
785,sp_workloads,1690805680,wl_small_mem,200,mixed:GM-LM-RR-LSVT-SGD-PATE-sub25100-defpa,0,greedy,block-composition-pa,poisson,ncd,mixed:GM-LM-RR-LSVT-SGD-PATE,sub25100,defpa,Unlocking,0.2,SVTLaplaceMechanism,{'Optimal': 40},3254745,215442,20539,32277,9351,6116,3222468,206091,14423,1155,1111,1125,32,93,348,1123,1018,777,poisson-block-composition-pa
786,sp_workloads,1690805680,wl_small_mem,201,mixed:GM-LM-RR-LSVT-SGD-PATE-sub25100-defpa,0,greedy,block-composition-pa,poisson,ncd,mixed:GM-LM-RR-LSVT-SGD-PATE,sub25100,defpa,Unlocking,0.4,GaussianMechanism,{'Optimal': 40},3326864,216518,19768,432040,131558,15847,2894824,84960,3921,1098,1121,1112,318,752,905,780,369,207,poisson-block-composition-pa
787,sp_workloads,1690805680,wl_small_mem,201,mixed:GM-LM-RR-LSVT-SGD-PATE-sub25100-defpa,0,greedy,block-composition-pa,poisson,ncd,mixed:GM-LM-RR-LSVT-SGD-PATE,sub25100,defpa,Unlocking,0.4,LaplaceMechanism,{'Optimal': 40},3160262,214484,19740,288863,67352,16013,2871399,147132,3727,1133,1141,1092,245,516,899,888,625,193,poisson-block-composition-pa
788,sp_workloads,1690805680,wl_small_mem,201,mixed:GM-LM-RR-LSVT-SGD-PATE-sub25100-defpa,0,greedy,block-composition-pa,poisson,ncd,mixed:GM-LM-RR-LSVT-SGD-PATE,sub25100,defpa,Unlocking,0.4,MLNoisySGDMechanism,{'Optimal': 40},3049683,202901,20644,141030,37728,7934,2908653,165173,12710,1124,1132,1148,89,252,450,1035,880,698,poisson-block-composition-pa
789,sp_workloads,1690805680,wl_small_mem,201,mixed:GM-LM-RR-LSVT-SGD-PATE-sub25100-defpa,0,greedy,block-composition-pa,poisson,ncd,mixed:GM-LM-RR-LSVT-SGD-PATE,sub25100,defpa,Unlocking,0.4,MLPateGaussianMechanism,{'Optimal': 40},3104776,219595,19804,98341,39784,7051,3006435,179811,12753,1159,1162,1108,75,257,421,1084,905,687,poisson-block-composition-pa
790,sp_workloads,1690805680,wl_small_mem,201,mixed:GM-LM-RR-LSVT-SGD-PATE-sub25100-defpa,0,greedy,block-composition-pa,poisson,ncd,mixed:GM-LM-RR-LSVT-SGD-PATE,sub25100,defpa,Unlocking,0.4,RandResponseMechanism,{'Optimal': 40},3027994,204361,19932,23819,11026,6773,3004175,193335,13159,1129,1138,1140,26,96,395,1103,1042,745,poisson-block-composition-pa
791,sp_workloads,1690805680,wl_small_mem,201,mixed:GM-LM-RR-LSVT-SGD-PATE-sub25100-defpa,0,greedy,block-composition-pa,poisson,ncd,mixed:GM-LM-RR-LSVT-SGD-PATE,sub25100,defpa,Unlocking,0.4,SVTLaplaceMechanism,{'Optimal': 40},3254745,215442,20539,42159,12629,6431,3212586,202813,14108,1155,1111,1125,41,85,369,1114,1026,756,poisson-block-composition-pa
792,sp_workloads,1690805680,wl_small_mem,202,mixed:GM-LM-RR-LSVT-SGD-PATE-sub25100-defpa,0,greedy,block-composition-pa,poisson,equal-ncd,mixed:GM-LM-RR-LSVT-SGD-PATE,sub25100,defpa,Unlocking,0.2,GaussianMechanism,{'Optimal': 40},1098,1121,1112,292,725,891,806,396,221,1098,1121,1112,292,725,891,806,396,221,poisson-block-composition-pa
793,sp_workloads,1690805680,wl_small_mem,202,mixed:GM-LM-RR-LSVT-SGD-PATE-sub25100-defpa,0,greedy,block-composition-pa,poisson,equal-ncd,mixed:GM-LM-RR-LSVT-SGD-PATE,sub25100,defpa,Unlocking,0.2,LaplaceMechanism,{'Optimal': 40},1133,1141,1092,199,456,895,934,685,197,1133,1141,1092,199,456,895,934,685,197,poisson-block-composition-pa
794,sp_workloads,1690805680,wl_small_mem,202,mixed:GM-LM-RR-LSVT-SGD-PATE-sub25100-defpa,0,greedy,block-composition-pa,poisson,equal-ncd,mixed:GM-LM-RR-LSVT-SGD-PATE,sub25100,defpa,Unlocking,0.2,MLNoisySGDMechanism,{'Optimal': 40},1124,1132,1148,105,269,436,1019,863,712,1124,1132,1148,105,269,436,1019,863,712,poisson-block-composition-pa
795,sp_workloads,1690805680,wl_small_mem,202,mixed:GM-LM-RR-LSVT-SGD-PATE-sub25100-defpa,0,greedy,block-composition-pa,poisson,equal-ncd,mixed:GM-LM-RR-LSVT-SGD-PATE,sub25100,defpa,Unlocking,0.2,MLPateGaussianMechanism,{'Optimal': 40},1159,1162,1108,92,252,408,1067,910,700,1159,1162,1108,92,252,408,1067,910,700,poisson-block-composition-pa
796,sp_workloads,1690805680,wl_small_mem,202,mixed:GM-LM-RR-LSVT-SGD-PATE-sub25100-defpa,0,greedy,block-composition-pa,poisson,equal-ncd,mixed:GM-LM-RR-LSVT-SGD-PATE,sub25100,defpa,Unlocking,0.2,RandResponseMechanism,{'Optimal': 40},1129,1138,1140,27,101,398,1102,1037,742,1129,1138,1140,27,101,398,1102,1037,742,poisson-block-composition-pa
797,sp_workloads,1690805680,wl_small_mem,202,mixed:GM-LM-RR-LSVT-SGD-PATE-sub25100-defpa,0,greedy,block-composition-pa,poisson,equal-ncd,mixed:GM-LM-RR-LSVT-SGD-PATE,sub25100,defpa,Unlocking,0.2,SVTLaplaceMechanism,{'Optimal': 40},1155,1111,1125,32,93,348,1123,1018,777,1155,1111,1125,32,93,348,1123,1018,777,poisson-block-composition-pa
798,sp_workloads,1690805680,wl_small_mem,203,mixed:GM-LM-RR-LSVT-SGD-PATE-sub25100-defpa,0,greedy,block-composition-pa,poisson,equal-ncd,mixed:GM-LM-RR-LSVT-SGD-PATE,sub25100,defpa,Unlocking,0.4,GaussianMechanism,{'Optimal': 40},1098,1121,1112,318,752,905,780,369,207,1098,1121,1112,318,752,905,780,369,207,poisson-block-composition-pa
799,sp_workloads,1690805680,wl_small_mem,203,mixed:GM-LM-RR-LSVT-SGD-PATE-sub25100-defpa,0,greedy,block-composition-pa,poisson,equal-ncd,mixed:GM-LM-RR-LSVT-SGD-PATE,sub25100,defpa,Unlocking,0.4,LaplaceMechanism,{'Optimal': 40},1133,1141,1092,245,516,899,888,625,193,1133,1141,1092,245,516,899,888,625,193,poisson-block-composition-pa
800,sp_workloads,1690805680,wl_small_mem,203,mixed:GM-LM-RR-LSVT-SGD-PATE-sub25100-defpa,0,greedy,block-composition-pa,poisson,equal-ncd,mixed:GM-LM-RR-LSVT-SGD-PATE,sub25100,defpa,Unlocking,0.4,MLNoisySGDMechanism,{'Optimal': 40},1124,1132,1148,89,252,450,1035,880,698,1124,1132,1148,89,252,450,1035,880,698,poisson-block-composition-pa
801,sp_workloads,1690805680,wl_small_mem,203,mixed:GM-LM-RR-LSVT-SGD-PATE-sub25100-defpa,0,greedy,block-composition-pa,poisson,equal-ncd,mixed:GM-LM-RR-LSVT-SGD-PATE,sub25100,defpa,Unlocking,0.4,MLPateGaussianMechanism,{'Optimal': 40},1159,1162,1108,75,257,421,1084,905,687,1159,1162,1108,75,257,421,1084,905,687,poisson-block-composition-pa
802,sp_workloads,1690805680,wl_small_mem,203,mixed:GM-LM-RR-LSVT-SGD-PATE-sub25100-defpa,0,greedy,block-composition-pa,poisson,equal-ncd,mixed:GM-LM-RR-LSVT-SGD-PATE,sub25100,defpa,Unlocking,0.4,RandResponseMechanism,{'Optimal': 40},1129,1138,1140,26,96,395,1103,1042,745,1129,1138,1140,26,96,395,1103,1042,745,poisson-block-composition-pa
803,sp_workloads,1690805680,wl_small_mem,203,mixed:GM-LM-RR-LSVT-SGD-PATE-sub25100-defpa,0,greedy,block-composition-pa,poisson,equal-ncd,mixed:GM-LM-RR-LSVT-SGD-PATE,sub25100,defpa,Unlocking,0.4,SVTLaplaceMechanism,{'Optimal': 40},1155,1111,1125,41,85,369,1114,1026,756,1155,1111,1125,41,85,369,1114,1026,756,poisson-block-composition-pa
804,sp_workloads,1690805680,wl_small_mem,204,mixed:GM-LM-RR-LSVT-SGD-PATE-sub25100-defpa,1,greedy,block-composition-pa,poisson,ncd,mixed:GM-LM-RR-LSVT-SGD-PATE,sub25100,defpa,Unlocking,0.2,GaussianMechanism,{'Optimal': 40},3139319,215782,21216,338411,121379,16816,2800908,94403,4400,1075,1140,1126,274,720,902,801,420,224,poisson-block-composition-pa
805,sp_workloads,1690805680,wl_small_mem,204,mixed:GM-LM-RR-LSVT-SGD-PATE-sub25100-defpa,1,greedy,block-composition-pa,poisson,ncd,mixed:GM-LM-RR-LSVT-SGD-PATE,sub25100,defpa,Unlocking,0.2,LaplaceMechanism,{'Optimal': 40},3080200,239601,21344,244994,66131,16480,2835206,173470,4864,1140,1163,1130,212,481,889,928,682,241,poisson-block-composition-pa
806,sp_workloads,1690805680,wl_small_mem,204,mixed:GM-LM-RR-LSVT-SGD-PATE-sub25100-defpa,1,greedy,block-composition-pa,poisson,ncd,mixed:GM-LM-RR-LSVT-SGD-PATE,sub25100,defpa,Unlocking,0.2,MLNoisySGDMechanism,{'Optimal': 40},3197047,217314,22128,186715,29357,7232,3010332,187957,14896,1145,1089,1161,100,202,396,1045,887,765,poisson-block-composition-pa
807,sp_workloads,1690805680,wl_small_mem,204,mixed:GM-LM-RR-LSVT-SGD-PATE-sub25100-defpa,1,greedy,block-composition-pa,poisson,ncd,mixed:GM-LM-RR-LSVT-SGD-PATE,sub25100,defpa,Unlocking,0.2,MLPateGaussianMechanism,{'Optimal': 40},3203621,231498,21632,85278,30373,7440,3118343,201125,14192,1163,1144,1138,70,214,410,1093,930,728,poisson-block-composition-pa
808,sp_workloads,1690805680,wl_small_mem,204,mixed:GM-LM-RR-LSVT-SGD-PATE-sub25100-defpa,1,greedy,block-composition-pa,poisson,ncd,mixed:GM-LM-RR-LSVT-SGD-PATE,sub25100,defpa,Unlocking,0.2,RandResponseMechanism,{'Optimal': 40},3122577,243521,22560,41018,17017,6144,3081559,226504,16416,1093,1164,1181,31,110,338,1062,1054,843,poisson-block-composition-pa
809,sp_workloads,1690805680,wl_small_mem,204,mixed:GM-LM-RR-LSVT-SGD-PATE-sub25100-defpa,1,greedy,block-composition-pa,poisson,ncd,mixed:GM-LM-RR-LSVT-SGD-PATE,sub25100,defpa,Unlocking,0.2,SVTLaplaceMechanism,{'Optimal': 40},3189411,227364,20784,32088,13249,5856,3157323,214115,14928,1178,1127,1089,27,98,320,1151,1029,769,poisson-block-composition-pa
810,sp_workloads,1690805680,wl_small_mem,205,mixed:GM-LM-RR-LSVT-SGD-PATE-sub25100-defpa,1,greedy,block-composition-pa,poisson,ncd,mixed:GM-LM-RR-LSVT-SGD-PATE,sub25100,defpa,Unlocking,0.4,GaussianMechanism,{'Optimal': 40},3139319,215782,21216,412775,126793,17632,2726544,88989,3584,1075,1140,1126,297,750,944,778,390,182,poisson-block-composition-pa
811,sp_workloads,1690805680,wl_small_mem,205,mixed:GM-LM-RR-LSVT-SGD-PATE-sub25100-defpa,1,greedy,block-composition-pa,poisson,ncd,mixed:GM-LM-RR-LSVT-SGD-PATE,sub25100,defpa,Unlocking,0.4,LaplaceMechanism,{'Optimal': 40},3080200,239601,21344,307004,81052,17392,2773196,158549,3952,1140,1163,1130,260,537,934,880,626,196,poisson-block-composition-pa
812,sp_workloads,1690805680,wl_small_mem,205,mixed:GM-LM-RR-LSVT-SGD-PATE-sub25100-defpa,1,greedy,block-composition-pa,poisson,ncd,mixed:GM-LM-RR-LSVT-SGD-PATE,sub25100,defpa,Unlocking,0.4,MLNoisySGDMechanism,{'Optimal': 40},3197047,217314,22128,169156,29803,7872,3027891,187511,14256,1145,1089,1161,101,220,430,1044,869,731,poisson-block-composition-pa
813,sp_workloads,1690805680,wl_small_mem,205,mixed:GM-LM-RR-LSVT-SGD-PATE-sub25100-defpa,1,greedy,block-composition-pa,poisson,ncd,mixed:GM-LM-RR-LSVT-SGD-PATE,sub25100,defpa,Unlocking,0.4,MLPateGaussianMechanism,{'Optimal': 40},3203621,231498,21632,74582,32734,7968,3129039,198764,13664,1163,1144,1138,77,221,448,1086,923,690,poisson-block-composition-pa
814,sp_workloads,1690805680,wl_small_mem,205,mixed:GM-LM-RR-LSVT-SGD-PATE-sub25100-defpa,1,greedy,block-composition-pa,poisson,ncd,mixed:GM-LM-RR-LSVT-SGD-PATE,sub25100,defpa,Unlocking,0.4,RandResponseMechanism,{'Optimal': 40},3122577,243521,22560,53583,15856,6816,3068994,227665,15744,1093,1164,1181,40,115,369,1053,1049,812,poisson-block-composition-pa
815,sp_workloads,1690805680,wl_small_mem,205,mixed:GM-LM-RR-LSVT-SGD-PATE-sub25100-defpa,1,greedy,block-composition-pa,poisson,ncd,mixed:GM-LM-RR-LSVT-SGD-PATE,sub25100,defpa,Unlocking,0.4,SVTLaplaceMechanism,{'Optimal': 40},3189411,227364,20784,44066,12743,6224,3145345,214621,14560,1178,1127,1089,34,102,349,1144,1025,740,poisson-block-composition-pa
816,sp_workloads,1690805680,wl_small_mem,206,mixed:GM-LM-RR-LSVT-SGD-PATE-sub25100-defpa,1,greedy,block-composition-pa,poisson,equal-ncd,mixed:GM-LM-RR-LSVT-SGD-PATE,sub25100,defpa,Unlocking,0.2,GaussianMechanism,{'Optimal': 40},1075,1140,1126,274,720,902,801,420,224,1075,1140,1126,274,720,902,801,420,224,poisson-block-composition-pa
817,sp_workloads,1690805680,wl_small_mem,206,mixed:GM-LM-RR-LSVT-SGD-PATE-sub25100-defpa,1,greedy,block-composition-pa,poisson,equal-ncd,mixed:GM-LM-RR-LSVT-SGD-PATE,sub25100,defpa,Unlocking,0.2,LaplaceMechanism,{'Optimal': 40},1140,1163,1130,212,481,889,928,682,241,1140,1163,1130,212,481,889,928,682,241,poisson-block-composition-pa
818,sp_workloads,1690805680,wl_small_mem,206,mixed:GM-LM-RR-LSVT-SGD-PATE-sub25100-defpa,1,greedy,block-composition-pa,poisson,equal-ncd,mixed:GM-LM-RR-LSVT-SGD-PATE,sub25100,defpa,Unlocking,0.2,MLNoisySGDMechanism,{'Optimal': 40},1145,1089,1161,100,202,396,1045,887,765,1145,1089,1161,100,202,396,1045,887,765,poisson-block-composition-pa
819,sp_workloads,1690805680,wl_small_mem,206,mixed:GM-LM-RR-LSVT-SGD-PATE-sub25100-defpa,1,greedy,block-composition-pa,poisson,equal-ncd,mixed:GM-LM-RR-LSVT-SGD-PATE,sub25100,defpa,Unlocking,0.2,MLPateGaussianMechanism,{'Optimal': 40},1163,1144,1138,70,214,410,1093,930,728,1163,1144,1138,70,214,410,1093,930,728,poisson-block-composition-pa
820,sp_workloads,1690805680,wl_small_mem,206,mixed:GM-LM-RR-LSVT-SGD-PATE-sub25100-defpa,1,greedy,block-composition-pa,poisson,equal-ncd,mixed:GM-LM-RR-LSVT-SGD-PATE,sub25100,defpa,Unlocking,0.2,RandResponseMechanism,{'Optimal': 40},1093,1164,1181,31,110,338,1062,1054,843,1093,1164,1181,31,110,338,1062,1054,843,poisson-block-composition-pa
821,sp_workloads,1690805680,wl_small_mem,206,mixed:GM-LM-RR-LSVT-SGD-PATE-sub25100-defpa,1,greedy,block-composition-pa,poisson,equal-ncd,mixed:GM-LM-RR-LSVT-SGD-PATE,sub25100,defpa,Unlocking,0.2,SVTLaplaceMechanism,{'Optimal': 40},1178,1127,1089,27,98,320,1151,1029,769,1178,1127,1089,27,98,320,1151,1029,769,poisson-block-composition-pa
822,sp_workloads,1690805680,wl_small_mem,207,mixed:GM-LM-RR-LSVT-SGD-PATE-sub25100-defpa,1,greedy,block-composition-pa,poisson,equal-ncd,mixed:GM-LM-RR-LSVT-SGD-PATE,sub25100,defpa,Unlocking,0.4,GaussianMechanism,{'Optimal': 40},1075,1140,1126,297,750,944,778,390,182,1075,1140,1126,297,750,944,778,390,182,poisson-block-composition-pa
823,sp_workloads,1690805680,wl_small_mem,207,mixed:GM-LM-RR-LSVT-SGD-PATE-sub25100-defpa,1,greedy,block-composition-pa,poisson,equal-ncd,mixed:GM-LM-RR-LSVT-SGD-PATE,sub25100,defpa,Unlocking,0.4,LaplaceMechanism,{'Optimal': 40},1140,1163,1130,260,537,934,880,626,196,1140,1163,1130,260,537,934,880,626,196,poisson-block-composition-pa
824,sp_workloads,1690805680,wl_small_mem,207,mixed:GM-LM-RR-LSVT-SGD-PATE-sub25100-defpa,1,greedy,block-composition-pa,poisson,equal-ncd,mixed:GM-LM-RR-LSVT-SGD-PATE,sub25100,defpa,Unlocking,0.4,MLNoisySGDMechanism,{'Optimal': 40},1145,1089,1161,101,220,430,1044,869,731,1145,1089,1161,101,220,430,1044,869,731,poisson-block-composition-pa
825,sp_workloads,1690805680,wl_small_mem,207,mixed:GM-LM-RR-LSVT-SGD-PATE-sub25100-defpa,1,greedy,block-composition-pa,poisson,equal-ncd,mixed:GM-LM-RR-LSVT-SGD-PATE,sub25100,defpa,Unlocking,0.4,MLPateGaussianMechanism,{'Optimal': 40},1163,1144,1138,77,221,448,1086,923,690,1163,1144,1138,77,221,448,1086,923,690,poisson-block-composition-pa
826,sp_workloads,1690805680,wl_small_mem,207,mixed:GM-LM-RR-LSVT-SGD-PATE-sub25100-defpa,1,greedy,block-composition-pa,poisson,equal-ncd,mixed:GM-LM-RR-LSVT-SGD-PATE,sub25100,defpa,Unlocking,0.4,RandResponseMechanism,{'Optimal': 40},1093,1164,1181,40,115,369,1053,1049,812,1093,1164,1181,40,115,369,1053,1049,812,poisson-block-composition-pa
827,sp_workloads,1690805680,wl_small_mem,207,mixed:GM-LM-RR-LSVT-SGD-PATE-sub25100-defpa,1,greedy,block-composition-pa,poisson,equal-ncd,mixed:GM-LM-RR-LSVT-SGD-PATE,sub25100,defpa,Unlocking,0.4,SVTLaplaceMechanism,{'Optimal': 40},1178,1127,1089,34,102,349,1144,1025,740,1178,1127,1089,34,102,349,1144,1025,740,poisson-block-composition-pa
828,sp_workloads,1690805680,wl_small_mem,208,mixed:GM-LM-RR-LSVT-SGD-PATE-sub25100-defpa,2,greedy,block-composition-pa,poisson,ncd,mixed:GM-LM-RR-LSVT-SGD-PATE,sub25100,defpa,Unlocking,0.2,GaussianMechanism,{'Optimal': 40},3297557,222693,20889,439927,131041,16841,2857630,91652,4048,1107,1156,1159,315,752,951,792,404,208,poisson-block-composition-pa
829,sp_workloads,1690805680,wl_small_mem,208,mixed:GM-LM-RR-LSVT-SGD-PATE-sub25100-defpa,2,greedy,block-composition-pa,poisson,ncd,mixed:GM-LM-RR-LSVT-SGD-PATE,sub25100,defpa,Unlocking,0.2,LaplaceMechanism,{'Optimal': 40},2847135,226653,20024,233033,57095,16158,2614102,169558,3866,1061,1136,1112,200,429,914,861,707,198,poisson-block-composition-pa
830,sp_workloads,1690805680,wl_small_mem,208,mixed:GM-LM-RR-LSVT-SGD-PATE-sub25100-defpa,2,greedy,block-composition-pa,poisson,ncd,mixed:GM-LM-RR-LSVT-SGD-PATE,sub25100,defpa,Unlocking,0.2,MLNoisySGDMechanism,{'Optimal': 40},3065470,217531,20600,142391,36144,7559,2923079,181387,13041,1088,1113,1144,75,221,441,1013,892,703,poisson-block-composition-pa
831,sp_workloads,1690805680,wl_small_mem,208,mixed:GM-LM-RR-LSVT-SGD-PATE-sub25100-defpa,2,greedy,block-composition-pa,poisson,ncd,mixed:GM-LM-RR-LSVT-SGD-PATE,sub25100,defpa,Unlocking,0.2,MLPateGaussianMechanism,{'Optimal': 40},3183074,228777,19443,79996,34284,6802,3103078,194493,12641,1123,1178,1085,66,228,398,1057,950,687,poisson-block-composition-pa
832,sp_workloads,1690805680,wl_small_mem,208,mixed:GM-LM-RR-LSVT-SGD-PATE-sub25100-defpa,2,greedy,block-composition-pa,poisson,ncd,mixed:GM-LM-RR-LSVT-SGD-PATE,sub25100,defpa,Unlocking,0.2,RandResponseMechanism,{'Optimal': 40},3253029,217115,19830,30833,11895,5930,3222196,205220,13900,1136,1135,1114,28,98,358,1108,1037,756,poisson-block-composition-pa
833,sp_workloads,1690805680,wl_small_mem,208,mixed:GM-LM-RR-LSVT-SGD-PATE-sub25100-defpa,2,greedy,block-composition-pa,poisson,ncd,mixed:GM-LM-RR-LSVT-SGD-PATE,sub25100,defpa,Unlocking,0.2,SVTLaplaceMechanism,{'Optimal': 40},3041723,217557,19755,50138,16783,5792,2991585,200774,13963,1106,1092,1109,38,98,336,1068,994,773,poisson-block-composition-pa
834,sp_workloads,1690805680,wl_small_mem,209,mixed:GM-LM-RR-LSVT-SGD-PATE-sub25100-defpa,2,greedy,block-composition-pa,poisson,ncd,mixed:GM-LM-RR-LSVT-SGD-PATE,sub25100,defpa,Unlocking,0.4,GaussianMechanism,{'Optimal': 40},3297557,222693,20889,529981,127144,16709,2767576,95549,4180,1107,1156,1159,341,755,939,766,401,220,poisson-block-composition-pa
835,sp_workloads,1690805680,wl_small_mem,209,mixed:GM-LM-RR-LSVT-SGD-PATE-sub25100-defpa,2,greedy,block-composition-pa,poisson,ncd,mixed:GM-LM-RR-LSVT-SGD-PATE,sub25100,defpa,Unlocking,0.4,LaplaceMechanism,{'Optimal': 40},2847135,226653,20024,276505,70579,16159,2570630,156074,3865,1061,1136,1112,223,496,913,838,640,199,poisson-block-composition-pa
836,sp_workloads,1690805680,wl_small_mem,209,mixed:GM-LM-RR-LSVT-SGD-PATE-sub25100-defpa,2,greedy,block-composition-pa,poisson,ncd,mixed:GM-LM-RR-LSVT-SGD-PATE,sub25100,defpa,Unlocking,0.4,MLNoisySGDMechanism,{'Optimal': 40},3065470,217531,20600,114853,30831,7563,2950617,186700,13037,1088,1113,1144,85,212,437,1003,901,707,poisson-block-composition-pa
837,sp_workloads,1690805680,wl_small_mem,209,mixed:GM-LM-RR-LSVT-SGD-PATE-sub25100-defpa,2,greedy,block-composition-pa,poisson,ncd,mixed:GM-LM-RR-LSVT-SGD-PATE,sub25100,defpa,Unlocking,0.4,MLPateGaussianMechanism,{'Optimal': 40},3183074,228777,19443,83223,34122,7007,3099851,194655,12436,1123,1178,1085,64,231,417,1059,947,668,poisson-block-composition-pa
838,sp_workloads,1690805680,wl_small_mem,209,mixed:GM-LM-RR-LSVT-SGD-PATE-sub25100-defpa,2,greedy,block-composition-pa,poisson,ncd,mixed:GM-LM-RR-LSVT-SGD-PATE,sub25100,defpa,Unlocking,0.4,RandResponseMechanism,{'Optimal': 40},3253029,217115,19830,38379,14768,5631,3214650,202347,14199,1136,1135,1114,32,99,337,1104,1036,777,poisson-block-composition-pa
839,sp_workloads,1690805680,wl_small_mem,209,mixed:GM-LM-RR-LSVT-SGD-PATE-sub25100-defpa,2,greedy,block-composition-pa,poisson,ncd,mixed:GM-LM-RR-LSVT-SGD-PATE,sub25100,defpa,Unlocking,0.4,SVTLaplaceMechanism,{'Optimal': 40},3041723,217557,19755,39654,14166,5730,3002069,203391,14025,1106,1092,1109,35,94,334,1071,998,775,poisson-block-composition-pa
840,sp_workloads,1690805680,wl_small_mem,210,mixed:GM-LM-RR-LSVT-SGD-PATE-sub25100-defpa,2,greedy,block-composition-pa,poisson,equal-ncd,mixed:GM-LM-RR-LSVT-SGD-PATE,sub25100,defpa,Unlocking,0.2,GaussianMechanism,{'Optimal': 40},1107,1156,1159,315,752,951,792,404,208,1107,1156,1159,315,752,951,792,404,208,poisson-block-composition-pa
841,sp_workloads,1690805680,wl_small_mem,210,mixed:GM-LM-RR-LSVT-SGD-PATE-sub25100-defpa,2,greedy,block-composition-pa,poisson,equal-ncd,mixed:GM-LM-RR-LSVT-SGD-PATE,sub25100,defpa,Unlocking,0.2,LaplaceMechanism,{'Optimal': 40},1061,1136,1112,200,429,914,861,707,198,1061,1136,1112,200,429,914,861,707,198,poisson-block-composition-pa
842,sp_workloads,1690805680,wl_small_mem,210,mixed:GM-LM-RR-LSVT-SGD-PATE-sub25100-defpa,2,greedy,block-composition-pa,poisson,equal-ncd,mixed:GM-LM-RR-LSVT-SGD-PATE,sub25100,defpa,Unlocking,0.2,MLNoisySGDMechanism,{'Optimal': 40},1088,1113,1144,75,221,441,1013,892,703,1088,1113,1144,75,221,441,1013,892,703,poisson-block-composition-pa
843,sp_workloads,1690805680,wl_small_mem,210,mixed:GM-LM-RR-LSVT-SGD-PATE-sub25100-defpa,2,greedy,block-composition-pa,poisson,equal-ncd,mixed:GM-LM-RR-LSVT-SGD-PATE,sub25100,defpa,Unlocking,0.2,MLPateGaussianMechanism,{'Optimal': 40},1123,1178,1085,66,228,398,1057,950,687,1123,1178,1085,66,228,398,1057,950,687,poisson-block-composition-pa
844,sp_workloads,1690805680,wl_small_mem,210,mixed:GM-LM-RR-LSVT-SGD-PATE-sub25100-defpa,2,greedy,block-composition-pa,poisson,equal-ncd,mixed:GM-LM-RR-LSVT-SGD-PATE,sub25100,defpa,Unlocking,0.2,RandResponseMechanism,{'Optimal': 40},1136,1135,1114,28,98,358,1108,1037,756,1136,1135,1114,28,98,358,1108,1037,756,poisson-block-composition-pa
845,sp_workloads,1690805680,wl_small_mem,210,mixed:GM-LM-RR-LSVT-SGD-PATE-sub25100-defpa,2,greedy,block-composition-pa,poisson,equal-ncd,mixed:GM-LM-RR-LSVT-SGD-PATE,sub25100,defpa,Unlocking,0.2,SVTLaplaceMechanism,{'Optimal': 40},1106,1092,1109,38,98,336,1068,994,773,1106,1092,1109,38,98,336,1068,994,773,poisson-block-composition-pa
846,sp_workloads,1690805680,wl_small_mem,211,mixed:GM-LM-RR-LSVT-SGD-PATE-sub25100-defpa,2,greedy,block-composition-pa,poisson,equal-ncd,mixed:GM-LM-RR-LSVT-SGD-PATE,sub25100,defpa,Unlocking,0.4,GaussianMechanism,{'Optimal': 40},1107,1156,1159,341,755,939,766,401,220,1107,1156,1159,341,755,939,766,401,220,poisson-block-composition-pa
847,sp_workloads,1690805680,wl_small_mem,211,mixed:GM-LM-RR-LSVT-SGD-PATE-sub25100-defpa,2,greedy,block-composition-pa,poisson,equal-ncd,mixed:GM-LM-RR-LSVT-SGD-PATE,sub25100,defpa,Unlocking,0.4,LaplaceMechanism,{'Optimal': 40},1061,1136,1112,223,496,913,838,640,199,1061,1136,1112,223,496,913,838,640,199,poisson-block-composition-pa
848,sp_workloads,1690805680,wl_small_mem,211,mixed:GM-LM-RR-LSVT-SGD-PATE-sub25100-defpa,2,greedy,block-composition-pa,poisson,equal-ncd,mixed:GM-LM-RR-LSVT-SGD-PATE,sub25100,defpa,Unlocking,0.4,MLNoisySGDMechanism,{'Optimal': 40},1088,1113,1144,85,212,437,1003,901,707,1088,1113,1144,85,212,437,1003,901,707,poisson-block-composition-pa
849,sp_workloads,1690805680,wl_small_mem,211,mixed:GM-LM-RR-LSVT-SGD-PATE-sub25100-defpa,2,greedy,block-composition-pa,poisson,equal-ncd,mixed:GM-LM-RR-LSVT-SGD-PATE,sub25100,defpa,Unlocking,0.4,MLPateGaussianMechanism,{'Optimal': 40},1123,1178,1085,64,231,417,1059,947,668,1123,1178,1085,64,231,417,1059,947,668,poisson-block-composition-pa
850,sp_workloads,1690805680,wl_small_mem,211,mixed:GM-LM-RR-LSVT-SGD-PATE-sub25100-defpa,2,greedy,block-composition-pa,poisson,equal-ncd,mixed:GM-LM-RR-LSVT-SGD-PATE,sub25100,defpa,Unlocking,0.4,RandResponseMechanism,{'Optimal': 40},1136,1135,1114,32,99,337,1104,1036,777,1136,1135,1114,32,99,337,1104,1036,777,poisson-block-composition-pa
851,sp_workloads,1690805680,wl_small_mem,211,mixed:GM-LM-RR-LSVT-SGD-PATE-sub25100-defpa,2,greedy,block-composition-pa,poisson,equal-ncd,mixed:GM-LM-RR-LSVT-SGD-PATE,sub25100,defpa,Unlocking,0.4,SVTLaplaceMechanism,{'Optimal': 40},1106,1092,1109,35,94,334,1071,998,775,1106,1092,1109,35,94,334,1071,998,775,poisson-block-composition-pa
852,sp_workloads,1690805680,wl_small_mem,212,mixed:GM-LM-RR-LSVT-SGD-PATE-sub25100-defpa,3,greedy,block-composition-pa,poisson,ncd,mixed:GM-LM-RR-LSVT-SGD-PATE,sub25100,defpa,Unlocking,0.2,GaussianMechanism,{'Optimal': 40},3014106,221031,21056,388684,122407,17232,2625422,98624,3824,1094,1113,1104,312,713,912,782,400,192,poisson-block-composition-pa
853,sp_workloads,1690805680,wl_small_mem,212,mixed:GM-LM-RR-LSVT-SGD-PATE-sub25100-defpa,3,greedy,block-composition-pa,poisson,ncd,mixed:GM-LM-RR-LSVT-SGD-PATE,sub25100,defpa,Unlocking,0.2,LaplaceMechanism,{'Optimal': 40},3356641,218178,20864,264101,74449,17440,3092540,143729,3424,1169,1154,1119,215,514,942,954,640,177,poisson-block-composition-pa
854,sp_workloads,1690805680,wl_small_mem,212,mixed:GM-LM-RR-LSVT-SGD-PATE-sub25100-defpa,3,greedy,block-composition-pa,poisson,ncd,mixed:GM-LM-RR-LSVT-SGD-PATE,sub25100,defpa,Unlocking,0.2,MLNoisySGDMechanism,{'Optimal': 40},2886113,212328,21728,93152,34489,7696,2792961,177839,14032,1057,1087,1124,85,212,420,972,875,704,poisson-block-composition-pa
855,sp_workloads,1690805680,wl_small_mem,212,mixed:GM-LM-RR-LSVT-SGD-PATE-sub25100-defpa,3,greedy,block-composition-pa,poisson,ncd,mixed:GM-LM-RR-LSVT-SGD-PATE,sub25100,defpa,Unlocking,0.2,MLPateGaussianMechanism,{'Optimal': 40},3286989,218751,22304,94142,29209,8096,3192847,189542,14208,1114,1105,1168,81,209,444,1033,896,724,poisson-block-composition-pa
856,sp_workloads,1690805680,wl_small_mem,212,mixed:GM-LM-RR-LSVT-SGD-PATE-sub25100-defpa,3,greedy,block-composition-pa,poisson,ncd,mixed:GM-LM-RR-LSVT-SGD-PATE,sub25100,defpa,Unlocking,0.2,RandResponseMechanism,{'Optimal': 40},3304405,225397,21760,13398,13839,6064,3291007,211558,15696,1160,1175,1154,22,101,335,1138,1074,819,poisson-block-composition-pa
857,sp_workloads,1690805680,wl_small_mem,212,mixed:GM-LM-RR-LSVT-SGD-PATE-sub25100-defpa,3,greedy,block-composition-pa,poisson,ncd,mixed:GM-LM-RR-LSVT-SGD-PATE,sub25100,defpa,Unlocking,0.2,SVTLaplaceMechanism,{'Optimal': 40},2975196,221951,22352,33475,12104,6512,2941721,209847,15840,1080,1132,1168,34,101,356,1046,1031,812,poisson-block-composition-pa
858,sp_workloads,1690805680,wl_small_mem,213,mixed:GM-LM-RR-LSVT-SGD-PATE-sub25100-defpa,3,greedy,block-composition-pa,poisson,ncd,mixed:GM-LM-RR-LSVT-SGD-PATE,sub25100,defpa,Unlocking,0.4,GaussianMechanism,{'Optimal': 40},3014106,221031,21056,425760,131586,16592,2588346,89445,4464,1094,1113,1104,324,714,880,770,399,224,poisson-block-composition-pa
859,sp_workloads,1690805680,wl_small_mem,213,mixed:GM-LM-RR-LSVT-SGD-PATE-sub25100-defpa,3,greedy,block-composition-pa,poisson,ncd,mixed:GM-LM-RR-LSVT-SGD-PATE,sub25100,defpa,Unlocking,0.4,LaplaceMechanism,{'Optimal': 40},3356641,218178,20864,317560,70146,16896,3039081,148032,3968,1169,1154,1119,257,526,918,912,628,201,poisson-block-composition-pa
860,sp_workloads,1690805680,wl_small_mem,213,mixed:GM-LM-RR-LSVT-SGD-PATE-sub25100-defpa,3,greedy,block-composition-pa,poisson,ncd,mixed:GM-LM-RR-LSVT-SGD-PATE,sub25100,defpa,Unlocking,0.4,MLNoisySGDMechanism,{'Optimal': 40},2886113,212328,21728,117799,33374,7760,2768314,178954,13968,1057,1087,1124,88,213,423,969,874,701,poisson-block-composition-pa
861,sp_workloads,1690805680,wl_small_mem,213,mixed:GM-LM-RR-LSVT-SGD-PATE-sub25100-defpa,3,greedy,block-composition-pa,poisson,ncd,mixed:GM-LM-RR-LSVT-SGD-PATE,sub25100,defpa,Unlocking,0.4,MLPateGaussianMechanism,{'Optimal': 40},3286989,218751,22304,101884,33210,8336,3185105,185541,13968,1114,1105,1168,85,231,459,1029,874,709,poisson-block-composition-pa
862,sp_workloads,1690805680,wl_small_mem,213,mixed:GM-LM-RR-LSVT-SGD-PATE-sub25100-defpa,3,greedy,block-composition-pa,poisson,ncd,mixed:GM-LM-RR-LSVT-SGD-PATE,sub25100,defpa,Unlocking,0.4,RandResponseMechanism,{'Optimal': 40},3304405,225397,21760,18253,14762,6512,3286152,210635,15248,1160,1175,1154,23,107,361,1137,1068,793,poisson-block-composition-pa
863,sp_workloads,1690805680,wl_small_mem,213,mixed:GM-LM-RR-LSVT-SGD-PATE-sub25100-defpa,3,greedy,block-composition-pa,poisson,ncd,mixed:GM-LM-RR-LSVT-SGD-PATE,sub25100,defpa,Unlocking,0.4,SVTLaplaceMechanism,{'Optimal': 40},2975196,221951,22352,46459,12876,6928,2928737,209075,15424,1080,1132,1168,32,102,380,1048,1030,788,poisson-block-composition-pa
864,sp_workloads,1690805680,wl_small_mem,214,mixed:GM-LM-RR-LSVT-SGD-PATE-sub25100-defpa,3,greedy,block-composition-pa,poisson,equal-ncd,mixed:GM-LM-RR-LSVT-SGD-PATE,sub25100,defpa,Unlocking,0.2,GaussianMechanism,{'Optimal': 40},1094,1113,1104,312,713,912,782,400,192,1094,1113,1104,312,713,912,782,400,192,poisson-block-composition-pa
865,sp_workloads,1690805680,wl_small_mem,214,mixed:GM-LM-RR-LSVT-SGD-PATE-sub25100-defpa,3,greedy,block-composition-pa,poisson,equal-ncd,mixed:GM-LM-RR-LSVT-SGD-PATE,sub25100,defpa,Unlocking,0.2,LaplaceMechanism,{'Optimal': 40},1169,1154,1119,215,514,942,954,640,177,1169,1154,1119,215,514,942,954,640,177,poisson-block-composition-pa
866,sp_workloads,1690805680,wl_small_mem,214,mixed:GM-LM-RR-LSVT-SGD-PATE-sub25100-defpa,3,greedy,block-composition-pa,poisson,equal-ncd,mixed:GM-LM-RR-LSVT-SGD-PATE,sub25100,defpa,Unlocking,0.2,MLNoisySGDMechanism,{'Optimal': 40},1057,1087,1124,85,212,420,972,875,704,1057,1087,1124,85,212,420,972,875,704,poisson-block-composition-pa
867,sp_workloads,1690805680,wl_small_mem,214,mixed:GM-LM-RR-LSVT-SGD-PATE-sub25100-defpa,3,greedy,block-composition-pa,poisson,equal-ncd,mixed:GM-LM-RR-LSVT-SGD-PATE,sub25100,defpa,Unlocking,0.2,MLPateGaussianMechanism,{'Optimal': 40},1114,1105,1168,81,209,444,1033,896,724,1114,1105,1168,81,209,444,1033,896,724,poisson-block-composition-pa
868,sp_workloads,1690805680,wl_small_mem,214,mixed:GM-LM-RR-LSVT-SGD-PATE-sub25100-defpa,3,greedy,block-composition-pa,poisson,equal-ncd,mixed:GM-LM-RR-LSVT-SGD-PATE,sub25100,defpa,Unlocking,0.2,RandResponseMechanism,{'Optimal': 40},1160,1175,1154,22,101,335,1138,1074,819,1160,1175,1154,22,101,335,1138,1074,819,poisson-block-composition-pa
869,sp_workloads,1690805680,wl_small_mem,214,mixed:GM-LM-RR-LSVT-SGD-PATE-sub25100-defpa,3,greedy,block-composition-pa,poisson,equal-ncd,mixed:GM-LM-RR-LSVT-SGD-PATE,sub25100,defpa,Unlocking,0.2,SVTLaplaceMechanism,{'Optimal': 40},1080,1132,1168,34,101,356,1046,1031,812,1080,1132,1168,34,101,356,1046,1031,812,poisson-block-composition-pa
870,sp_workloads,1690805680,wl_small_mem,215,mixed:GM-LM-RR-LSVT-SGD-PATE-sub25100-defpa,3,greedy,block-composition-pa,poisson,equal-ncd,mixed:GM-LM-RR-LSVT-SGD-PATE,sub25100,defpa,Unlocking,0.4,GaussianMechanism,{'Optimal': 40},1094,1113,1104,324,714,880,770,399,224,1094,1113,1104,324,714,880,770,399,224,poisson-block-composition-pa
871,sp_workloads,1690805680,wl_small_mem,215,mixed:GM-LM-RR-LSVT-SGD-PATE-sub25100-defpa,3,greedy,block-composition-pa,poisson,equal-ncd,mixed:GM-LM-RR-LSVT-SGD-PATE,sub25100,defpa,Unlocking,0.4,LaplaceMechanism,{'Optimal': 40},1169,1154,1119,257,526,918,912,628,201,1169,1154,1119,257,526,918,912,628,201,poisson-block-composition-pa
872,sp_workloads,1690805680,wl_small_mem,215,mixed:GM-LM-RR-LSVT-SGD-PATE-sub25100-defpa,3,greedy,block-composition-pa,poisson,equal-ncd,mixed:GM-LM-RR-LSVT-SGD-PATE,sub25100,defpa,Unlocking,0.4,MLNoisySGDMechanism,{'Optimal': 40},1057,1087,1124,88,213,423,969,874,701,1057,1087,1124,88,213,423,969,874,701,poisson-block-composition-pa
873,sp_workloads,1690805680,wl_small_mem,215,mixed:GM-LM-RR-LSVT-SGD-PATE-sub25100-defpa,3,greedy,block-composition-pa,poisson,equal-ncd,mixed:GM-LM-RR-LSVT-SGD-PATE,sub25100,defpa,Unlocking,0.4,MLPateGaussianMechanism,{'Optimal': 40},1114,1105,1168,85,231,459,1029,874,709,1114,1105,1168,85,231,459,1029,874,709,poisson-block-composition-pa
874,sp_workloads,1690805680,wl_small_mem,215,mixed:GM-LM-RR-LSVT-SGD-PATE-sub25100-defpa,3,greedy,block-composition-pa,poisson,equal-ncd,mixed:GM-LM-RR-LSVT-SGD-PATE,sub25100,defpa,Unlocking,0.4,RandResponseMechanism,{'Optimal': 40},1160,1175,1154,23,107,361,1137,1068,793,1160,1175,1154,23,107,361,1137,1068,793,poisson-block-composition-pa
875,sp_workloads,1690805680,wl_small_mem,215,mixed:GM-LM-RR-LSVT-SGD-PATE-sub25100-defpa,3,greedy,block-composition-pa,poisson,equal-ncd,mixed:GM-LM-RR-LSVT-SGD-PATE,sub25100,defpa,Unlocking,0.4,SVTLaplaceMechanism,{'Optimal': 40},1080,1132,1168,32,102,380,1048,1030,788,1080,1132,1168,32,102,380,1048,1030,788,poisson-block-composition-pa
876,sp_workloads,1690805680,wl_small_mem,216,mixed:GM-LM-RR-LSVT-SGD-PATE-sub25100-defpa,4,greedy,block-composition-pa,poisson,ncd,mixed:GM-LM-RR-LSVT-SGD-PATE,sub25100,defpa,Unlocking,0.2,GaussianMechanism,{'Optimal': 40},3164159,212016,19356,330785,115455,15662,2833374,96561,3694,1113,1088,1060,275,657,866,838,431,194,poisson-block-composition-pa
877,sp_workloads,1690805680,wl_small_mem,216,mixed:GM-LM-RR-LSVT-SGD-PATE-sub25100-defpa,4,greedy,block-composition-pa,poisson,ncd,mixed:GM-LM-RR-LSVT-SGD-PATE,sub25100,defpa,Unlocking,0.2,LaplaceMechanism,{'Optimal': 40},2854575,215653,19585,259358,66537,15975,2595217,149116,3610,1062,1115,1087,212,455,889,850,660,198,poisson-block-composition-pa
878,sp_workloads,1690805680,wl_small_mem,216,mixed:GM-LM-RR-LSVT-SGD-PATE-sub25100-defpa,4,greedy,block-composition-pa,poisson,ncd,mixed:GM-LM-RR-LSVT-SGD-PATE,sub25100,defpa,Unlocking,0.2,MLNoisySGDMechanism,{'Optimal': 40},3215801,221736,20277,153095,32253,7173,3062706,189483,13104,1144,1128,1131,94,195,427,1050,933,704,poisson-block-composition-pa
879,sp_workloads,1690805680,wl_small_mem,216,mixed:GM-LM-RR-LSVT-SGD-PATE-sub25100-defpa,4,greedy,block-composition-pa,poisson,ncd,mixed:GM-LM-RR-LSVT-SGD-PATE,sub25100,defpa,Unlocking,0.2,MLPateGaussianMechanism,{'Optimal': 40},3246364,219077,18914,102756,29448,6821,3143608,189629,12093,1154,1099,1070,69,216,411,1085,883,659,poisson-block-composition-pa
880,sp_workloads,1690805680,wl_small_mem,216,mixed:GM-LM-RR-LSVT-SGD-PATE-sub25100-defpa,4,greedy,block-composition-pa,poisson,ncd,mixed:GM-LM-RR-LSVT-SGD-PATE,sub25100,defpa,Unlocking,0.2,RandResponseMechanism,{'Optimal': 40},3086084,218125,20774,52061,12116,6169,3034023,206009,14605,1149,1123,1162,40,92,375,1109,1031,787,poisson-block-composition-pa
881,sp_workloads,1690805680,wl_small_mem,216,mixed:GM-LM-RR-LSVT-SGD-PATE-sub25100-defpa,4,greedy,block-composition-pa,poisson,ncd,mixed:GM-LM-RR-LSVT-SGD-PATE,sub25100,defpa,Unlocking,0.2,SVTLaplaceMechanism,{'Optimal': 40},3076541,223346,21123,28597,13013,6087,3047944,210333,15036,1073,1134,1197,30,91,361,1043,1043,836,poisson-block-composition-pa
882,sp_workloads,1690805680,wl_small_mem,217,mixed:GM-LM-RR-LSVT-SGD-PATE-sub25100-defpa,4,greedy,block-composition-pa,poisson,ncd,mixed:GM-LM-RR-LSVT-SGD-PATE,sub25100,defpa,Unlocking,0.4,GaussianMechanism,{'Optimal': 40},3164159,212016,19356,404688,120230,15689,2759471,91786,3667,1113,1088,1060,311,698,871,802,390,189,poisson-block-composition-pa
883,sp_workloads,1690805680,wl_small_mem,217,mixed:GM-LM-RR-LSVT-SGD-PATE-sub25100-defpa,4,greedy,block-composition-pa,poisson,ncd,mixed:GM-LM-RR-LSVT-SGD-PATE,sub25100,defpa,Unlocking,0.4,LaplaceMechanism,{'Optimal': 40},2854575,215653,19585,259015,77709,16015,2595560,137944,3570,1062,1115,1087,222,515,897,840,600,190,poisson-block-composition-pa
884,sp_workloads,1690805680,wl_small_mem,217,mixed:GM-LM-RR-LSVT-SGD-PATE-sub25100-defpa,4,greedy,block-composition-pa,poisson,ncd,mixed:GM-LM-RR-LSVT-SGD-PATE,sub25100,defpa,Unlocking,0.4,MLNoisySGDMechanism,{'Optimal': 40},3215801,221736,20277,188918,35810,6919,3026883,185926,13358,1144,1128,1131,99,206,409,1045,922,722,poisson-block-composition-pa
885,sp_workloads,1690805680,wl_small_mem,217,mixed:GM-LM-RR-LSVT-SGD-PATE-sub25100-defpa,4,greedy,block-composition-pa,poisson,ncd,mixed:GM-LM-RR-LSVT-SGD-PATE,sub25100,defpa,Unlocking,0.4,MLPateGaussianMechanism,{'Optimal': 40},3246364,219077,18914,109894,31704,7320,3136470,187373,11594,1154,1099,1070,78,200,440,1076,899,630,poisson-block-composition-pa
886,sp_workloads,1690805680,wl_small_mem,217,mixed:GM-LM-RR-LSVT-SGD-PATE-sub25100-defpa,4,greedy,block-composition-pa,poisson,ncd,mixed:GM-LM-RR-LSVT-SGD-PATE,sub25100,defpa,Unlocking,0.4,RandResponseMechanism,{'Optimal': 40},3086084,218125,20774,47127,15531,6025,3038957,202594,14749,1149,1123,1162,32,101,359,1117,1022,803,poisson-block-composition-pa
887,sp_workloads,1690805680,wl_small_mem,217,mixed:GM-LM-RR-LSVT-SGD-PATE-sub25100-defpa,4,greedy,block-composition-pa,poisson,ncd,mixed:GM-LM-RR-LSVT-SGD-PATE,sub25100,defpa,Unlocking,0.4,SVTLaplaceMechanism,{'Optimal': 40},3076541,223346,21123,32462,13924,6100,3044079,209422,15023,1073,1134,1197,36,108,364,1037,1026,833,poisson-block-composition-pa
888,sp_workloads,1690805680,wl_small_mem,218,mixed:GM-LM-RR-LSVT-SGD-PATE-sub25100-defpa,4,greedy,block-composition-pa,poisson,equal-ncd,mixed:GM-LM-RR-LSVT-SGD-PATE,sub25100,defpa,Unlocking,0.2,GaussianMechanism,{'Optimal': 40},1113,1088,1060,275,657,866,838,431,194,1113,1088,1060,275,657,866,838,431,194,poisson-block-composition-pa
889,sp_workloads,1690805680,wl_small_mem,218,mixed:GM-LM-RR-LSVT-SGD-PATE-sub25100-defpa,4,greedy,block-composition-pa,poisson,equal-ncd,mixed:GM-LM-RR-LSVT-SGD-PATE,sub25100,defpa,Unlocking,0.2,LaplaceMechanism,{'Optimal': 40},1062,1115,1087,212,455,889,850,660,198,1062,1115,1087,212,455,889,850,660,198,poisson-block-composition-pa
890,sp_workloads,1690805680,wl_small_mem,218,mixed:GM-LM-RR-LSVT-SGD-PATE-sub25100-defpa,4,greedy,block-composition-pa,poisson,equal-ncd,mixed:GM-LM-RR-LSVT-SGD-PATE,sub25100,defpa,Unlocking,0.2,MLNoisySGDMechanism,{'Optimal': 40},1144,1128,1131,94,195,427,1050,933,704,1144,1128,1131,94,195,427,1050,933,704,poisson-block-composition-pa
891,sp_workloads,1690805680,wl_small_mem,218,mixed:GM-LM-RR-LSVT-SGD-PATE-sub25100-defpa,4,greedy,block-composition-pa,poisson,equal-ncd,mixed:GM-LM-RR-LSVT-SGD-PATE,sub25100,defpa,Unlocking,0.2,MLPateGaussianMechanism,{'Optimal': 40},1154,1099,1070,69,216,411,1085,883,659,1154,1099,1070,69,216,411,1085,883,659,poisson-block-composition-pa
892,sp_workloads,1690805680,wl_small_mem,218,mixed:GM-LM-RR-LSVT-SGD-PATE-sub25100-defpa,4,greedy,block-composition-pa,poisson,equal-ncd,mixed:GM-LM-RR-LSVT-SGD-PATE,sub25100,defpa,Unlocking,0.2,RandResponseMechanism,{'Optimal': 40},1149,1123,1162,40,92,375,1109,1031,787,1149,1123,1162,40,92,375,1109,1031,787,poisson-block-composition-pa
893,sp_workloads,1690805680,wl_small_mem,218,mixed:GM-LM-RR-LSVT-SGD-PATE-sub25100-defpa,4,greedy,block-composition-pa,poisson,equal-ncd,mixed:GM-LM-RR-LSVT-SGD-PATE,sub25100,defpa,Unlocking,0.2,SVTLaplaceMechanism,{'Optimal': 40},1073,1134,1197,30,91,361,1043,1043,836,1073,1134,1197,30,91,361,1043,1043,836,poisson-block-composition-pa
894,sp_workloads,1690805680,wl_small_mem,219,mixed:GM-LM-RR-LSVT-SGD-PATE-sub25100-defpa,4,greedy,block-composition-pa,poisson,equal-ncd,mixed:GM-LM-RR-LSVT-SGD-PATE,sub25100,defpa,Unlocking,0.4,GaussianMechanism,{'Optimal': 40},1113,1088,1060,311,698,871,802,390,189,1113,1088,1060,311,698,871,802,390,189,poisson-block-composition-pa
895,sp_workloads,1690805680,wl_small_mem,219,mixed:GM-LM-RR-LSVT-SGD-PATE-sub25100-defpa,4,greedy,block-composition-pa,poisson,equal-ncd,mixed:GM-LM-RR-LSVT-SGD-PATE,sub25100,defpa,Unlocking,0.4,LaplaceMechanism,{'Optimal': 40},1062,1115,1087,222,515,897,840,600,190,1062,1115,1087,222,515,897,840,600,190,poisson-block-composition-pa
896,sp_workloads,1690805680,wl_small_mem,219,mixed:GM-LM-RR-LSVT-SGD-PATE-sub25100-defpa,4,greedy,block-composition-pa,poisson,equal-ncd,mixed:GM-LM-RR-LSVT-SGD-PATE,sub25100,defpa,Unlocking,0.4,MLNoisySGDMechanism,{'Optimal': 40},1144,1128,1131,99,206,409,1045,922,722,1144,1128,1131,99,206,409,1045,922,722,poisson-block-composition-pa
897,sp_workloads,1690805680,wl_small_mem,219,mixed:GM-LM-RR-LSVT-SGD-PATE-sub25100-defpa,4,greedy,block-composition-pa,poisson,equal-ncd,mixed:GM-LM-RR-LSVT-SGD-PATE,sub25100,defpa,Unlocking,0.4,MLPateGaussianMechanism,{'Optimal': 40},1154,1099,1070,78,200,440,1076,899,630,1154,1099,1070,78,200,440,1076,899,630,poisson-block-composition-pa
898,sp_workloads,1690805680,wl_small_mem,219,mixed:GM-LM-RR-LSVT-SGD-PATE-sub25100-defpa,4,greedy,block-composition-pa,poisson,equal-ncd,mixed:GM-LM-RR-LSVT-SGD-PATE,sub25100,defpa,Unlocking,0.4,RandResponseMechanism,{'Optimal': 40},1149,1123,1162,32,101,359,1117,1022,803,1149,1123,1162,32,101,359,1117,1022,803,poisson-block-composition-pa
899,sp_workloads,1690805680,wl_small_mem,219,mixed:GM-LM-RR-LSVT-SGD-PATE-sub25100-defpa,4,greedy,block-composition-pa,poisson,equal-ncd,mixed:GM-LM-RR-LSVT-SGD-PATE,sub25100,defpa,Unlocking,0.4,SVTLaplaceMechanism,{'Optimal': 40},1073,1134,1197,36,108,364,1037,1026,833,1073,1134,1197,36,108,364,1037,1026,833,poisson-block-composition-pa
900,sp_workloads,1690805680,wl_small_mem,220,basic:GM-LM-RR-LSVT-sub25100-defpa,0,greedy,block-composition-pa,poisson,ncd,basic:GM-LM-RR-LSVT,sub25100,defpa,Unlocking,0.2,GaussianMechanism,{'Optimal': 40},4847751,317174,28905,561074,169522,23246,4286677,147652,5659,1760,1618,1607,479,999,1314,1281,619,293,poisson-block-composition-pa
901,sp_workloads,1690805680,wl_small_mem,220,basic:GM-LM-RR-LSVT-sub25100-defpa,0,greedy,block-composition-pa,poisson,ncd,basic:GM-LM-RR-LSVT,sub25100,defpa,Unlocking,0.2,LaplaceMechanism,{'Optimal': 40},4580618,310999,29482,399524,87596,24150,4181094,223403,5332,1690,1679,1654,320,695,1386,1370,984,268,poisson-block-composition-pa
902,sp_workloads,1690805680,wl_small_mem,220,basic:GM-LM-RR-LSVT-sub25100-defpa,0,greedy,block-composition-pa,poisson,ncd,basic:GM-LM-RR-LSVT,sub25100,defpa,Unlocking,0.2,RandResponseMechanism,{'Optimal': 40},4834309,320190,30099,59393,19440,9807,4774916,300750,20292,1752,1677,1693,43,152,577,1709,1525,1116,poisson-block-composition-pa
903,sp_workloads,1690805680,wl_small_mem,220,basic:GM-LM-RR-LSVT-sub25100-defpa,0,greedy,block-composition-pa,poisson,ncd,basic:GM-LM-RR-LSVT,sub25100,defpa,Unlocking,0.2,SVTLaplaceMechanism,{'Optimal': 40},4502539,307841,30348,52798,18550,9578,4449741,289291,20770,1685,1652,1684,46,152,550,1639,1500,1134,poisson-block-composition-pa
904,sp_workloads,1690805680,wl_small_mem,221,basic:GM-LM-RR-LSVT-sub25100-defpa,0,greedy,block-composition-pa,poisson,ncd,basic:GM-LM-RR-LSVT,sub25100,defpa,Unlocking,0.4,GaussianMechanism,{'Optimal': 40},4847751,317174,28905,652374,185735,23036,4195377,131439,5869,1760,1618,1607,534,1062,1300,1226,556,307,poisson-block-composition-pa
905,sp_workloads,1690805680,wl_small_mem,221,basic:GM-LM-RR-LSVT-sub25100-defpa,0,greedy,block-composition-pa,poisson,ncd,basic:GM-LM-RR-LSVT,sub25100,defpa,Unlocking,0.4,LaplaceMechanism,{'Optimal': 40},4580618,310999,29482,411520,99202,24171,4169098,211797,5311,1690,1679,1654,340,755,1381,1350,924,273,poisson-block-composition-pa
906,sp_workloads,1690805680,wl_small_mem,221,basic:GM-LM-RR-LSVT-sub25100-defpa,0,greedy,block-composition-pa,poisson,ncd,basic:GM-LM-RR-LSVT,sub25100,defpa,Unlocking,0.4,RandResponseMechanism,{'Optimal': 40},4834309,320190,30099,56873,19116,10702,4777436,301074,19397,1752,1677,1693,42,147,626,1710,1530,1067,poisson-block-composition-pa
907,sp_workloads,1690805680,wl_small_mem,221,basic:GM-LM-RR-LSVT-sub25100-defpa,0,greedy,block-composition-pa,poisson,ncd,basic:GM-LM-RR-LSVT,sub25100,defpa,Unlocking,0.4,SVTLaplaceMechanism,{'Optimal': 40},4502539,307841,30348,48365,20123,10366,4454174,287718,19982,1685,1652,1684,47,157,594,1638,1495,1090,poisson-block-composition-pa
908,sp_workloads,1690805680,wl_small_mem,222,basic:GM-LM-RR-LSVT-sub25100-defpa,0,greedy,block-composition-pa,poisson,equal-ncd,basic:GM-LM-RR-LSVT,sub25100,defpa,Unlocking,0.2,GaussianMechanism,{'Optimal': 40},1760,1618,1607,479,999,1314,1281,619,293,1760,1618,1607,479,999,1314,1281,619,293,poisson-block-composition-pa
909,sp_workloads,1690805680,wl_small_mem,222,basic:GM-LM-RR-LSVT-sub25100-defpa,0,greedy,block-composition-pa,poisson,equal-ncd,basic:GM-LM-RR-LSVT,sub25100,defpa,Unlocking,0.2,LaplaceMechanism,{'Optimal': 40},1690,1679,1654,320,695,1386,1370,984,268,1690,1679,1654,320,695,1386,1370,984,268,poisson-block-composition-pa
910,sp_workloads,1690805680,wl_small_mem,222,basic:GM-LM-RR-LSVT-sub25100-defpa,0,greedy,block-composition-pa,poisson,equal-ncd,basic:GM-LM-RR-LSVT,sub25100,defpa,Unlocking,0.2,RandResponseMechanism,{'Optimal': 40},1752,1677,1693,43,152,577,1709,1525,1116,1752,1677,1693,43,152,577,1709,1525,1116,poisson-block-composition-pa
911,sp_workloads,1690805680,wl_small_mem,222,basic:GM-LM-RR-LSVT-sub25100-defpa,0,greedy,block-composition-pa,poisson,equal-ncd,basic:GM-LM-RR-LSVT,sub25100,defpa,Unlocking,0.2,SVTLaplaceMechanism,{'Optimal': 40},1685,1652,1684,46,152,550,1639,1500,1134,1685,1652,1684,46,152,550,1639,1500,1134,poisson-block-composition-pa
912,sp_workloads,1690805680,wl_small_mem,223,basic:GM-LM-RR-LSVT-sub25100-defpa,0,greedy,block-composition-pa,poisson,equal-ncd,basic:GM-LM-RR-LSVT,sub25100,defpa,Unlocking,0.4,GaussianMechanism,{'Optimal': 40},1760,1618,1607,534,1062,1300,1226,556,307,1760,1618,1607,534,1062,1300,1226,556,307,poisson-block-composition-pa
913,sp_workloads,1690805680,wl_small_mem,223,basic:GM-LM-RR-LSVT-sub25100-defpa,0,greedy,block-composition-pa,poisson,equal-ncd,basic:GM-LM-RR-LSVT,sub25100,defpa,Unlocking,0.4,LaplaceMechanism,{'Optimal': 40},1690,1679,1654,340,755,1381,1350,924,273,1690,1679,1654,340,755,1381,1350,924,273,poisson-block-composition-pa
914,sp_workloads,1690805680,wl_small_mem,223,basic:GM-LM-RR-LSVT-sub25100-defpa,0,greedy,block-composition-pa,poisson,equal-ncd,basic:GM-LM-RR-LSVT,sub25100,defpa,Unlocking,0.4,RandResponseMechanism,{'Optimal': 40},1752,1677,1693,42,147,626,1710,1530,1067,1752,1677,1693,42,147,626,1710,1530,1067,poisson-block-composition-pa
915,sp_workloads,1690805680,wl_small_mem,223,basic:GM-LM-RR-LSVT-sub25100-defpa,0,greedy,block-composition-pa,poisson,equal-ncd,basic:GM-LM-RR-LSVT,sub25100,defpa,Unlocking,0.4,SVTLaplaceMechanism,{'Optimal': 40},1685,1652,1684,47,157,594,1638,1495,1090,1685,1652,1684,47,157,594,1638,1495,1090,poisson-block-composition-pa
916,sp_workloads,1690805680,wl_small_mem,224,basic:GM-LM-RR-LSVT-sub25100-defpa,1,greedy,block-composition-pa,poisson,ncd,basic:GM-LM-RR-LSVT,sub25100,defpa,Unlocking,0.2,GaussianMechanism,{'Optimal': 40},4674135,351804,29818,610352,186032,24376,4063783,165772,5442,1725,1745,1670,467,1062,1384,1258,683,286,poisson-block-composition-pa
917,sp_workloads,1690805680,wl_small_mem,224,basic:GM-LM-RR-LSVT-sub25100-defpa,1,greedy,block-composition-pa,poisson,ncd,basic:GM-LM-RR-LSVT,sub25100,defpa,Unlocking,0.2,LaplaceMechanism,{'Optimal': 40},4701336,316959,30901,342707,82926,25556,4358629,234033,5345,1705,1659,1707,312,666,1436,1393,993,271,poisson-block-composition-pa
918,sp_workloads,1690805680,wl_small_mem,224,basic:GM-LM-RR-LSVT-sub25100-defpa,1,greedy,block-composition-pa,poisson,ncd,basic:GM-LM-RR-LSVT,sub25100,defpa,Unlocking,0.2,RandResponseMechanism,{'Optimal': 40},4751311,334074,30363,43457,17178,10642,4707854,316896,19721,1634,1678,1701,41,140,622,1593,1538,1079,poisson-block-composition-pa
919,sp_workloads,1690805680,wl_small_mem,224,basic:GM-LM-RR-LSVT-sub25100-defpa,1,greedy,block-composition-pa,poisson,ncd,basic:GM-LM-RR-LSVT,sub25100,defpa,Unlocking,0.2,SVTLaplaceMechanism,{'Optimal': 40},4658717,301226,29963,71823,15146,10635,4586894,286080,19328,1700,1628,1669,56,147,613,1644,1481,1056,poisson-block-composition-pa
920,sp_workloads,1690805680,wl_small_mem,225,basic:GM-LM-RR-LSVT-sub25100-defpa,1,greedy,block-composition-pa,poisson,ncd,basic:GM-LM-RR-LSVT,sub25100,defpa,Unlocking,0.4,GaussianMechanism,{'Optimal': 40},4674135,351804,29818,659000,215030,24891,4015135,136774,4927,1725,1745,1670,537,1175,1413,1188,570,257,poisson-block-composition-pa
921,sp_workloads,1690805680,wl_small_mem,225,basic:GM-LM-RR-LSVT-sub25100-defpa,1,greedy,block-composition-pa,poisson,ncd,basic:GM-LM-RR-LSVT,sub25100,defpa,Unlocking,0.4,LaplaceMechanism,{'Optimal': 40},4701336,316959,30901,440079,96331,26092,4261257,220628,4809,1705,1659,1707,351,730,1460,1354,929,247,poisson-block-composition-pa
922,sp_workloads,1690805680,wl_small_mem,225,basic:GM-LM-RR-LSVT-sub25100-defpa,1,greedy,block-composition-pa,poisson,ncd,basic:GM-LM-RR-LSVT,sub25100,defpa,Unlocking,0.4,RandResponseMechanism,{'Optimal': 40},4751311,334074,30363,58149,18498,10268,4693162,315576,20095,1634,1678,1701,47,154,596,1587,1524,1105,poisson-block-composition-pa
923,sp_workloads,1690805680,wl_small_mem,225,basic:GM-LM-RR-LSVT-sub25100-defpa,1,greedy,block-composition-pa,poisson,ncd,basic:GM-LM-RR-LSVT,sub25100,defpa,Unlocking,0.4,SVTLaplaceMechanism,{'Optimal': 40},4658717,301226,29963,55600,19239,9677,4603117,281987,20286,1700,1628,1669,52,173,563,1648,1455,1106,poisson-block-composition-pa
924,sp_workloads,1690805680,wl_small_mem,226,basic:GM-LM-RR-LSVT-sub25100-defpa,1,greedy,block-composition-pa,poisson,equal-ncd,basic:GM-LM-RR-LSVT,sub25100,defpa,Unlocking,0.2,GaussianMechanism,{'Optimal': 40},1725,1745,1670,467,1062,1384,1258,683,286,1725,1745,1670,467,1062,1384,1258,683,286,poisson-block-composition-pa
925,sp_workloads,1690805680,wl_small_mem,226,basic:GM-LM-RR-LSVT-sub25100-defpa,1,greedy,block-composition-pa,poisson,equal-ncd,basic:GM-LM-RR-LSVT,sub25100,defpa,Unlocking,0.2,LaplaceMechanism,{'Optimal': 40},1705,1659,1707,312,666,1436,1393,993,271,1705,1659,1707,312,666,1436,1393,993,271,poisson-block-composition-pa
926,sp_workloads,1690805680,wl_small_mem,226,basic:GM-LM-RR-LSVT-sub25100-defpa,1,greedy,block-composition-pa,poisson,equal-ncd,basic:GM-LM-RR-LSVT,sub25100,defpa,Unlocking,0.2,RandResponseMechanism,{'Optimal': 40},1634,1678,1701,41,140,622,1593,1538,1079,1634,1678,1701,41,140,622,1593,1538,1079,poisson-block-composition-pa
927,sp_workloads,1690805680,wl_small_mem,226,basic:GM-LM-RR-LSVT-sub25100-defpa,1,greedy,block-composition-pa,poisson,equal-ncd,basic:GM-LM-RR-LSVT,sub25100,defpa,Unlocking,0.2,SVTLaplaceMechanism,{'Optimal': 40},1700,1628,1669,56,147,613,1644,1481,1056,1700,1628,1669,56,147,613,1644,1481,1056,poisson-block-composition-pa
928,sp_workloads,1690805680,wl_small_mem,227,basic:GM-LM-RR-LSVT-sub25100-defpa,1,greedy,block-composition-pa,poisson,equal-ncd,basic:GM-LM-RR-LSVT,sub25100,defpa,Unlocking,0.4,GaussianMechanism,{'Optimal': 40},1725,1745,1670,537,1175,1413,1188,570,257,1725,1745,1670,537,1175,1413,1188,570,257,poisson-block-composition-pa
929,sp_workloads,1690805680,wl_small_mem,227,basic:GM-LM-RR-LSVT-sub25100-defpa,1,greedy,block-composition-pa,poisson,equal-ncd,basic:GM-LM-RR-LSVT,sub25100,defpa,Unlocking,0.4,LaplaceMechanism,{'Optimal': 40},1705,1659,1707,351,730,1460,1354,929,247,1705,1659,1707,351,730,1460,1354,929,247,poisson-block-composition-pa
930,sp_workloads,1690805680,wl_small_mem,227,basic:GM-LM-RR-LSVT-sub25100-defpa,1,greedy,block-composition-pa,poisson,equal-ncd,basic:GM-LM-RR-LSVT,sub25100,defpa,Unlocking,0.4,RandResponseMechanism,{'Optimal': 40},1634,1678,1701,47,154,596,1587,1524,1105,1634,1678,1701,47,154,596,1587,1524,1105,poisson-block-composition-pa
931,sp_workloads,1690805680,wl_small_mem,227,basic:GM-LM-RR-LSVT-sub25100-defpa,1,greedy,block-composition-pa,poisson,equal-ncd,basic:GM-LM-RR-LSVT,sub25100,defpa,Unlocking,0.4,SVTLaplaceMechanism,{'Optimal': 40},1700,1628,1669,52,173,563,1648,1455,1106,1700,1628,1669,52,173,563,1648,1455,1106,poisson-block-composition-pa
932,sp_workloads,1690805680,wl_small_mem,228,basic:GM-LM-RR-LSVT-sub25100-defpa,2,greedy,block-composition-pa,poisson,ncd,basic:GM-LM-RR-LSVT,sub25100,defpa,Unlocking,0.2,GaussianMechanism,{'Optimal': 40},4344073,336565,33248,456067,188473,26224,3888006,148092,7024,1647,1671,1731,391,1050,1396,1256,621,335,poisson-block-composition-pa
933,sp_workloads,1690805680,wl_small_mem,228,basic:GM-LM-RR-LSVT-sub25100-defpa,2,greedy,block-composition-pa,poisson,ncd,basic:GM-LM-RR-LSVT,sub25100,defpa,Unlocking,0.2,LaplaceMechanism,{'Optimal': 40},4548967,333299,30800,378725,99261,24688,4170242,234038,6112,1660,1661,1646,298,696,1333,1362,965,313,poisson-block-composition-pa
934,sp_workloads,1690805680,wl_small_mem,228,basic:GM-LM-RR-LSVT-sub25100-defpa,2,greedy,block-composition-pa,poisson,ncd,basic:GM-LM-RR-LSVT,sub25100,defpa,Unlocking,0.2,RandResponseMechanism,{'Optimal': 40},5016525,328891,32448,53530,27256,10640,4962995,301635,21808,1714,1690,1723,40,170,598,1674,1520,1125,poisson-block-composition-pa
935,sp_workloads,1690805680,wl_small_mem,228,basic:GM-LM-RR-LSVT-sub25100-defpa,2,greedy,block-composition-pa,poisson,ncd,basic:GM-LM-RR-LSVT,sub25100,defpa,Unlocking,0.2,SVTLaplaceMechanism,{'Optimal': 40},4781610,327880,32576,46427,21945,10960,4735183,305935,21616,1631,1679,1700,41,159,604,1590,1520,1096,poisson-block-composition-pa
936,sp_workloads,1690805680,wl_small_mem,229,basic:GM-LM-RR-LSVT-sub25100-defpa,2,greedy,block-composition-pa,poisson,ncd,basic:GM-LM-RR-LSVT,sub25100,defpa,Unlocking,0.4,GaussianMechanism,{'Optimal': 40},4344073,336565,33248,597054,198894,26752,3747019,137671,6496,1647,1671,1731,459,1106,1417,1188,565,314,poisson-block-composition-pa
937,sp_workloads,1690805680,wl_small_mem,229,basic:GM-LM-RR-LSVT-sub25100-defpa,2,greedy,block-composition-pa,poisson,ncd,basic:GM-LM-RR-LSVT,sub25100,defpa,Unlocking,0.4,LaplaceMechanism,{'Optimal': 40},4548967,333299,30800,446864,110045,24912,4102103,223254,5888,1660,1661,1646,325,737,1346,1335,924,300,poisson-block-composition-pa
938,sp_workloads,1690805680,wl_small_mem,229,basic:GM-LM-RR-LSVT-sub25100-defpa,2,greedy,block-composition-pa,poisson,ncd,basic:GM-LM-RR-LSVT,sub25100,defpa,Unlocking,0.4,RandResponseMechanism,{'Optimal': 40},5016525,328891,32448,69614,25233,10800,4946911,303658,21648,1714,1690,1723,45,178,600,1669,1512,1123,poisson-block-composition-pa
939,sp_workloads,1690805680,wl_small_mem,229,basic:GM-LM-RR-LSVT-sub25100-defpa,2,greedy,block-composition-pa,poisson,ncd,basic:GM-LM-RR-LSVT,sub25100,defpa,Unlocking,0.4,SVTLaplaceMechanism,{'Optimal': 40},4781610,327880,32576,68319,20995,11600,4713291,306885,20976,1631,1679,1700,45,149,640,1586,1530,1060,poisson-block-composition-pa
940,sp_workloads,1690805680,wl_small_mem,230,basic:GM-LM-RR-LSVT-sub25100-defpa,2,greedy,block-composition-pa,poisson,equal-ncd,basic:GM-LM-RR-LSVT,sub25100,defpa,Unlocking,0.2,GaussianMechanism,{'Optimal': 40},1647,1671,1731,391,1050,1396,1256,621,335,1647,1671,1731,391,1050,1396,1256,621,335,poisson-block-composition-pa
941,sp_workloads,1690805680,wl_small_mem,230,basic:GM-LM-RR-LSVT-sub25100-defpa,2,greedy,block-composition-pa,poisson,equal-ncd,basic:GM-LM-RR-LSVT,sub25100,defpa,Unlocking,0.2,LaplaceMechanism,{'Optimal': 40},1660,1661,1646,298,696,1333,1362,965,313,1660,1661,1646,298,696,1333,1362,965,313,poisson-block-composition-pa
942,sp_workloads,1690805680,wl_small_mem,230,basic:GM-LM-RR-LSVT-sub25100-defpa,2,greedy,block-composition-pa,poisson,equal-ncd,basic:GM-LM-RR-LSVT,sub25100,defpa,Unlocking,0.2,RandResponseMechanism,{'Optimal': 40},1714,1690,1723,40,170,598,1674,1520,1125,1714,1690,1723,40,170,598,1674,1520,1125,poisson-block-composition-pa
943,sp_workloads,1690805680,wl_small_mem,230,basic:GM-LM-RR-LSVT-sub25100-defpa,2,greedy,block-composition-pa,poisson,equal-ncd,basic:GM-LM-RR-LSVT,sub25100,defpa,Unlocking,0.2,SVTLaplaceMechanism,{'Optimal': 40},1631,1679,1700,41,159,604,1590,1520,1096,1631,1679,1700,41,159,604,1590,1520,1096,poisson-block-composition-pa
944,sp_workloads,1690805680,wl_small_mem,231,basic:GM-LM-RR-LSVT-sub25100-defpa,2,greedy,block-composition-pa,poisson,equal-ncd,basic:GM-LM-RR-LSVT,sub25100,defpa,Unlocking,0.4,GaussianMechanism,{'Optimal': 40},1647,1671,1731,459,1106,1417,1188,565,314,1647,1671,1731,459,1106,1417,1188,565,314,poisson-block-composition-pa
945,sp_workloads,1690805680,wl_small_mem,231,basic:GM-LM-RR-LSVT-sub25100-defpa,2,greedy,block-composition-pa,poisson,equal-ncd,basic:GM-LM-RR-LSVT,sub25100,defpa,Unlocking,0.4,LaplaceMechanism,{'Optimal': 40},1660,1661,1646,325,737,1346,1335,924,300,1660,1661,1646,325,737,1346,1335,924,300,poisson-block-composition-pa
946,sp_workloads,1690805680,wl_small_mem,231,basic:GM-LM-RR-LSVT-sub25100-defpa,2,greedy,block-composition-pa,poisson,equal-ncd,basic:GM-LM-RR-LSVT,sub25100,defpa,Unlocking,0.4,RandResponseMechanism,{'Optimal': 40},1714,1690,1723,45,178,600,1669,1512,1123,1714,1690,1723,45,178,600,1669,1512,1123,poisson-block-composition-pa
947,sp_workloads,1690805680,wl_small_mem,231,basic:GM-LM-RR-LSVT-sub25100-defpa,2,greedy,block-composition-pa,poisson,equal-ncd,basic:GM-LM-RR-LSVT,sub25100,defpa,Unlocking,0.4,SVTLaplaceMechanism,{'Optimal': 40},1631,1679,1700,45,149,640,1586,1530,1060,1631,1679,1700,45,149,640,1586,1530,1060,poisson-block-composition-pa
948,sp_workloads,1690805680,wl_small_mem,232,basic:GM-LM-RR-LSVT-sub25100-defpa,3,greedy,block-composition-pa,poisson,ncd,basic:GM-LM-RR-LSVT,sub25100,defpa,Unlocking,0.2,GaussianMechanism,{'Optimal': 40},4431438,335185,30243,530608,186084,24228,3900830,149101,6015,1636,1707,1661,434,1076,1356,1202,631,305,poisson-block-composition-pa
949,sp_workloads,1690805680,wl_small_mem,232,basic:GM-LM-RR-LSVT-sub25100-defpa,3,greedy,block-composition-pa,poisson,ncd,basic:GM-LM-RR-LSVT,sub25100,defpa,Unlocking,0.2,LaplaceMechanism,{'Optimal': 40},4614241,302136,30909,346774,81322,25612,4267467,220814,5297,1669,1590,1731,300,624,1444,1369,966,287,poisson-block-composition-pa
950,sp_workloads,1690805680,wl_small_mem,232,basic:GM-LM-RR-LSVT-sub25100-defpa,3,greedy,block-composition-pa,poisson,ncd,basic:GM-LM-RR-LSVT,sub25100,defpa,Unlocking,0.2,RandResponseMechanism,{'Optimal': 40},4710432,347409,29228,55740,18329,9887,4654692,329080,19341,1691,1685,1636,45,155,577,1646,1530,1059,poisson-block-composition-pa
951,sp_workloads,1690805680,wl_small_mem,232,basic:GM-LM-RR-LSVT-sub25100-defpa,3,greedy,block-composition-pa,poisson,ncd,basic:GM-LM-RR-LSVT,sub25100,defpa,Unlocking,0.2,SVTLaplaceMechanism,{'Optimal': 40},4781445,315437,29779,60836,18447,10159,4720609,296990,19620,1697,1624,1645,44,146,593,1653,1478,1052,poisson-block-composition-pa
952,sp_workloads,1690805680,wl_small_mem,233,basic:GM-LM-RR-LSVT-sub25100-defpa,3,greedy,block-composition-pa,poisson,ncd,basic:GM-LM-RR-LSVT,sub25100,defpa,Unlocking,0.4,GaussianMechanism,{'Optimal': 40},4431438,335185,30243,643502,189981,25024,3787936,145204,5219,1636,1707,1661,478,1129,1392,1158,578,269,poisson-block-composition-pa
953,sp_workloads,1690805680,wl_small_mem,233,basic:GM-LM-RR-LSVT-sub25100-defpa,3,greedy,block-composition-pa,poisson,ncd,basic:GM-LM-RR-LSVT,sub25100,defpa,Unlocking,0.4,LaplaceMechanism,{'Optimal': 40},4614241,302136,30909,437123,110207,26108,4177118,191929,4801,1669,1590,1731,343,723,1476,1326,867,255,poisson-block-composition-pa
954,sp_workloads,1690805680,wl_small_mem,233,basic:GM-LM-RR-LSVT-sub25100-defpa,3,greedy,block-composition-pa,poisson,ncd,basic:GM-LM-RR-LSVT,sub25100,defpa,Unlocking,0.4,RandResponseMechanism,{'Optimal': 40},4710432,347409,29228,81235,20251,9545,4629197,327158,19683,1691,1685,1636,42,146,567,1649,1539,1069,poisson-block-composition-pa
955,sp_workloads,1690805680,wl_small_mem,233,basic:GM-LM-RR-LSVT-sub25100-defpa,3,greedy,block-composition-pa,poisson,ncd,basic:GM-LM-RR-LSVT,sub25100,defpa,Unlocking,0.4,SVTLaplaceMechanism,{'Optimal': 40},4781445,315437,29779,75172,17416,10103,4706273,298021,19676,1697,1624,1645,50,141,585,1647,1483,1060,poisson-block-composition-pa
956,sp_workloads,1690805680,wl_small_mem,234,basic:GM-LM-RR-LSVT-sub25100-defpa,3,greedy,block-composition-pa,poisson,equal-ncd,basic:GM-LM-RR-LSVT,sub25100,defpa,Unlocking,0.2,GaussianMechanism,{'Optimal': 40},1636,1707,1661,434,1076,1356,1202,631,305,1636,1707,1661,434,1076,1356,1202,631,305,poisson-block-composition-pa
957,sp_workloads,1690805680,wl_small_mem,234,basic:GM-LM-RR-LSVT-sub25100-defpa,3,greedy,block-composition-pa,poisson,equal-ncd,basic:GM-LM-RR-LSVT,sub25100,defpa,Unlocking,0.2,LaplaceMechanism,{'Optimal': 40},1669,1590,1731,300,624,1444,1369,966,287,1669,1590,1731,300,624,1444,1369,966,287,poisson-block-composition-pa
958,sp_workloads,1690805680,wl_small_mem,234,basic:GM-LM-RR-LSVT-sub25100-defpa,3,greedy,block-composition-pa,poisson,equal-ncd,basic:GM-LM-RR-LSVT,sub25100,defpa,Unlocking,0.2,RandResponseMechanism,{'Optimal': 40},1691,1685,1636,45,155,577,1646,1530,1059,1691,1685,1636,45,155,577,1646,1530,1059,poisson-block-composition-pa
959,sp_workloads,1690805680,wl_small_mem,234,basic:GM-LM-RR-LSVT-sub25100-defpa,3,greedy,block-composition-pa,poisson,equal-ncd,basic:GM-LM-RR-LSVT,sub25100,defpa,Unlocking,0.2,SVTLaplaceMechanism,{'Optimal': 40},1697,1624,1645,44,146,593,1653,1478,1052,1697,1624,1645,44,146,593,1653,1478,1052,poisson-block-composition-pa
960,sp_workloads,1690805680,wl_small_mem,235,basic:GM-LM-RR-LSVT-sub25100-defpa,3,greedy,block-composition-pa,poisson,equal-ncd,basic:GM-LM-RR-LSVT,sub25100,defpa,Unlocking,0.4,GaussianMechanism,{'Optimal': 40},1636,1707,1661,478,1129,1392,1158,578,269,1636,1707,1661,478,1129,1392,1158,578,269,poisson-block-composition-pa
961,sp_workloads,1690805680,wl_small_mem,235,basic:GM-LM-RR-LSVT-sub25100-defpa,3,greedy,block-composition-pa,poisson,equal-ncd,basic:GM-LM-RR-LSVT,sub25100,defpa,Unlocking,0.4,LaplaceMechanism,{'Optimal': 40},1669,1590,1731,343,723,1476,1326,867,255,1669,1590,1731,343,723,1476,1326,867,255,poisson-block-composition-pa
962,sp_workloads,1690805680,wl_small_mem,235,basic:GM-LM-RR-LSVT-sub25100-defpa,3,greedy,block-composition-pa,poisson,equal-ncd,basic:GM-LM-RR-LSVT,sub25100,defpa,Unlocking,0.4,RandResponseMechanism,{'Optimal': 40},1691,1685,1636,42,146,567,1649,1539,1069,1691,1685,1636,42,146,567,1649,1539,1069,poisson-block-composition-pa
963,sp_workloads,1690805680,wl_small_mem,235,basic:GM-LM-RR-LSVT-sub25100-defpa,3,greedy,block-composition-pa,poisson,equal-ncd,basic:GM-LM-RR-LSVT,sub25100,defpa,Unlocking,0.4,SVTLaplaceMechanism,{'Optimal': 40},1697,1624,1645,50,141,585,1647,1483,1060,1697,1624,1645,50,141,585,1647,1483,1060,poisson-block-composition-pa
964,sp_workloads,1690805680,wl_small_mem,236,basic:GM-LM-RR-LSVT-sub25100-defpa,4,greedy,block-composition-pa,poisson,ncd,basic:GM-LM-RR-LSVT,sub25100,defpa,Unlocking,0.2,GaussianMechanism,{'Optimal': 40},4571824,341651,31424,539705,192623,25504,4032119,149028,5920,1667,1683,1652,436,1071,1357,1231,612,295,poisson-block-composition-pa
965,sp_workloads,1690805680,wl_small_mem,236,basic:GM-LM-RR-LSVT-sub25100-defpa,4,greedy,block-composition-pa,poisson,ncd,basic:GM-LM-RR-LSVT,sub25100,defpa,Unlocking,0.2,LaplaceMechanism,{'Optimal': 40},4559498,310728,31904,347631,86571,26416,4211867,224157,5488,1705,1675,1674,318,655,1406,1387,1020,268,poisson-block-composition-pa
966,sp_workloads,1690805680,wl_small_mem,236,basic:GM-LM-RR-LSVT-sub25100-defpa,4,greedy,block-composition-pa,poisson,ncd,basic:GM-LM-RR-LSVT,sub25100,defpa,Unlocking,0.2,RandResponseMechanism,{'Optimal': 40},4915555,321907,33248,48728,18944,11024,4866827,302963,22224,1732,1682,1739,44,154,613,1688,1528,1126,poisson-block-composition-pa
967,sp_workloads,1690805680,wl_small_mem,236,basic:GM-LM-RR-LSVT-sub25100-defpa,4,greedy,block-composition-pa,poisson,ncd,basic:GM-LM-RR-LSVT,sub25100,defpa,Unlocking,0.2,SVTLaplaceMechanism,{'Optimal': 40},4827443,310825,33008,42230,18318,11328,4785213,292507,21680,1701,1631,1753,36,146,641,1665,1485,1112,poisson-block-composition-pa
968,sp_workloads,1690805680,wl_small_mem,237,basic:GM-LM-RR-LSVT-sub25100-defpa,4,greedy,block-composition-pa,poisson,ncd,basic:GM-LM-RR-LSVT,sub25100,defpa,Unlocking,0.4,GaussianMechanism,{'Optimal': 40},4571824,341651,31424,632982,206466,26528,3938842,135185,4896,1667,1683,1652,480,1126,1401,1187,557,251,poisson-block-composition-pa
969,sp_workloads,1690805680,wl_small_mem,237,basic:GM-LM-RR-LSVT-sub25100-defpa,4,greedy,block-composition-pa,poisson,ncd,basic:GM-LM-RR-LSVT,sub25100,defpa,Unlocking,0.4,LaplaceMechanism,{'Optimal': 40},4559498,310728,31904,435630,102347,26288,4123868,208381,5616,1705,1675,1674,380,737,1395,1325,938,279,poisson-block-composition-pa
970,sp_workloads,1690805680,wl_small_mem,237,basic:GM-LM-RR-LSVT-sub25100-defpa,4,greedy,block-composition-pa,poisson,ncd,basic:GM-LM-RR-LSVT,sub25100,defpa,Unlocking,0.4,RandResponseMechanism,{'Optimal': 40},4915555,321907,33248,64207,20817,11104,4851348,301090,22144,1732,1682,1739,46,165,619,1686,1517,1120,poisson-block-composition-pa
971,sp_workloads,1690805680,wl_small_mem,237,basic:GM-LM-RR-LSVT-sub25100-defpa,4,greedy,block-composition-pa,poisson,ncd,basic:GM-LM-RR-LSVT,sub25100,defpa,Unlocking,0.4,SVTLaplaceMechanism,{'Optimal': 40},4827443,310825,33008,44686,18524,11296,4782757,292301,21712,1701,1631,1753,33,153,631,1668,1478,1122,poisson-block-composition-pa
972,sp_workloads,1690805680,wl_small_mem,238,basic:GM-LM-RR-LSVT-sub25100-defpa,4,greedy,block-composition-pa,poisson,equal-ncd,basic:GM-LM-RR-LSVT,sub25100,defpa,Unlocking,0.2,GaussianMechanism,{'Optimal': 40},1667,1683,1652,436,1071,1357,1231,612,295,1667,1683,1652,436,1071,1357,1231,612,295,poisson-block-composition-pa
973,sp_workloads,1690805680,wl_small_mem,238,basic:GM-LM-RR-LSVT-sub25100-defpa,4,greedy,block-composition-pa,poisson,equal-ncd,basic:GM-LM-RR-LSVT,sub25100,defpa,Unlocking,0.2,LaplaceMechanism,{'Optimal': 40},1705,1675,1674,318,655,1406,1387,1020,268,1705,1675,1674,318,655,1406,1387,1020,268,poisson-block-composition-pa
974,sp_workloads,1690805680,wl_small_mem,238,basic:GM-LM-RR-LSVT-sub25100-defpa,4,greedy,block-composition-pa,poisson,equal-ncd,basic:GM-LM-RR-LSVT,sub25100,defpa,Unlocking,0.2,RandResponseMechanism,{'Optimal': 40},1732,1682,1739,44,154,613,1688,1528,1126,1732,1682,1739,44,154,613,1688,1528,1126,poisson-block-composition-pa
975,sp_workloads,1690805680,wl_small_mem,238,basic:GM-LM-RR-LSVT-sub25100-defpa,4,greedy,block-composition-pa,poisson,equal-ncd,basic:GM-LM-RR-LSVT,sub25100,defpa,Unlocking,0.2,SVTLaplaceMechanism,{'Optimal': 40},1701,1631,1753,36,146,641,1665,1485,1112,1701,1631,1753,36,146,641,1665,1485,1112,poisson-block-composition-pa
976,sp_workloads,1690805680,wl_small_mem,239,basic:GM-LM-RR-LSVT-sub25100-defpa,4,greedy,block-composition-pa,poisson,equal-ncd,basic:GM-LM-RR-LSVT,sub25100,defpa,Unlocking,0.4,GaussianMechanism,{'Optimal': 40},1667,1683,1652,480,1126,1401,1187,557,251,1667,1683,1652,480,1126,1401,1187,557,251,poisson-block-composition-pa
977,sp_workloads,1690805680,wl_small_mem,239,basic:GM-LM-RR-LSVT-sub25100-defpa,4,greedy,block-composition-pa,poisson,equal-ncd,basic:GM-LM-RR-LSVT,sub25100,defpa,Unlocking,0.4,LaplaceMechanism,{'Optimal': 40},1705,1675,1674,380,737,1395,1325,938,279,1705,1675,1674,380,737,1395,1325,938,279,poisson-block-composition-pa
978,sp_workloads,1690805680,wl_small_mem,239,basic:GM-LM-RR-LSVT-sub25100-defpa,4,greedy,block-composition-pa,poisson,equal-ncd,basic:GM-LM-RR-LSVT,sub25100,defpa,Unlocking,0.4,RandResponseMechanism,{'Optimal': 40},1732,1682,1739,46,165,619,1686,1517,1120,1732,1682,1739,46,165,619,1686,1517,1120,poisson-block-composition-pa
979,sp_workloads,1690805680,wl_small_mem,239,basic:GM-LM-RR-LSVT-sub25100-defpa,4,greedy,block-composition-pa,poisson,equal-ncd,basic:GM-LM-RR-LSVT,sub25100,defpa,Unlocking,0.4,SVTLaplaceMechanism,{'Optimal': 40},1701,1631,1753,33,153,631,1668,1478,1122,1701,1631,1753,33,153,631,1668,1478,1122,poisson-block-composition-pa
980,sp_workloads,1690805680,wl_small_mem,960,gm:GM-sub25100-defpa,0,weighted-dpf+,block-composition,poisson,ncd,gm:GM,sub25100,nopa,Unlocking,0.2,GaussianMechanism,{'Optimal': 40},18864461,1345041,130912,1391541,28812,54624,17472920,1316229,76288,6716,6728,6904,612,196,3414,6104,6532,3490,poisson-block-composition
981,sp_workloads,1690805680,wl_small_mem,961,gm:GM-sub25100-defpa,0,weighted-dpf+,block-composition,poisson,ncd,gm:GM,sub25100,nopa,Unlocking,0.4,GaussianMechanism,{'Optimal': 40},18864461,1345041,130912,1404050,37693,54624,17460411,1307348,76288,6716,6728,6904,620,258,3414,6096,6470,3490,poisson-block-composition
982,sp_workloads,1690805680,wl_small_mem,962,gm:GM-sub25100-defpa,0,weighted-dpf+,block-composition,upc,ncd,gm:GM,sub25100,nopa,Unlocking,0.2,GaussianMechanism,{'Optimal': 40},18893588,1315647,124584,98373,212497,27793,18795215,1103150,96791,6716,6728,6904,11,469,1535,6705,6259,5369,upc-block-composition
983,sp_workloads,1690805680,wl_small_mem,963,gm:GM-sub25100-defpa,0,weighted-dpf+,block-composition,upc,ncd,gm:GM,sub25100,nopa,Unlocking,0.4,GaussianMechanism,{'Optimal': 40},18893588,1315647,124584,118486,194885,30583,18775102,1120762,94001,6716,6728,6904,14,538,1721,6702,6190,5183,upc-block-composition
984,sp_workloads,1690805680,wl_small_mem,964,gm:GM-sub25100-defpa,0,weighted-dpf+,block-composition,poisson,equal-ncd,gm:GM,sub25100,nopa,Unlocking,0.2,GaussianMechanism,{'Optimal': 40},6716,6728,6904,95,3327,6802,6621,3401,102,6716,6728,6904,95,3327,6802,6621,3401,102,poisson-block-composition
985,sp_workloads,1690805680,wl_small_mem,965,gm:GM-sub25100-defpa,0,weighted-dpf+,block-composition,poisson,equal-ncd,gm:GM,sub25100,nopa,Unlocking,0.4,GaussianMechanism,{'Optimal': 40},6716,6728,6904,161,3327,6174,6555,3401,730,6716,6728,6904,161,3327,6174,6555,3401,730,poisson-block-composition
986,sp_workloads,1690805680,wl_small_mem,966,gm:GM-sub25100-defpa,0,weighted-dpf+,block-composition,upc,equal-ncd,gm:GM,sub25100,nopa,Unlocking,0.2,GaussianMechanism,{'Optimal': 40},6716,6728,6904,1,841,6904,6715,5887,0,6716,6728,6904,1,841,6904,6715,5887,0,upc-block-composition
987,sp_workloads,1690805680,wl_small_mem,967,gm:GM-sub25100-defpa,0,weighted-dpf+,block-composition,upc,equal-ncd,gm:GM,sub25100,nopa,Unlocking,0.4,GaussianMechanism,{'Optimal': 40},6716,6728,6904,1,860,6876,6715,5868,28,6716,6728,6904,1,860,6876,6715,5868,28,upc-block-composition
988,sp_workloads,1690805680,wl_small_mem,968,gm:GM-sub25100-defpa,1,weighted-dpf+,block-composition,poisson,ncd,gm:GM,sub25100,nopa,Unlocking,0.2,GaussianMechanism,{'Optimal': 40},18715267,1320958,128176,1365419,31040,53056,17349848,1289918,75120,6673,6765,6731,611,216,3316,6062,6549,3415,poisson-block-composition
989,sp_workloads,1690805680,wl_small_mem,969,gm:GM-sub25100-defpa,1,weighted-dpf+,block-composition,poisson,ncd,gm:GM,sub25100,nopa,Unlocking,0.4,GaussianMechanism,{'Optimal': 40},18715267,1320958,128176,1383289,36000,53056,17331978,1284958,75120,6673,6765,6731,621,252,3316,6052,6513,3415,poisson-block-composition
990,sp_workloads,1690805680,wl_small_mem,970,gm:GM-sub25100-defpa,1,weighted-dpf+,block-composition,upc,ncd,gm:GM,sub25100,nopa,Unlocking,0.2,GaussianMechanism,{'Optimal': 40},18728783,1307738,120469,82147,226553,28524,18646636,1081185,91945,6673,6765,6731,11,509,1572,6662,6256,5159,upc-block-composition
991,sp_workloads,1690805680,wl_small_mem,971,gm:GM-sub25100-defpa,1,weighted-dpf+,block-composition,upc,ncd,gm:GM,sub25100,nopa,Unlocking,0.4,GaussianMechanism,{'Optimal': 40},18728783,1307738,120469,128570,184386,28959,18600213,1123352,91510,6673,6765,6731,16,546,1649,6657,6219,5082,upc-block-composition
992,sp_workloads,1690805680,wl_small_mem,972,gm:GM-sub25100-defpa,1,weighted-dpf+,block-composition,poisson,equal-ncd,gm:GM,sub25100,nopa,Unlocking,0.2,GaussianMechanism,{'Optimal': 40},6673,6765,6731,111,3375,6494,6562,3390,237,6673,6765,6731,111,3375,6494,6562,3390,237,poisson-block-composition
993,sp_workloads,1690805680,wl_small_mem,973,gm:GM-sub25100-defpa,1,weighted-dpf+,block-composition,poisson,equal-ncd,gm:GM,sub25100,nopa,Unlocking,0.4,GaussianMechanism,{'Optimal': 40},6673,6765,6731,175,3375,5873,6498,3390,858,6673,6765,6731,175,3375,5873,6498,3390,858,poisson-block-composition
994,sp_workloads,1690805680,wl_small_mem,974,gm:GM-sub25100-defpa,1,weighted-dpf+,block-composition,upc,equal-ncd,gm:GM,sub25100,nopa,Unlocking,0.2,GaussianMechanism,{'Optimal': 40},6673,6765,6731,1,867,6731,6672,5898,0,6673,6765,6731,1,867,6731,6672,5898,0,upc-block-composition
995,sp_workloads,1690805680,wl_small_mem,975,gm:GM-sub25100-defpa,1,weighted-dpf+,block-composition,upc,equal-ncd,gm:GM,sub25100,nopa,Unlocking,0.4,GaussianMechanism,{'Optimal': 40},6673,6765,6731,1,906,6709,6672,5859,22,6673,6765,6731,1,906,6709,6672,5859,22,upc-block-composition
996,sp_workloads,1690805680,wl_small_mem,976,gm:GM-sub25100-defpa,2,weighted-dpf+,block-composition,poisson,ncd,gm:GM,sub25100,nopa,Unlocking,0.2,GaussianMechanism,{'Optimal': 40},18806374,1355979,126784,1367748,29104,53232,17438626,1326875,73552,6783,6833,6678,612,202,3327,6171,6631,3351,poisson-block-composition
997,sp_workloads,1690805680,wl_small_mem,977,gm:GM-sub25100-defpa,2,weighted-dpf+,block-composition,poisson,ncd,gm:GM,sub25100,nopa,Unlocking,0.4,GaussianMechanism,{'Optimal': 40},18806374,1355979,126784,1389952,30256,53232,17416422,1325723,73552,6783,6833,6678,624,210,3327,6159,6623,3351,poisson-block-composition
998,sp_workloads,1690805680,wl_small_mem,978,gm:GM-sub25100-defpa,2,weighted-dpf+,block-composition,upc,ncd,gm:GM,sub25100,nopa,Unlocking,0.2,GaussianMechanism,{'Optimal': 40},18840947,1320526,120650,63799,238236,28994,18777148,1082290,91656,6783,6833,6678,8,558,1582,6775,6275,5096,upc-block-composition
999,sp_workloads,1690805680,wl_small_mem,979,gm:GM-sub25100-defpa,2,weighted-dpf+,block-composition,upc,ncd,gm:GM,sub25100,nopa,Unlocking,0.4,GaussianMechanism,{'Optimal': 40},18840947,1320526,120650,116574,194693,29140,18724373,1125833,91510,6783,6833,6678,14,561,1644,6769,6272,5034,upc-block-composition
1000,sp_workloads,1690805680,wl_small_mem,980,gm:GM-sub25100-defpa,2,weighted-dpf+,block-composition,poisson,equal-ncd,gm:GM,sub25100,nopa,Unlocking,0.2,GaussianMechanism,{'Optimal': 40},6783,6833,6678,105,3377,6560,6678,3456,118,6783,6833,6678,105,3377,6560,6678,3456,118,poisson-block-composition
1001,sp_workloads,1690805680,wl_small_mem,981,gm:GM-sub25100-defpa,2,weighted-dpf+,block-composition,poisson,equal-ncd,gm:GM,sub25100,nopa,Unlocking,0.4,GaussianMechanism,{'Optimal': 40},6783,6833,6678,172,3377,5905,6611,3456,773,6783,6833,6678,172,3377,5905,6611,3456,773,poisson-block-composition
1002,sp_workloads,1690805680,wl_small_mem,982,gm:GM-sub25100-defpa,2,weighted-dpf+,block-composition,upc,equal-ncd,gm:GM,sub25100,nopa,Unlocking,0.2,GaussianMechanism,{'Optimal': 40},6783,6833,6678,1,875,6678,6782,5958,0,6783,6833,6678,1,875,6678,6782,5958,0,upc-block-composition
1003,sp_workloads,1690805680,wl_small_mem,983,gm:GM-sub25100-defpa,2,weighted-dpf+,block-composition,upc,equal-ncd,gm:GM,sub25100,nopa,Unlocking,0.4,GaussianMechanism,{'Optimal': 40},6783,6833,6678,1,917,6662,6782,5916,16,6783,6833,6678,1,917,6662,6782,5916,16,upc-block-composition
1004,sp_workloads,1690805680,wl_small_mem,984,gm:GM-sub25100-defpa,3,weighted-dpf+,block-composition,poisson,ncd,gm:GM,sub25100,nopa,Unlocking,0.2,GaussianMechanism,{'Optimal': 40},18672541,1292482,118587,1321847,27661,50745,17350694,1264821,67842,6771,6693,6629,612,199,3383,6159,6494,3246,poisson-block-composition
1005,sp_workloads,1690805680,wl_small_mem,985,gm:GM-sub25100-defpa,3,weighted-dpf+,block-composition,poisson,ncd,gm:GM,sub25100,nopa,Unlocking,0.4,GaussianMechanism,{'Optimal': 40},18672541,1292482,118587,1338565,32250,50745,17333976,1260232,67842,6771,6693,6629,622,234,3383,6149,6459,3246,poisson-block-composition
1006,sp_workloads,1690805680,wl_small_mem,986,gm:GM-sub25100-defpa,3,weighted-dpf+,block-composition,upc,ncd,gm:GM,sub25100,nopa,Unlocking,0.2,GaussianMechanism,{'Optimal': 40},18653277,1308064,119435,90176,219298,28203,18563101,1088766,91232,6771,6693,6629,11,483,1621,6760,6210,5008,upc-block-composition
1007,sp_workloads,1690805680,wl_small_mem,987,gm:GM-sub25100-defpa,3,weighted-dpf+,block-composition,upc,ncd,gm:GM,sub25100,nopa,Unlocking,0.4,GaussianMechanism,{'Optimal': 40},18653277,1308064,119435,119191,187806,29226,18534086,1120258,90209,6771,6693,6629,15,557,1670,6756,6136,4959,upc-block-composition
1008,sp_workloads,1690805680,wl_small_mem,988,gm:GM-sub25100-defpa,3,weighted-dpf+,block-composition,poisson,equal-ncd,gm:GM,sub25100,nopa,Unlocking,0.2,GaussianMechanism,{'Optimal': 40},6771,6693,6629,114,3319,6545,6657,3374,84,6771,6693,6629,114,3319,6545,6657,3374,84,poisson-block-composition
1009,sp_workloads,1690805680,wl_small_mem,989,gm:GM-sub25100-defpa,3,weighted-dpf+,block-composition,poisson,equal-ncd,gm:GM,sub25100,nopa,Unlocking,0.4,GaussianMechanism,{'Optimal': 40},6771,6693,6629,181,3319,5913,6590,3374,716,6771,6693,6629,181,3319,5913,6590,3374,716,poisson-block-composition
1010,sp_workloads,1690805680,wl_small_mem,990,gm:GM-sub25100-defpa,3,weighted-dpf+,block-composition,upc,equal-ncd,gm:GM,sub25100,nopa,Unlocking,0.2,GaussianMechanism,{'Optimal': 40},6771,6693,6629,1,914,6629,6770,5779,0,6771,6693,6629,1,914,6629,6770,5779,0,upc-block-composition
1011,sp_workloads,1690805680,wl_small_mem,991,gm:GM-sub25100-defpa,3,weighted-dpf+,block-composition,upc,equal-ncd,gm:GM,sub25100,nopa,Unlocking,0.4,GaussianMechanism,{'Optimal': 40},6771,6693,6629,1,930,6617,6770,5763,12,6771,6693,6629,1,930,6617,6770,5763,12,upc-block-composition
1012,sp_workloads,1690805680,wl_small_mem,992,gm:GM-sub25100-defpa,4,weighted-dpf+,block-composition,poisson,ncd,gm:GM,sub25100,nopa,Unlocking,0.2,GaussianMechanism,{'Optimal': 40},18857452,1277663,120343,1330630,28420,49770,17526822,1249243,70573,6862,6691,6713,612,203,3318,6250,6488,3395,poisson-block-composition
1013,sp_workloads,1690805680,wl_small_mem,993,gm:GM-sub25100-defpa,4,weighted-dpf+,block-composition,poisson,ncd,gm:GM,sub25100,nopa,Unlocking,0.4,GaussianMechanism,{'Optimal': 40},18857452,1277663,120343,1349038,31360,49770,17508414,1246303,70573,6862,6691,6713,623,224,3318,6239,6467,3395,poisson-block-composition
1014,sp_workloads,1690805680,wl_small_mem,994,gm:GM-sub25100-defpa,4,weighted-dpf+,block-composition,upc,ncd,gm:GM,sub25100,nopa,Unlocking,0.2,GaussianMechanism,{'Optimal': 40},18854676,1280656,121591,63833,236458,29029,18790843,1044198,92562,6862,6691,6713,9,545,1627,6853,6146,5086,upc-block-composition
1015,sp_workloads,1690805680,wl_small_mem,995,gm:GM-sub25100-defpa,4,weighted-dpf+,block-composition,upc,ncd,gm:GM,sub25100,nopa,Unlocking,0.4,GaussianMechanism,{'Optimal': 40},18854676,1280656,121591,123868,183513,27900,18730808,1097143,93691,6862,6691,6713,17,533,1556,6845,6158,5157,upc-block-composition
1016,sp_workloads,1690805680,wl_small_mem,996,gm:GM-sub25100-defpa,4,weighted-dpf+,block-composition,poisson,equal-ncd,gm:GM,sub25100,nopa,Unlocking,0.2,GaussianMechanism,{'Optimal': 40},6862,6691,6713,105,3325,6610,6757,3366,103,6862,6691,6713,105,3325,6610,6757,3366,103,poisson-block-composition
1017,sp_workloads,1690805680,wl_small_mem,997,gm:GM-sub25100-defpa,4,weighted-dpf+,block-composition,poisson,equal-ncd,gm:GM,sub25100,nopa,Unlocking,0.4,GaussianMechanism,{'Optimal': 40},6862,6691,6713,173,3325,5942,6689,3366,771,6862,6691,6713,173,3325,5942,6689,3366,771,poisson-block-composition
1018,sp_workloads,1690805680,wl_small_mem,998,gm:GM-sub25100-defpa,4,weighted-dpf+,block-composition,upc,equal-ncd,gm:GM,sub25100,nopa,Unlocking,0.2,GaussianMechanism,{'Optimal': 40},6862,6691,6713,0,862,6713,6862,5829,0,6862,6691,6713,0,862,6713,6862,5829,0,upc-block-composition
1019,sp_workloads,1690805680,wl_small_mem,999,gm:GM-sub25100-defpa,4,weighted-dpf+,block-composition,upc,equal-ncd,gm:GM,sub25100,nopa,Unlocking,0.4,GaussianMechanism,{'Optimal': 40},6862,6691,6713,1,884,6702,6861,5807,11,6862,6691,6713,1,884,6702,6861,5807,11,upc-block-composition
1020,sp_workloads,1690805680,wl_small_mem,1000,ml:SGD-PATE-sub25100-defpa,0,weighted-dpf+,block-composition,poisson,ncd,ml:SGD-PATE,sub25100,nopa,Unlocking,0.2,MLNoisySGDMechanism,{'Optimal': 40},9320337,647144,60780,1251557,139,22815,8068780,647005,37965,3347,3348,3392,598,1,1520,2749,3347,1872,poisson-block-composition
1021,sp_workloads,1690805680,wl_small_mem,1000,ml:SGD-PATE-sub25100-defpa,0,weighted-dpf+,block-composition,poisson,ncd,ml:SGD-PATE,sub25100,nopa,Unlocking,0.2,MLPateGaussianMechanism,{'Optimal': 40},9560711,630849,59490,278741,18316,24885,9281970,612533,34605,3488,3389,3328,129,132,1659,3359,3257,1669,poisson-block-composition
1022,sp_workloads,1690805680,wl_small_mem,1001,ml:SGD-PATE-sub25100-defpa,0,weighted-dpf+,block-composition,poisson,ncd,ml:SGD-PATE,sub25100,nopa,Unlocking,0.4,MLNoisySGDMechanism,{'Optimal': 40},9320337,647144,60780,1151695,0,24435,8168642,647144,36345,3347,3348,3392,550,0,1629,2797,3348,1763,poisson-block-composition
1023,sp_workloads,1690805680,wl_small_mem,1001,ml:SGD-PATE-sub25100-defpa,0,weighted-dpf+,block-composition,poisson,ncd,ml:SGD-PATE,sub25100,nopa,Unlocking,0.4,MLPateGaussianMechanism,{'Optimal': 40},9560711,630849,59490,382845,22240,24885,9177866,608609,34605,3488,3389,3328,178,160,1659,3310,3229,1669,poisson-block-composition
1024,sp_workloads,1690805680,wl_small_mem,1002,ml:SGD-PATE-sub25100-defpa,0,weighted-dpf+,block-composition,upc,ncd,ml:SGD-PATE,sub25100,nopa,Unlocking,0.2,MLNoisySGDMechanism,{'Optimal': 40},9083039,636185,61248,407855,97413,21536,8675184,538772,39712,3347,3348,3392,47,275,1040,3300,3073,2352,upc-block-composition
1025,sp_workloads,1690805680,wl_small_mem,1002,ml:SGD-PATE-sub25100-defpa,0,weighted-dpf+,block-composition,upc,ncd,ml:SGD-PATE,sub25100,nopa,Unlocking,0.2,MLPateGaussianMechanism,{'Optimal': 40},9794725,645631,60352,0,6173,8380,9794725,639458,51972,3488,3389,3328,0,63,548,3488,3326,2780,upc-block-composition
1026,sp_workloads,1690805680,wl_small_mem,1003,ml:SGD-PATE-sub25100-defpa,0,weighted-dpf+,block-composition,upc,ncd,ml:SGD-PATE,sub25100,nopa,Unlocking,0.4,MLNoisySGDMechanism,{'Optimal': 40},9083039,636185,61248,459949,46418,21006,8623090,589767,40242,3347,3348,3392,73,209,978,3274,3139,2414,upc-block-composition
1027,sp_workloads,1690805680,wl_small_mem,1003,ml:SGD-PATE-sub25100-defpa,0,weighted-dpf+,block-composition,upc,ncd,ml:SGD-PATE,sub25100,nopa,Unlocking,0.4,MLPateGaussianMechanism,{'Optimal': 40},9794725,645631,60352,0,9584,7701,9794725,636047,52651,3488,3389,3328,0,111,507,3488,3278,2821,upc-block-composition
1028,sp_workloads,1690805680,wl_small_mem,1004,ml:SGD-PATE-sub25100-defpa,0,weighted-dpf+,block-composition,poisson,equal-ncd,ml:SGD-PATE,sub25100,nopa,Unlocking,0.2,MLNoisySGDMechanism,{'Optimal': 40},3347,3348,3392,113,1454,3392,3234,1894,0,3347,3348,3392,113,1454,3392,3234,1894,0,poisson-block-composition
1029,sp_workloads,1690805680,wl_small_mem,1004,ml:SGD-PATE-sub25100-defpa,0,weighted-dpf+,block-composition,poisson,equal-ncd,ml:SGD-PATE,sub25100,nopa,Unlocking,0.2,MLPateGaussianMechanism,{'Optimal': 40},3488,3389,3328,0,1697,3328,3488,1692,0,3488,3389,3328,0,1697,3328,3488,1692,0,poisson-block-composition
1030,sp_workloads,1690805680,wl_small_mem,1005,ml:SGD-PATE-sub25100-defpa,0,weighted-dpf+,block-composition,poisson,equal-ncd,ml:SGD-PATE,sub25100,nopa,Unlocking,0.4,MLNoisySGDMechanism,{'Optimal': 40},3347,3348,3392,193,1023,3392,3154,2325,0,3347,3348,3392,193,1023,3392,3154,2325,0,poisson-block-composition
1031,sp_workloads,1690805680,wl_small_mem,1005,ml:SGD-PATE-sub25100-defpa,0,weighted-dpf+,block-composition,poisson,equal-ncd,ml:SGD-PATE,sub25100,nopa,Unlocking,0.4,MLPateGaussianMechanism,{'Optimal': 40},3488,3389,3328,0,1697,3187,3488,1692,141,3488,3389,3328,0,1697,3187,3488,1692,141,poisson-block-composition
1032,sp_workloads,1690805680,wl_small_mem,1006,ml:SGD-PATE-sub25100-defpa,0,weighted-dpf+,block-composition,upc,equal-ncd,ml:SGD-PATE,sub25100,nopa,Unlocking,0.2,MLNoisySGDMechanism,{'Optimal': 40},3347,3348,3392,1,820,3392,3346,2528,0,3347,3348,3392,1,820,3392,3346,2528,0,upc-block-composition
1033,sp_workloads,1690805680,wl_small_mem,1006,ml:SGD-PATE-sub25100-defpa,0,weighted-dpf+,block-composition,upc,equal-ncd,ml:SGD-PATE,sub25100,nopa,Unlocking,0.2,MLPateGaussianMechanism,{'Optimal': 40},3488,3389,3328,0,233,3328,3488,3156,0,3488,3389,3328,0,233,3328,3488,3156,0,upc-block-composition
1034,sp_workloads,1690805680,wl_small_mem,1007,ml:SGD-PATE-sub25100-defpa,0,weighted-dpf+,block-composition,upc,equal-ncd,ml:SGD-PATE,sub25100,nopa,Unlocking,0.4,MLNoisySGDMechanism,{'Optimal': 40},3347,3348,3392,3,733,3392,3344,2615,0,3347,3348,3392,3,733,3392,3344,2615,0,upc-block-composition
1035,sp_workloads,1690805680,wl_small_mem,1007,ml:SGD-PATE-sub25100-defpa,0,weighted-dpf+,block-composition,upc,equal-ncd,ml:SGD-PATE,sub25100,nopa,Unlocking,0.4,MLPateGaussianMechanism,{'Optimal': 40},3488,3389,3328,0,315,3327,3488,3074,1,3488,3389,3328,0,315,3327,3488,3074,1,upc-block-composition
1036,sp_workloads,1690805680,wl_small_mem,1008,ml:SGD-PATE-sub25100-defpa,1,weighted-dpf+,block-composition,poisson,ncd,ml:SGD-PATE,sub25100,nopa,Unlocking,0.2,MLNoisySGDMechanism,{'Optimal': 40},9612014,638642,60437,1309842,0,24465,8302172,638642,35972,3436,3336,3371,623,0,1631,2813,3336,1740,poisson-block-composition
1037,sp_workloads,1690805680,wl_small_mem,1008,ml:SGD-PATE-sub25100-defpa,1,weighted-dpf+,block-composition,poisson,ncd,ml:SGD-PATE,sub25100,nopa,Unlocking,0.2,MLPateGaussianMechanism,{'Optimal': 40},9101816,660711,61026,232470,20252,25035,8869346,640459,35991,3337,3307,3358,107,145,1669,3230,3162,1689,poisson-block-composition
1038,sp_workloads,1690805680,wl_small_mem,1009,ml:SGD-PATE-sub25100-defpa,1,weighted-dpf+,block-composition,poisson,ncd,ml:SGD-PATE,sub25100,nopa,Unlocking,0.4,MLNoisySGDMechanism,{'Optimal': 40},9612014,638642,60437,1225834,2876,25546,8386180,635766,34891,3436,3336,3371,583,21,1702,2853,3315,1669,poisson-block-composition
1039,sp_workloads,1690805680,wl_small_mem,1009,ml:SGD-PATE-sub25100-defpa,1,weighted-dpf+,block-composition,poisson,ncd,ml:SGD-PATE,sub25100,nopa,Unlocking,0.4,MLPateGaussianMechanism,{'Optimal': 40},9101816,660711,61026,320107,23331,25035,8781709,637380,35991,3337,3307,3358,148,168,1669,3189,3139,1689,poisson-block-composition
1040,sp_workloads,1690805680,wl_small_mem,1010,ml:SGD-PATE-sub25100-defpa,1,weighted-dpf+,block-composition,upc,ncd,ml:SGD-PATE,sub25100,nopa,Unlocking,0.2,MLNoisySGDMechanism,{'Optimal': 40},9248526,647648,60469,401204,99831,22251,8847322,547817,38218,3436,3336,3371,49,274,1109,3387,3062,2262,upc-block-composition
1041,sp_workloads,1690805680,wl_small_mem,1010,ml:SGD-PATE-sub25100-defpa,1,weighted-dpf+,block-composition,upc,ncd,ml:SGD-PATE,sub25100,nopa,Unlocking,0.2,MLPateGaussianMechanism,{'Optimal': 40},9470335,646016,60114,0,7332,9779,9470335,638684,50335,3337,3307,3358,0,67,637,3337,3240,2721,upc-block-composition
1042,sp_workloads,1690805680,wl_small_mem,1011,ml:SGD-PATE-sub25100-defpa,1,weighted-dpf+,block-composition,upc,ncd,ml:SGD-PATE,sub25100,nopa,Unlocking,0.4,MLNoisySGDMechanism,{'Optimal': 40},9248526,647648,60469,469374,57941,22417,8779152,589707,38052,3436,3336,3371,60,214,1087,3376,3122,2284,upc-block-composition
1043,sp_workloads,1690805680,wl_small_mem,1011,ml:SGD-PATE-sub25100-defpa,1,weighted-dpf+,block-composition,upc,ncd,ml:SGD-PATE,sub25100,nopa,Unlocking,0.4,MLPateGaussianMechanism,{'Optimal': 40},9470335,646016,60114,15,9522,8573,9470320,636494,51541,3337,3307,3358,1,90,563,3336,3217,2795,upc-block-composition
1044,sp_workloads,1690805680,wl_small_mem,1012,ml:SGD-PATE-sub25100-defpa,1,weighted-dpf+,block-composition,poisson,equal-ncd,ml:SGD-PATE,sub25100,nopa,Unlocking,0.2,MLNoisySGDMechanism,{'Optimal': 40},3436,3336,3371,136,1373,3371,3300,1963,0,3436,3336,3371,136,1373,3371,3300,1963,0,poisson-block-composition
1045,sp_workloads,1690805680,wl_small_mem,1012,ml:SGD-PATE-sub25100-defpa,1,weighted-dpf+,block-composition,poisson,equal-ncd,ml:SGD-PATE,sub25100,nopa,Unlocking,0.2,MLPateGaussianMechanism,{'Optimal': 40},3337,3307,3358,0,1606,3358,3337,1701,0,3337,3307,3358,0,1606,3358,3337,1701,0,poisson-block-composition
1046,sp_workloads,1690805680,wl_small_mem,1013,ml:SGD-PATE-sub25100-defpa,1,weighted-dpf+,block-composition,poisson,equal-ncd,ml:SGD-PATE,sub25100,nopa,Unlocking,0.4,MLNoisySGDMechanism,{'Optimal': 40},3436,3336,3371,219,938,3371,3217,2398,0,3436,3336,3371,219,938,3371,3217,2398,0,poisson-block-composition
1047,sp_workloads,1690805680,wl_small_mem,1013,ml:SGD-PATE-sub25100-defpa,1,weighted-dpf+,block-composition,poisson,equal-ncd,ml:SGD-PATE,sub25100,nopa,Unlocking,0.4,MLPateGaussianMechanism,{'Optimal': 40},3337,3307,3358,0,1606,3202,3337,1701,156,3337,3307,3358,0,1606,3202,3337,1701,156,poisson-block-composition
1048,sp_workloads,1690805680,wl_small_mem,1014,ml:SGD-PATE-sub25100-defpa,1,weighted-dpf+,block-composition,upc,equal-ncd,ml:SGD-PATE,sub25100,nopa,Unlocking,0.2,MLNoisySGDMechanism,{'Optimal': 40},3436,3336,3371,0,801,3371,3436,2535,0,3436,3336,3371,0,801,3371,3436,2535,0,upc-block-composition
1049,sp_workloads,1690805680,wl_small_mem,1014,ml:SGD-PATE-sub25100-defpa,1,weighted-dpf+,block-composition,upc,equal-ncd,ml:SGD-PATE,sub25100,nopa,Unlocking,0.2,MLPateGaussianMechanism,{'Optimal': 40},3337,3307,3358,1,225,3358,3336,3082,0,3337,3307,3358,1,225,3358,3336,3082,0,upc-block-composition
1050,sp_workloads,1690805680,wl_small_mem,1015,ml:SGD-PATE-sub25100-defpa,1,weighted-dpf+,block-composition,upc,equal-ncd,ml:SGD-PATE,sub25100,nopa,Unlocking,0.4,MLNoisySGDMechanism,{'Optimal': 40},3436,3336,3371,1,734,3371,3435,2602,0,3436,3336,3371,1,734,3371,3435,2602,0,upc-block-composition
1051,sp_workloads,1690805680,wl_small_mem,1015,ml:SGD-PATE-sub25100-defpa,1,weighted-dpf+,block-composition,upc,equal-ncd,ml:SGD-PATE,sub25100,nopa,Unlocking,0.4,MLPateGaussianMechanism,{'Optimal': 40},3337,3307,3358,1,308,3342,3336,2999,16,3337,3307,3358,1,308,3342,3336,2999,16,upc-block-composition
1052,sp_workloads,1690805680,wl_small_mem,1016,ml:SGD-PATE-sub25100-defpa,2,weighted-dpf+,block-composition,poisson,ncd,ml:SGD-PATE,sub25100,nopa,Unlocking,0.2,MLNoisySGDMechanism,{'Optimal': 40},9102086,650387,61289,1253776,286,22590,7848310,650101,38699,3387,3344,3399,585,2,1506,2802,3342,1893,poisson-block-composition
1053,sp_workloads,1690805680,wl_small_mem,1016,ml:SGD-PATE-sub25100-defpa,2,weighted-dpf+,block-composition,poisson,ncd,ml:SGD-PATE,sub25100,nopa,Unlocking,0.2,MLPateGaussianMechanism,{'Optimal': 40},9667159,651460,60587,310466,17477,25710,9356693,633983,34877,3356,3340,3381,140,123,1714,3216,3217,1667,poisson-block-composition
1054,sp_workloads,1690805680,wl_small_mem,1017,ml:SGD-PATE-sub25100-defpa,2,weighted-dpf+,block-composition,poisson,ncd,ml:SGD-PATE,sub25100,nopa,Unlocking,0.4,MLNoisySGDMechanism,{'Optimal': 40},9102086,650387,61289,1182061,1144,24811,7920025,649243,36478,3387,3344,3399,553,8,1653,2834,3336,1746,poisson-block-composition
1055,sp_workloads,1690805680,wl_small_mem,1017,ml:SGD-PATE-sub25100-defpa,2,weighted-dpf+,block-composition,poisson,ncd,ml:SGD-PATE,sub25100,nopa,Unlocking,0.4,MLPateGaussianMechanism,{'Optimal': 40},9667159,651460,60587,388456,19527,25710,9278703,631933,34877,3356,3340,3381,176,137,1714,3180,3203,1667,poisson-block-composition
1056,sp_workloads,1690805680,wl_small_mem,1018,ml:SGD-PATE-sub25100-defpa,2,weighted-dpf+,block-composition,upc,ncd,ml:SGD-PATE,sub25100,nopa,Unlocking,0.2,MLNoisySGDMechanism,{'Optimal': 40},9360300,635145,61577,406562,95161,23047,8953738,539984,38530,3387,3344,3399,46,246,1129,3341,3098,2270,upc-block-composition
1057,sp_workloads,1690805680,wl_small_mem,1018,ml:SGD-PATE-sub25100-defpa,2,weighted-dpf+,block-composition,upc,ncd,ml:SGD-PATE,sub25100,nopa,Unlocking,0.2,MLPateGaussianMechanism,{'Optimal': 40},9448947,628519,60475,1494,6821,9189,9447453,621698,51286,3356,3340,3381,1,67,603,3355,3273,2778,upc-block-composition
1058,sp_workloads,1690805680,wl_small_mem,1019,ml:SGD-PATE-sub25100-defpa,2,weighted-dpf+,block-composition,upc,ncd,ml:SGD-PATE,sub25100,nopa,Unlocking,0.4,MLNoisySGDMechanism,{'Optimal': 40},9360300,635145,61577,453557,41293,25195,8906743,593852,36382,3387,3344,3399,71,218,1237,3316,3126,2162,upc-block-composition
1059,sp_workloads,1690805680,wl_small_mem,1019,ml:SGD-PATE-sub25100-defpa,2,weighted-dpf+,block-composition,upc,ncd,ml:SGD-PATE,sub25100,nopa,Unlocking,0.4,MLPateGaussianMechanism,{'Optimal': 40},9448947,628519,60475,0,13590,9844,9448947,614929,50631,3356,3340,3381,0,135,652,3356,3205,2729,upc-block-composition
1060,sp_workloads,1690805680,wl_small_mem,1020,ml:SGD-PATE-sub25100-defpa,2,weighted-dpf+,block-composition,poisson,equal-ncd,ml:SGD-PATE,sub25100,nopa,Unlocking,0.2,MLNoisySGDMechanism,{'Optimal': 40},3387,3344,3399,108,1526,3399,3279,1818,0,3387,3344,3399,108,1526,3399,3279,1818,0,poisson-block-composition
1061,sp_workloads,1690805680,wl_small_mem,1020,ml:SGD-PATE-sub25100-defpa,2,weighted-dpf+,block-composition,poisson,equal-ncd,ml:SGD-PATE,sub25100,nopa,Unlocking,0.2,MLPateGaussianMechanism,{'Optimal': 40},3356,3340,3381,0,1706,3381,3356,1634,0,3356,3340,3381,0,1706,3381,3356,1634,0,poisson-block-composition
1062,sp_workloads,1690805680,wl_small_mem,1021,ml:SGD-PATE-sub25100-defpa,2,weighted-dpf+,block-composition,poisson,equal-ncd,ml:SGD-PATE,sub25100,nopa,Unlocking,0.4,MLNoisySGDMechanism,{'Optimal': 40},3387,3344,3399,192,1010,3399,3195,2334,0,3387,3344,3399,192,1010,3399,3195,2334,0,poisson-block-composition
1063,sp_workloads,1690805680,wl_small_mem,1021,ml:SGD-PATE-sub25100-defpa,2,weighted-dpf+,block-composition,poisson,equal-ncd,ml:SGD-PATE,sub25100,nopa,Unlocking,0.4,MLPateGaussianMechanism,{'Optimal': 40},3356,3340,3381,0,1706,3299,3356,1634,82,3356,3340,3381,0,1706,3299,3356,1634,82,poisson-block-composition
1064,sp_workloads,1690805680,wl_small_mem,1022,ml:SGD-PATE-sub25100-defpa,2,weighted-dpf+,block-composition,upc,equal-ncd,ml:SGD-PATE,sub25100,nopa,Unlocking,0.2,MLNoisySGDMechanism,{'Optimal': 40},3387,3344,3399,2,830,3399,3385,2514,0,3387,3344,3399,2,830,3399,3385,2514,0,upc-block-composition
1065,sp_workloads,1690805680,wl_small_mem,1022,ml:SGD-PATE-sub25100-defpa,2,weighted-dpf+,block-composition,upc,equal-ncd,ml:SGD-PATE,sub25100,nopa,Unlocking,0.2,MLPateGaussianMechanism,{'Optimal': 40},3356,3340,3381,1,231,3381,3355,3109,0,3356,3340,3381,1,231,3381,3355,3109,0,upc-block-composition
1066,sp_workloads,1690805680,wl_small_mem,1023,ml:SGD-PATE-sub25100-defpa,2,weighted-dpf+,block-composition,upc,equal-ncd,ml:SGD-PATE,sub25100,nopa,Unlocking,0.4,MLNoisySGDMechanism,{'Optimal': 40},3387,3344,3399,0,755,3399,3387,2589,0,3387,3344,3399,0,755,3399,3387,2589,0,upc-block-composition
1067,sp_workloads,1690805680,wl_small_mem,1023,ml:SGD-PATE-sub25100-defpa,2,weighted-dpf+,block-composition,upc,equal-ncd,ml:SGD-PATE,sub25100,nopa,Unlocking,0.4,MLPateGaussianMechanism,{'Optimal': 40},3356,3340,3381,2,302,3380,3354,3038,1,3356,3340,3381,2,302,3380,3354,3038,1,upc-block-composition
1068,sp_workloads,1690805680,wl_small_mem,1024,ml:SGD-PATE-sub25100-defpa,3,weighted-dpf+,block-composition,poisson,ncd,ml:SGD-PATE,sub25100,nopa,Unlocking,0.2,MLNoisySGDMechanism,{'Optimal': 40},9538338,661542,60462,1207911,564,24902,8330427,660978,35560,3432,3504,3362,571,4,1658,2861,3500,1704,poisson-block-composition
1069,sp_workloads,1690805680,wl_small_mem,1024,ml:SGD-PATE-sub25100-defpa,3,weighted-dpf+,block-composition,poisson,ncd,ml:SGD-PATE,sub25100,nopa,Unlocking,0.2,MLPateGaussianMechanism,{'Optimal': 40},9431567,656376,60193,323950,21571,25035,9107617,634805,35158,3379,3400,3343,148,154,1669,3231,3246,1674,poisson-block-composition
1070,sp_workloads,1690805680,wl_small_mem,1025,ml:SGD-PATE-sub25100-defpa,3,weighted-dpf+,block-composition,poisson,ncd,ml:SGD-PATE,sub25100,nopa,Unlocking,0.4,MLNoisySGDMechanism,{'Optimal': 40},9538338,661542,60462,1136075,282,25591,8402263,661260,34871,3432,3504,3362,537,2,1705,2895,3502,1657,poisson-block-composition
1071,sp_workloads,1690805680,wl_small_mem,1025,ml:SGD-PATE-sub25100-defpa,3,weighted-dpf+,block-composition,poisson,ncd,ml:SGD-PATE,sub25100,nopa,Unlocking,0.4,MLPateGaussianMechanism,{'Optimal': 40},9431567,656376,60193,412946,18282,25035,9018621,638094,35158,3379,3400,3343,190,130,1669,3189,3270,1674,poisson-block-composition
1072,sp_workloads,1690805680,wl_small_mem,1026,ml:SGD-PATE-sub25100-defpa,3,weighted-dpf+,block-composition,upc,ncd,ml:SGD-PATE,sub25100,nopa,Unlocking,0.2,MLNoisySGDMechanism,{'Optimal': 40},9534421,712160,60142,404428,101072,22305,9129993,611088,37837,3432,3504,3362,45,272,1103,3387,3232,2259,upc-block-composition
1073,sp_workloads,1690805680,wl_small_mem,1026,ml:SGD-PATE-sub25100-defpa,3,weighted-dpf+,block-composition,upc,ncd,ml:SGD-PATE,sub25100,nopa,Unlocking,0.2,MLPateGaussianMechanism,{'Optimal': 40},9371673,665112,59809,2143,7846,9491,9369530,657266,50318,3379,3400,3343,1,74,621,3378,3326,2722,upc-block-composition
1074,sp_workloads,1690805680,wl_small_mem,1027,ml:SGD-PATE-sub25100-defpa,3,weighted-dpf+,block-composition,upc,ncd,ml:SGD-PATE,sub25100,nopa,Unlocking,0.4,MLNoisySGDMechanism,{'Optimal': 40},9534421,712160,60142,456053,69050,24138,9078368,643110,36004,3432,3504,3362,53,246,1206,3379,3258,2156,upc-block-composition
1075,sp_workloads,1690805680,wl_small_mem,1027,ml:SGD-PATE-sub25100-defpa,3,weighted-dpf+,block-composition,upc,ncd,ml:SGD-PATE,sub25100,nopa,Unlocking,0.4,MLPateGaussianMechanism,{'Optimal': 40},9371673,665112,59809,1375,8866,10198,9370298,656246,49611,3379,3400,3343,1,78,666,3378,3322,2677,upc-block-composition
1076,sp_workloads,1690805680,wl_small_mem,1028,ml:SGD-PATE-sub25100-defpa,3,weighted-dpf+,block-composition,poisson,equal-ncd,ml:SGD-PATE,sub25100,nopa,Unlocking,0.2,MLNoisySGDMechanism,{'Optimal': 40},3432,3504,3362,115,1499,3362,3317,2005,0,3432,3504,3362,115,1499,3362,3317,2005,0,poisson-block-composition
1077,sp_workloads,1690805680,wl_small_mem,1028,ml:SGD-PATE-sub25100-defpa,3,weighted-dpf+,block-composition,poisson,equal-ncd,ml:SGD-PATE,sub25100,nopa,Unlocking,0.2,MLPateGaussianMechanism,{'Optimal': 40},3379,3400,3343,0,1699,3343,3379,1701,0,3379,3400,3343,0,1699,3343,3379,1701,0,poisson-block-composition
1078,sp_workloads,1690805680,wl_small_mem,1029,ml:SGD-PATE-sub25100-defpa,3,weighted-dpf+,block-composition,poisson,equal-ncd,ml:SGD-PATE,sub25100,nopa,Unlocking,0.4,MLNoisySGDMechanism,{'Optimal': 40},3432,3504,3362,198,1083,3362,3234,2421,0,3432,3504,3362,198,1083,3362,3234,2421,0,poisson-block-composition
1079,sp_workloads,1690805680,wl_small_mem,1029,ml:SGD-PATE-sub25100-defpa,3,weighted-dpf+,block-composition,poisson,equal-ncd,ml:SGD-PATE,sub25100,nopa,Unlocking,0.4,MLPateGaussianMechanism,{'Optimal': 40},3379,3400,3343,0,1699,3164,3379,1701,179,3379,3400,3343,0,1699,3164,3379,1701,179,poisson-block-composition
1080,sp_workloads,1690805680,wl_small_mem,1030,ml:SGD-PATE-sub25100-defpa,3,weighted-dpf+,block-composition,upc,equal-ncd,ml:SGD-PATE,sub25100,nopa,Unlocking,0.2,MLNoisySGDMechanism,{'Optimal': 40},3432,3504,3362,1,856,3362,3431,2648,0,3432,3504,3362,1,856,3362,3431,2648,0,upc-block-composition
1081,sp_workloads,1690805680,wl_small_mem,1030,ml:SGD-PATE-sub25100-defpa,3,weighted-dpf+,block-composition,upc,equal-ncd,ml:SGD-PATE,sub25100,nopa,Unlocking,0.2,MLPateGaussianMechanism,{'Optimal': 40},3379,3400,3343,0,205,3343,3379,3195,0,3379,3400,3343,0,205,3343,3379,3195,0,upc-block-composition
1082,sp_workloads,1690805680,wl_small_mem,1031,ml:SGD-PATE-sub25100-defpa,3,weighted-dpf+,block-composition,upc,equal-ncd,ml:SGD-PATE,sub25100,nopa,Unlocking,0.4,MLNoisySGDMechanism,{'Optimal': 40},3432,3504,3362,1,786,3362,3431,2718,0,3432,3504,3362,1,786,3362,3431,2718,0,upc-block-composition
1083,sp_workloads,1690805680,wl_small_mem,1031,ml:SGD-PATE-sub25100-defpa,3,weighted-dpf+,block-composition,upc,equal-ncd,ml:SGD-PATE,sub25100,nopa,Unlocking,0.4,MLPateGaussianMechanism,{'Optimal': 40},3379,3400,3343,1,276,3332,3378,3124,11,3379,3400,3343,1,276,3332,3378,3124,11,upc-block-composition
1084,sp_workloads,1690805680,wl_small_mem,1032,ml:SGD-PATE-sub25100-defpa,4,weighted-dpf+,block-composition,poisson,ncd,ml:SGD-PATE,sub25100,nopa,Unlocking,0.2,MLNoisySGDMechanism,{'Optimal': 40},9619476,680600,63408,1318335,0,25280,8301141,680600,38128,3443,3381,3350,604,0,1577,2839,3381,1773,poisson-block-composition
1085,sp_workloads,1690805680,wl_small_mem,1032,ml:SGD-PATE-sub25100-defpa,4,weighted-dpf+,block-composition,poisson,ncd,ml:SGD-PATE,sub25100,nopa,Unlocking,0.2,MLPateGaussianMechanism,{'Optimal': 40},9087643,650021,64528,275505,19440,28000,8812138,630581,36528,3245,3345,3408,123,135,1750,3122,3210,1658,poisson-block-composition
1086,sp_workloads,1690805680,wl_small_mem,1033,ml:SGD-PATE-sub25100-defpa,4,weighted-dpf+,block-composition,poisson,ncd,ml:SGD-PATE,sub25100,nopa,Unlocking,0.4,MLNoisySGDMechanism,{'Optimal': 40},9619476,680600,63408,1211885,288,26240,8407591,680312,37168,3443,3381,3350,555,2,1640,2888,3379,1710,poisson-block-composition
1087,sp_workloads,1690805680,wl_small_mem,1033,ml:SGD-PATE-sub25100-defpa,4,weighted-dpf+,block-composition,poisson,ncd,ml:SGD-PATE,sub25100,nopa,Unlocking,0.4,MLPateGaussianMechanism,{'Optimal': 40},9087643,650021,64528,384920,23280,28000,8702723,626741,36528,3245,3345,3408,173,162,1750,3072,3183,1658,poisson-block-composition
1088,sp_workloads,1690805680,wl_small_mem,1034,ml:SGD-PATE-sub25100-defpa,4,weighted-dpf+,block-composition,upc,ncd,ml:SGD-PATE,sub25100,nopa,Unlocking,0.2,MLNoisySGDMechanism,{'Optimal': 40},9753693,680301,63744,417583,96528,23040,9336110,583773,40704,3443,3381,3350,47,245,1068,3396,3136,2282,upc-block-composition
1089,sp_workloads,1690805680,wl_small_mem,1034,ml:SGD-PATE-sub25100-defpa,4,weighted-dpf+,block-composition,upc,ncd,ml:SGD-PATE,sub25100,nopa,Unlocking,0.2,MLPateGaussianMechanism,{'Optimal': 40},8922612,681243,64896,0,7872,9744,8922612,673371,55152,3245,3345,3408,0,72,601,3245,3273,2807,upc-block-composition
1090,sp_workloads,1690805680,wl_small_mem,1035,ml:SGD-PATE-sub25100-defpa,4,weighted-dpf+,block-composition,upc,ncd,ml:SGD-PATE,sub25100,nopa,Unlocking,0.4,MLNoisySGDMechanism,{'Optimal': 40},9753693,680301,63744,478644,46330,23216,9275049,633971,40528,3443,3381,3350,70,222,1071,3373,3159,2279,upc-block-composition
1091,sp_workloads,1690805680,wl_small_mem,1035,ml:SGD-PATE-sub25100-defpa,4,weighted-dpf+,block-composition,upc,ncd,ml:SGD-PATE,sub25100,nopa,Unlocking,0.4,MLPateGaussianMechanism,{'Optimal': 40},8922612,681243,64896,0,8928,9136,8922612,672315,55760,3245,3345,3408,0,87,566,3245,3258,2842,upc-block-composition
1092,sp_workloads,1690805680,wl_small_mem,1036,ml:SGD-PATE-sub25100-defpa,4,weighted-dpf+,block-composition,poisson,equal-ncd,ml:SGD-PATE,sub25100,nopa,Unlocking,0.2,MLNoisySGDMechanism,{'Optimal': 40},3443,3381,3350,125,1435,3350,3318,1946,0,3443,3381,3350,125,1435,3350,3318,1946,0,poisson-block-composition
1093,sp_workloads,1690805680,wl_small_mem,1036,ml:SGD-PATE-sub25100-defpa,4,weighted-dpf+,block-composition,poisson,equal-ncd,ml:SGD-PATE,sub25100,nopa,Unlocking,0.2,MLPateGaussianMechanism,{'Optimal': 40},3245,3345,3408,0,1648,3408,3245,1697,0,3245,3345,3408,0,1648,3408,3245,1697,0,poisson-block-composition
1094,sp_workloads,1690805680,wl_small_mem,1037,ml:SGD-PATE-sub25100-defpa,4,weighted-dpf+,block-composition,poisson,equal-ncd,ml:SGD-PATE,sub25100,nopa,Unlocking,0.4,MLNoisySGDMechanism,{'Optimal': 40},3443,3381,3350,202,1029,3350,3241,2352,0,3443,3381,3350,202,1029,3350,3241,2352,0,poisson-block-composition
1095,sp_workloads,1690805680,wl_small_mem,1037,ml:SGD-PATE-sub25100-defpa,4,weighted-dpf+,block-composition,poisson,equal-ncd,ml:SGD-PATE,sub25100,nopa,Unlocking,0.4,MLPateGaussianMechanism,{'Optimal': 40},3245,3345,3408,0,1648,3267,3245,1697,141,3245,3345,3408,0,1648,3267,3245,1697,141,poisson-block-composition
1096,sp_workloads,1690805680,wl_small_mem,1038,ml:SGD-PATE-sub25100-defpa,4,weighted-dpf+,block-composition,upc,equal-ncd,ml:SGD-PATE,sub25100,nopa,Unlocking,0.2,MLNoisySGDMechanism,{'Optimal': 40},3443,3381,3350,1,832,3350,3442,2549,0,3443,3381,3350,1,832,3350,3442,2549,0,upc-block-composition
1097,sp_workloads,1690805680,wl_small_mem,1038,ml:SGD-PATE-sub25100-defpa,4,weighted-dpf+,block-composition,upc,equal-ncd,ml:SGD-PATE,sub25100,nopa,Unlocking,0.2,MLPateGaussianMechanism,{'Optimal': 40},3245,3345,3408,1,211,3408,3244,3134,0,3245,3345,3408,1,211,3408,3244,3134,0,upc-block-composition
1098,sp_workloads,1690805680,wl_small_mem,1039,ml:SGD-PATE-sub25100-defpa,4,weighted-dpf+,block-composition,upc,equal-ncd,ml:SGD-PATE,sub25100,nopa,Unlocking,0.4,MLNoisySGDMechanism,{'Optimal': 40},3443,3381,3350,2,746,3350,3441,2635,0,3443,3381,3350,2,746,3350,3441,2635,0,upc-block-composition
1099,sp_workloads,1690805680,wl_small_mem,1039,ml:SGD-PATE-sub25100-defpa,4,weighted-dpf+,block-composition,upc,equal-ncd,ml:SGD-PATE,sub25100,nopa,Unlocking,0.4,MLPateGaussianMechanism,{'Optimal': 40},3245,3345,3408,0,317,3408,3245,3028,0,3245,3345,3408,0,317,3408,3245,3028,0,upc-block-composition
1100,sp_workloads,1690805680,wl_small_mem,1040,mixed:GM-LM-RR-LSVT-SGD-PATE-sub25100-defpa,0,weighted-dpf+,block-composition,poisson,ncd,mixed:GM-LM-RR-LSVT-SGD-PATE,sub25100,nopa,Unlocking,0.2,GaussianMechanism,{'Optimal': 40},3326864,216518,19768,0,0,3765,3326864,216518,16003,1098,1121,1112,0,0,251,1098,1121,861,poisson-block-composition
1101,sp_workloads,1690805680,wl_small_mem,1040,mixed:GM-LM-RR-LSVT-SGD-PATE-sub25100-defpa,0,weighted-dpf+,block-composition,poisson,ncd,mixed:GM-LM-RR-LSVT-SGD-PATE,sub25100,nopa,Unlocking,0.2,LaplaceMechanism,{'Optimal': 40},3160262,214484,19740,371457,2945,11625,2788805,211539,8115,1133,1141,1092,176,21,679,957,1120,413,poisson-block-composition
1102,sp_workloads,1690805680,wl_small_mem,1040,mixed:GM-LM-RR-LSVT-SGD-PATE-sub25100-defpa,0,weighted-dpf+,block-composition,poisson,ncd,mixed:GM-LM-RR-LSVT-SGD-PATE,sub25100,nopa,Unlocking,0.2,MLNoisySGDMechanism,{'Optimal': 40},3049683,202901,20644,0,0,0,3049683,202901,20644,1124,1132,1148,0,0,0,1124,1132,1148,poisson-block-composition
1103,sp_workloads,1690805680,wl_small_mem,1040,mixed:GM-LM-RR-LSVT-SGD-PATE-sub25100-defpa,0,weighted-dpf+,block-composition,poisson,ncd,mixed:GM-LM-RR-LSVT-SGD-PATE,sub25100,nopa,Unlocking,0.2,MLPateGaussianMechanism,{'Optimal': 40},3104776,219595,19804,0,0,210,3104776,219595,19594,1159,1162,1108,0,0,14,1159,1162,1094,poisson-block-composition
1104,sp_workloads,1690805680,wl_small_mem,1040,mixed:GM-LM-RR-LSVT-SGD-PATE-sub25100-defpa,0,weighted-dpf+,block-composition,poisson,ncd,mixed:GM-LM-RR-LSVT-SGD-PATE,sub25100,nopa,Unlocking,0.2,RandResponseMechanism,{'Optimal': 40},3027994,204361,19932,48185,0,11943,2979809,204361,7989,1129,1138,1140,19,0,697,1110,1138,443,poisson-block-composition
1105,sp_workloads,1690805680,wl_small_mem,1040,mixed:GM-LM-RR-LSVT-SGD-PATE-sub25100-defpa,0,weighted-dpf+,block-composition,poisson,ncd,mixed:GM-LM-RR-LSVT-SGD-PATE,sub25100,nopa,Unlocking,0.2,SVTLaplaceMechanism,{'Optimal': 40},3254745,215442,20539,21930,0,10075,3232815,215442,10464,1155,1111,1125,10,0,597,1145,1111,528,poisson-block-composition
1106,sp_workloads,1690805680,wl_small_mem,1041,mixed:GM-LM-RR-LSVT-SGD-PATE-sub25100-defpa,0,weighted-dpf+,block-composition,poisson,ncd,mixed:GM-LM-RR-LSVT-SGD-PATE,sub25100,nopa,Unlocking,0.4,GaussianMechanism,{'Optimal': 40},3326864,216518,19768,0,0,3720,3326864,216518,16048,1098,1121,1112,0,0,248,1098,1121,864,poisson-block-composition
1107,sp_workloads,1690805680,wl_small_mem,1041,mixed:GM-LM-RR-LSVT-SGD-PATE-sub25100-defpa,0,weighted-dpf+,block-composition,poisson,ncd,mixed:GM-LM-RR-LSVT-SGD-PATE,sub25100,nopa,Unlocking,0.4,LaplaceMechanism,{'Optimal': 40},3160262,214484,19740,334180,4073,12487,2826082,210411,7253,1133,1141,1092,156,29,697,977,1112,395,poisson-block-composition
1108,sp_workloads,1690805680,wl_small_mem,1041,mixed:GM-LM-RR-LSVT-SGD-PATE-sub25100-defpa,0,weighted-dpf+,block-composition,poisson,ncd,mixed:GM-LM-RR-LSVT-SGD-PATE,sub25100,nopa,Unlocking,0.4,MLNoisySGDMechanism,{'Optimal': 40},3049683,202901,20644,0,0,0,3049683,202901,20644,1124,1132,1148,0,0,0,1124,1132,1148,poisson-block-composition
1109,sp_workloads,1690805680,wl_small_mem,1041,mixed:GM-LM-RR-LSVT-SGD-PATE-sub25100-defpa,0,weighted-dpf+,block-composition,poisson,ncd,mixed:GM-LM-RR-LSVT-SGD-PATE,sub25100,nopa,Unlocking,0.4,MLPateGaussianMechanism,{'Optimal': 40},3104776,219595,19804,0,0,180,3104776,219595,19624,1159,1162,1108,0,0,12,1159,1162,1096,poisson-block-composition
1110,sp_workloads,1690805680,wl_small_mem,1041,mixed:GM-LM-RR-LSVT-SGD-PATE-sub25100-defpa,0,weighted-dpf+,block-composition,poisson,ncd,mixed:GM-LM-RR-LSVT-SGD-PATE,sub25100,nopa,Unlocking,0.4,RandResponseMechanism,{'Optimal': 40},3027994,204361,19932,67857,0,13056,2960137,204361,6876,1129,1138,1140,31,0,736,1098,1138,404,poisson-block-composition
1111,sp_workloads,1690805680,wl_small_mem,1041,mixed:GM-LM-RR-LSVT-SGD-PATE-sub25100-defpa,0,weighted-dpf+,block-composition,poisson,ncd,mixed:GM-LM-RR-LSVT-SGD-PATE,sub25100,nopa,Unlocking,0.4,SVTLaplaceMechanism,{'Optimal': 40},3254745,215442,20539,35088,282,9917,3219657,215160,10622,1155,1111,1125,16,2,579,1139,1109,546,poisson-block-composition
1112,sp_workloads,1690805680,wl_small_mem,1042,mixed:GM-LM-RR-LSVT-SGD-PATE-sub25100-defpa,0,weighted-dpf+,block-composition,upc,ncd,mixed:GM-LM-RR-LSVT-SGD-PATE,sub25100,nopa,Unlocking,0.2,GaussianMechanism,{'Optimal': 40},2981730,214916,19928,0,4233,2535,2981730,210683,17393,1098,1121,1112,0,55,169,1098,1066,943,upc-block-composition
1113,sp_workloads,1690805680,wl_small_mem,1042,mixed:GM-LM-RR-LSVT-SGD-PATE-sub25100-defpa,0,weighted-dpf+,block-composition,upc,ncd,mixed:GM-LM-RR-LSVT-SGD-PATE,sub25100,nopa,Unlocking,0.2,LaplaceMechanism,{'Optimal': 40},3131295,232349,19708,61256,2421,8355,3070039,229928,11353,1133,1141,1092,16,27,461,1117,1114,631,upc-block-composition
1114,sp_workloads,1690805680,wl_small_mem,1042,mixed:GM-LM-RR-LSVT-SGD-PATE-sub25100-defpa,0,weighted-dpf+,block-composition,upc,ncd,mixed:GM-LM-RR-LSVT-SGD-PATE,sub25100,nopa,Unlocking,0.2,MLNoisySGDMechanism,{'Optimal': 40},3118726,223010,20660,0,3310,1740,3118726,219700,18920,1124,1132,1148,0,34,116,1124,1098,1032,upc-block-composition
1115,sp_workloads,1690805680,wl_small_mem,1042,mixed:GM-LM-RR-LSVT-SGD-PATE-sub25100-defpa,0,weighted-dpf+,block-composition,upc,ncd,mixed:GM-LM-RR-LSVT-SGD-PATE,sub25100,nopa,Unlocking,0.2,MLPateGaussianMechanism,{'Optimal': 40},3293821,219087,19708,0,3685,2175,3293821,215402,17533,1159,1162,1108,0,43,145,1159,1119,963,upc-block-composition
1116,sp_workloads,1690805680,wl_small_mem,1042,mixed:GM-LM-RR-LSVT-SGD-PATE-sub25100-defpa,0,weighted-dpf+,block-composition,upc,ncd,mixed:GM-LM-RR-LSVT-SGD-PATE,sub25100,nopa,Unlocking,0.2,RandResponseMechanism,{'Optimal': 40},3089004,211671,20540,41052,2627,7938,3047952,209044,12602,1129,1138,1140,18,29,462,1111,1109,678,upc-block-composition
1117,sp_workloads,1690805680,wl_small_mem,1042,mixed:GM-LM-RR-LSVT-SGD-PATE-sub25100-defpa,0,weighted-dpf+,block-composition,upc,ncd,mixed:GM-LM-RR-LSVT-SGD-PATE,sub25100,nopa,Unlocking,0.2,SVTLaplaceMechanism,{'Optimal': 40},3249651,226516,20283,30752,2028,5333,3218899,224488,14950,1155,1111,1125,15,20,347,1140,1091,778,upc-block-composition
1118,sp_workloads,1690805680,wl_small_mem,1043,mixed:GM-LM-RR-LSVT-SGD-PATE-sub25100-defpa,0,weighted-dpf+,block-composition,upc,ncd,mixed:GM-LM-RR-LSVT-SGD-PATE,sub25100,nopa,Unlocking,0.4,GaussianMechanism,{'Optimal': 40},2981730,214916,19928,0,5476,4954,2981730,209440,14974,1098,1121,1112,0,60,326,1098,1061,786,upc-block-composition
1119,sp_workloads,1690805680,wl_small_mem,1043,mixed:GM-LM-RR-LSVT-SGD-PATE-sub25100-defpa,0,weighted-dpf+,block-composition,upc,ncd,mixed:GM-LM-RR-LSVT-SGD-PATE,sub25100,nopa,Unlocking,0.4,LaplaceMechanism,{'Optimal': 40},3131295,232349,19708,25143,6662,14857,3106152,225687,4851,1133,1141,1092,9,54,807,1124,1087,285,upc-block-composition
1120,sp_workloads,1690805680,wl_small_mem,1043,mixed:GM-LM-RR-LSVT-SGD-PATE-sub25100-defpa,0,weighted-dpf+,block-composition,upc,ncd,mixed:GM-LM-RR-LSVT-SGD-PATE,sub25100,nopa,Unlocking,0.4,MLNoisySGDMechanism,{'Optimal': 40},3118726,223010,20660,62,4553,3825,3118664,218457,16835,1124,1132,1148,2,55,255,1122,1077,893,upc-block-composition
1121,sp_workloads,1690805680,wl_small_mem,1043,mixed:GM-LM-RR-LSVT-SGD-PATE-sub25100-defpa,0,weighted-dpf+,block-composition,upc,ncd,mixed:GM-LM-RR-LSVT-SGD-PATE,sub25100,nopa,Unlocking,0.4,MLPateGaussianMechanism,{'Optimal': 40},3293821,219087,19708,3331,6736,4785,3290490,212351,14923,1159,1162,1108,3,80,319,1156,1082,789,upc-block-composition
1122,sp_workloads,1690805680,wl_small_mem,1043,mixed:GM-LM-RR-LSVT-SGD-PATE-sub25100-defpa,0,weighted-dpf+,block-composition,upc,ncd,mixed:GM-LM-RR-LSVT-SGD-PATE,sub25100,nopa,Unlocking,0.4,RandResponseMechanism,{'Optimal': 40},3089004,211671,20540,30546,3422,14837,3058458,208249,5703,1129,1138,1140,12,34,795,1117,1104,345,upc-block-composition
1123,sp_workloads,1690805680,wl_small_mem,1043,mixed:GM-LM-RR-LSVT-SGD-PATE-sub25100-defpa,0,weighted-dpf+,block-composition,upc,ncd,mixed:GM-LM-RR-LSVT-SGD-PATE,sub25100,nopa,Unlocking,0.4,SVTLaplaceMechanism,{'Optimal': 40},3249651,226516,20283,21284,4755,12320,3228367,221761,7963,1155,1111,1125,7,43,656,1148,1068,469,upc-block-composition
1124,sp_workloads,1690805680,wl_small_mem,1044,mixed:GM-LM-RR-LSVT-SGD-PATE-sub25100-defpa,0,weighted-dpf+,block-composition,poisson,equal-ncd,mixed:GM-LM-RR-LSVT-SGD-PATE,sub25100,nopa,Unlocking,0.2,GaussianMechanism,{'Optimal': 40},1098,1121,1112,0,0,599,1098,1121,513,1098,1121,1112,0,0,599,1098,1121,513,poisson-block-composition
1125,sp_workloads,1690805680,wl_small_mem,1044,mixed:GM-LM-RR-LSVT-SGD-PATE-sub25100-defpa,0,weighted-dpf+,block-composition,poisson,equal-ncd,mixed:GM-LM-RR-LSVT-SGD-PATE,sub25100,nopa,Unlocking,0.2,LaplaceMechanism,{'Optimal': 40},1133,1141,1092,0,583,1092,1133,558,0,1133,1141,1092,0,583,1092,1133,558,0,poisson-block-composition
1126,sp_workloads,1690805680,wl_small_mem,1044,mixed:GM-LM-RR-LSVT-SGD-PATE-sub25100-defpa,0,weighted-dpf+,block-composition,poisson,equal-ncd,mixed:GM-LM-RR-LSVT-SGD-PATE,sub25100,nopa,Unlocking,0.2,MLNoisySGDMechanism,{'Optimal': 40},1124,1132,1148,0,0,112,1124,1132,1036,1124,1132,1148,0,0,112,1124,1132,1036,poisson-block-composition
1127,sp_workloads,1690805680,wl_small_mem,1044,mixed:GM-LM-RR-LSVT-SGD-PATE-sub25100-defpa,0,weighted-dpf+,block-composition,poisson,equal-ncd,mixed:GM-LM-RR-LSVT-SGD-PATE,sub25100,nopa,Unlocking,0.2,MLPateGaussianMechanism,{'Optimal': 40},1159,1162,1108,0,5,427,1159,1157,681,1159,1162,1108,0,5,427,1159,1157,681,poisson-block-composition
1128,sp_workloads,1690805680,wl_small_mem,1044,mixed:GM-LM-RR-LSVT-SGD-PATE-sub25100-defpa,0,weighted-dpf+,block-composition,poisson,equal-ncd,mixed:GM-LM-RR-LSVT-SGD-PATE,sub25100,nopa,Unlocking,0.2,RandResponseMechanism,{'Optimal': 40},1129,1138,1140,0,19,1140,1129,1119,0,1129,1138,1140,0,19,1140,1129,1119,0,poisson-block-composition
1129,sp_workloads,1690805680,wl_small_mem,1044,mixed:GM-LM-RR-LSVT-SGD-PATE-sub25100-defpa,0,weighted-dpf+,block-composition,poisson,equal-ncd,mixed:GM-LM-RR-LSVT-SGD-PATE,sub25100,nopa,Unlocking,0.2,SVTLaplaceMechanism,{'Optimal': 40},1155,1111,1125,0,281,1125,1155,830,0,1155,1111,1125,0,281,1125,1155,830,0,poisson-block-composition
1130,sp_workloads,1690805680,wl_small_mem,1045,mixed:GM-LM-RR-LSVT-SGD-PATE-sub25100-defpa,0,weighted-dpf+,block-composition,poisson,equal-ncd,mixed:GM-LM-RR-LSVT-SGD-PATE,sub25100,nopa,Unlocking,0.4,GaussianMechanism,{'Optimal': 40},1098,1121,1112,0,0,594,1098,1121,518,1098,1121,1112,0,0,594,1098,1121,518,poisson-block-composition
1131,sp_workloads,1690805680,wl_small_mem,1045,mixed:GM-LM-RR-LSVT-SGD-PATE-sub25100-defpa,0,weighted-dpf+,block-composition,poisson,equal-ncd,mixed:GM-LM-RR-LSVT-SGD-PATE,sub25100,nopa,Unlocking,0.4,LaplaceMechanism,{'Optimal': 40},1133,1141,1092,0,512,1092,1133,629,0,1133,1141,1092,0,512,1092,1133,629,0,poisson-block-composition
1132,sp_workloads,1690805680,wl_small_mem,1045,mixed:GM-LM-RR-LSVT-SGD-PATE-sub25100-defpa,0,weighted-dpf+,block-composition,poisson,equal-ncd,mixed:GM-LM-RR-LSVT-SGD-PATE,sub25100,nopa,Unlocking,0.4,MLNoisySGDMechanism,{'Optimal': 40},1124,1132,1148,0,0,154,1124,1132,994,1124,1132,1148,0,0,154,1124,1132,994,poisson-block-composition
1133,sp_workloads,1690805680,wl_small_mem,1045,mixed:GM-LM-RR-LSVT-SGD-PATE-sub25100-defpa,0,weighted-dpf+,block-composition,poisson,equal-ncd,mixed:GM-LM-RR-LSVT-SGD-PATE,sub25100,nopa,Unlocking,0.4,MLPateGaussianMechanism,{'Optimal': 40},1159,1162,1108,0,2,519,1159,1160,589,1159,1162,1108,0,2,519,1159,1160,589,poisson-block-composition
1134,sp_workloads,1690805680,wl_small_mem,1045,mixed:GM-LM-RR-LSVT-SGD-PATE-sub25100-defpa,0,weighted-dpf+,block-composition,poisson,equal-ncd,mixed:GM-LM-RR-LSVT-SGD-PATE,sub25100,nopa,Unlocking,0.4,RandResponseMechanism,{'Optimal': 40},1129,1138,1140,0,63,1140,1129,1075,0,1129,1138,1140,0,63,1140,1129,1075,0,poisson-block-composition
1135,sp_workloads,1690805680,wl_small_mem,1045,mixed:GM-LM-RR-LSVT-SGD-PATE-sub25100-defpa,0,weighted-dpf+,block-composition,poisson,equal-ncd,mixed:GM-LM-RR-LSVT-SGD-PATE,sub25100,nopa,Unlocking,0.4,SVTLaplaceMechanism,{'Optimal': 40},1155,1111,1125,0,302,1125,1155,809,0,1155,1111,1125,0,302,1125,1155,809,0,poisson-block-composition
1136,sp_workloads,1690805680,wl_small_mem,1046,mixed:GM-LM-RR-LSVT-SGD-PATE-sub25100-defpa,0,weighted-dpf+,block-composition,upc,equal-ncd,mixed:GM-LM-RR-LSVT-SGD-PATE,sub25100,nopa,Unlocking,0.2,GaussianMechanism,{'Optimal': 40},1098,1121,1112,0,55,762,1098,1066,350,1098,1121,1112,0,55,762,1098,1066,350,upc-block-composition
1137,sp_workloads,1690805680,wl_small_mem,1046,mixed:GM-LM-RR-LSVT-SGD-PATE-sub25100-defpa,0,weighted-dpf+,block-composition,upc,equal-ncd,mixed:GM-LM-RR-LSVT-SGD-PATE,sub25100,nopa,Unlocking,0.2,LaplaceMechanism,{'Optimal': 40},1133,1141,1092,0,81,1035,1133,1060,57,1133,1141,1092,0,81,1035,1133,1060,57,upc-block-composition
1138,sp_workloads,1690805680,wl_small_mem,1046,mixed:GM-LM-RR-LSVT-SGD-PATE-sub25100-defpa,0,weighted-dpf+,block-composition,upc,equal-ncd,mixed:GM-LM-RR-LSVT-SGD-PATE,sub25100,nopa,Unlocking,0.2,MLNoisySGDMechanism,{'Optimal': 40},1124,1132,1148,0,56,311,1124,1076,837,1124,1132,1148,0,56,311,1124,1076,837,upc-block-composition
1139,sp_workloads,1690805680,wl_small_mem,1046,mixed:GM-LM-RR-LSVT-SGD-PATE-sub25100-defpa,0,weighted-dpf+,block-composition,upc,equal-ncd,mixed:GM-LM-RR-LSVT-SGD-PATE,sub25100,nopa,Unlocking,0.2,MLPateGaussianMechanism,{'Optimal': 40},1159,1162,1108,0,138,461,1159,1024,647,1159,1162,1108,0,138,461,1159,1024,647,upc-block-composition
1140,sp_workloads,1690805680,wl_small_mem,1046,mixed:GM-LM-RR-LSVT-SGD-PATE-sub25100-defpa,0,weighted-dpf+,block-composition,upc,equal-ncd,mixed:GM-LM-RR-LSVT-SGD-PATE,sub25100,nopa,Unlocking,0.2,RandResponseMechanism,{'Optimal': 40},1129,1138,1140,0,63,1020,1129,1075,120,1129,1138,1140,0,63,1020,1129,1075,120,upc-block-composition
1141,sp_workloads,1690805680,wl_small_mem,1046,mixed:GM-LM-RR-LSVT-SGD-PATE-sub25100-defpa,0,weighted-dpf+,block-composition,upc,equal-ncd,mixed:GM-LM-RR-LSVT-SGD-PATE,sub25100,nopa,Unlocking,0.2,SVTLaplaceMechanism,{'Optimal': 40},1155,1111,1125,0,67,992,1155,1044,133,1155,1111,1125,0,67,992,1155,1044,133,upc-block-composition
1142,sp_workloads,1690805680,wl_small_mem,1047,mixed:GM-LM-RR-LSVT-SGD-PATE-sub25100-defpa,0,weighted-dpf+,block-composition,upc,equal-ncd,mixed:GM-LM-RR-LSVT-SGD-PATE,sub25100,nopa,Unlocking,0.4,GaussianMechanism,{'Optimal': 40},1098,1121,1112,0,105,481,1098,1016,631,1098,1121,1112,0,105,481,1098,1016,631,upc-block-composition
1143,sp_workloads,1690805680,wl_small_mem,1047,mixed:GM-LM-RR-LSVT-SGD-PATE-sub25100-defpa,0,weighted-dpf+,block-composition,upc,equal-ncd,mixed:GM-LM-RR-LSVT-SGD-PATE,sub25100,nopa,Unlocking,0.4,LaplaceMechanism,{'Optimal': 40},1133,1141,1092,0,99,1048,1133,1042,44,1133,1141,1092,0,99,1048,1133,1042,44,upc-block-composition
1144,sp_workloads,1690805680,wl_small_mem,1047,mixed:GM-LM-RR-LSVT-SGD-PATE-sub25100-defpa,0,weighted-dpf+,block-composition,upc,equal-ncd,mixed:GM-LM-RR-LSVT-SGD-PATE,sub25100,nopa,Unlocking,0.4,MLNoisySGDMechanism,{'Optimal': 40},1124,1132,1148,0,61,275,1124,1071,873,1124,1132,1148,0,61,275,1124,1071,873,upc-block-composition
1145,sp_workloads,1690805680,wl_small_mem,1047,mixed:GM-LM-RR-LSVT-SGD-PATE-sub25100-defpa,0,weighted-dpf+,block-composition,upc,equal-ncd,mixed:GM-LM-RR-LSVT-SGD-PATE,sub25100,nopa,Unlocking,0.4,MLPateGaussianMechanism,{'Optimal': 40},1159,1162,1108,0,152,334,1159,1010,774,1159,1162,1108,0,152,334,1159,1010,774,upc-block-composition
1146,sp_workloads,1690805680,wl_small_mem,1047,mixed:GM-LM-RR-LSVT-SGD-PATE-sub25100-defpa,0,weighted-dpf+,block-composition,upc,equal-ncd,mixed:GM-LM-RR-LSVT-SGD-PATE,sub25100,nopa,Unlocking,0.4,RandResponseMechanism,{'Optimal': 40},1129,1138,1140,0,73,1070,1129,1065,70,1129,1138,1140,0,73,1070,1129,1065,70,upc-block-composition
1147,sp_workloads,1690805680,wl_small_mem,1047,mixed:GM-LM-RR-LSVT-SGD-PATE-sub25100-defpa,0,weighted-dpf+,block-composition,upc,equal-ncd,mixed:GM-LM-RR-LSVT-SGD-PATE,sub25100,nopa,Unlocking,0.4,SVTLaplaceMechanism,{'Optimal': 40},1155,1111,1125,0,61,1017,1155,1050,108,1155,1111,1125,0,61,1017,1155,1050,108,upc-block-composition
1148,sp_workloads,1690805680,wl_small_mem,1048,mixed:GM-LM-RR-LSVT-SGD-PATE-sub25100-defpa,1,weighted-dpf+,block-composition,poisson,ncd,mixed:GM-LM-RR-LSVT-SGD-PATE,sub25100,nopa,Unlocking,0.2,GaussianMechanism,{'Optimal': 40},3139319,215782,21216,0,0,4160,3139319,215782,17056,1075,1140,1126,0,0,260,1075,1140,866,poisson-block-composition
1149,sp_workloads,1690805680,wl_small_mem,1048,mixed:GM-LM-RR-LSVT-SGD-PATE-sub25100-defpa,1,weighted-dpf+,block-composition,poisson,ncd,mixed:GM-LM-RR-LSVT-SGD-PATE,sub25100,nopa,Unlocking,0.2,LaplaceMechanism,{'Optimal': 40},3080200,239601,21344,381964,3326,13520,2698236,236275,7824,1140,1163,1130,174,23,726,966,1140,404,poisson-block-composition
1150,sp_workloads,1690805680,wl_small_mem,1048,mixed:GM-LM-RR-LSVT-SGD-PATE-sub25100-defpa,1,weighted-dpf+,block-composition,poisson,ncd,mixed:GM-LM-RR-LSVT-SGD-PATE,sub25100,nopa,Unlocking,0.2,MLNoisySGDMechanism,{'Optimal': 40},3197047,217314,22128,0,0,0,3197047,217314,22128,1145,1089,1161,0,0,0,1145,1089,1161,poisson-block-composition
1151,sp_workloads,1690805680,wl_small_mem,1048,mixed:GM-LM-RR-LSVT-SGD-PATE-sub25100-defpa,1,weighted-dpf+,block-composition,poisson,ncd,mixed:GM-LM-RR-LSVT-SGD-PATE,sub25100,nopa,Unlocking,0.2,MLPateGaussianMechanism,{'Optimal': 40},3203621,231498,21632,0,0,224,3203621,231498,21408,1163,1144,1138,0,0,14,1163,1144,1124,poisson-block-composition
1152,sp_workloads,1690805680,wl_small_mem,1048,mixed:GM-LM-RR-LSVT-SGD-PATE-sub25100-defpa,1,weighted-dpf+,block-composition,poisson,ncd,mixed:GM-LM-RR-LSVT-SGD-PATE,sub25100,nopa,Unlocking,0.2,RandResponseMechanism,{'Optimal': 40},3122577,243521,22560,34197,0,12000,3088380,243521,10560,1093,1164,1181,15,0,651,1078,1164,530,poisson-block-composition
1153,sp_workloads,1690805680,wl_small_mem,1048,mixed:GM-LM-RR-LSVT-SGD-PATE-sub25100-defpa,1,weighted-dpf+,block-composition,poisson,ncd,mixed:GM-LM-RR-LSVT-SGD-PATE,sub25100,nopa,Unlocking,0.2,SVTLaplaceMechanism,{'Optimal': 40},3189411,227364,20784,40978,584,10928,3148433,226780,9856,1178,1127,1089,18,4,613,1160,1123,476,poisson-block-composition
1154,sp_workloads,1690805680,wl_small_mem,1049,mixed:GM-LM-RR-LSVT-SGD-PATE-sub25100-defpa,1,weighted-dpf+,block-composition,poisson,ncd,mixed:GM-LM-RR-LSVT-SGD-PATE,sub25100,nopa,Unlocking,0.4,GaussianMechanism,{'Optimal': 40},3139319,215782,21216,0,0,4944,3139319,215782,16272,1075,1140,1126,0,0,309,1075,1140,817,poisson-block-composition
1155,sp_workloads,1690805680,wl_small_mem,1049,mixed:GM-LM-RR-LSVT-SGD-PATE-sub25100-defpa,1,weighted-dpf+,block-composition,poisson,ncd,mixed:GM-LM-RR-LSVT-SGD-PATE,sub25100,nopa,Unlocking,0.4,LaplaceMechanism,{'Optimal': 40},3080200,239601,21344,335955,3764,14032,2744245,235837,7312,1140,1163,1130,152,26,732,988,1137,398,poisson-block-composition
1156,sp_workloads,1690805680,wl_small_mem,1049,mixed:GM-LM-RR-LSVT-SGD-PATE-sub25100-defpa,1,weighted-dpf+,block-composition,poisson,ncd,mixed:GM-LM-RR-LSVT-SGD-PATE,sub25100,nopa,Unlocking,0.4,MLNoisySGDMechanism,{'Optimal': 40},3197047,217314,22128,0,0,0,3197047,217314,22128,1145,1089,1161,0,0,0,1145,1089,1161,poisson-block-composition
1157,sp_workloads,1690805680,wl_small_mem,1049,mixed:GM-LM-RR-LSVT-SGD-PATE-sub25100-defpa,1,weighted-dpf+,block-composition,poisson,ncd,mixed:GM-LM-RR-LSVT-SGD-PATE,sub25100,nopa,Unlocking,0.4,MLPateGaussianMechanism,{'Optimal': 40},3203621,231498,21632,0,0,176,3203621,231498,21456,1163,1144,1138,0,0,11,1163,1144,1127,poisson-block-composition
1158,sp_workloads,1690805680,wl_small_mem,1049,mixed:GM-LM-RR-LSVT-SGD-PATE-sub25100-defpa,1,weighted-dpf+,block-composition,poisson,ncd,mixed:GM-LM-RR-LSVT-SGD-PATE,sub25100,nopa,Unlocking,0.4,RandResponseMechanism,{'Optimal': 40},3122577,243521,22560,41076,0,13760,3081501,243521,8800,1093,1164,1181,15,0,709,1078,1164,472,poisson-block-composition
1159,sp_workloads,1690805680,wl_small_mem,1049,mixed:GM-LM-RR-LSVT-SGD-PATE-sub25100-defpa,1,weighted-dpf+,block-composition,poisson,ncd,mixed:GM-LM-RR-LSVT-SGD-PATE,sub25100,nopa,Unlocking,0.4,SVTLaplaceMechanism,{'Optimal': 40},3189411,227364,20784,66031,876,11408,3123380,226488,9376,1178,1127,1089,29,6,622,1149,1121,467,poisson-block-composition
1160,sp_workloads,1690805680,wl_small_mem,1050,mixed:GM-LM-RR-LSVT-SGD-PATE-sub25100-defpa,1,weighted-dpf+,block-composition,upc,ncd,mixed:GM-LM-RR-LSVT-SGD-PATE,sub25100,nopa,Unlocking,0.2,GaussianMechanism,{'Optimal': 40},3132487,230731,21232,0,3654,2704,3132487,227077,18528,1075,1140,1126,0,46,169,1075,1094,957,upc-block-composition
1161,sp_workloads,1690805680,wl_small_mem,1050,mixed:GM-LM-RR-LSVT-SGD-PATE-sub25100-defpa,1,weighted-dpf+,block-composition,upc,ncd,mixed:GM-LM-RR-LSVT-SGD-PATE,sub25100,nopa,Unlocking,0.2,LaplaceMechanism,{'Optimal': 40},3099847,241488,21408,52922,3511,8912,3046925,237977,12496,1140,1163,1130,15,39,476,1125,1124,654,upc-block-composition
1162,sp_workloads,1690805680,wl_small_mem,1050,mixed:GM-LM-RR-LSVT-SGD-PATE-sub25100-defpa,1,weighted-dpf+,block-composition,upc,ncd,mixed:GM-LM-RR-LSVT-SGD-PATE,sub25100,nopa,Unlocking,0.2,MLNoisySGDMechanism,{'Optimal': 40},3154870,213434,22336,0,3591,1840,3154870,209843,20496,1145,1089,1161,0,41,115,1145,1048,1046,upc-block-composition
1163,sp_workloads,1690805680,wl_small_mem,1050,mixed:GM-LM-RR-LSVT-SGD-PATE-sub25100-defpa,1,weighted-dpf+,block-composition,upc,ncd,mixed:GM-LM-RR-LSVT-SGD-PATE,sub25100,nopa,Unlocking,0.2,MLPateGaussianMechanism,{'Optimal': 40},3325335,225275,21360,0,5283,2256,3325335,219992,19104,1163,1144,1138,0,61,141,1163,1083,997,upc-block-composition
1164,sp_workloads,1690805680,wl_small_mem,1050,mixed:GM-LM-RR-LSVT-SGD-PATE-sub25100-defpa,1,weighted-dpf+,block-composition,upc,ncd,mixed:GM-LM-RR-LSVT-SGD-PATE,sub25100,nopa,Unlocking,0.2,RandResponseMechanism,{'Optimal': 40},2890868,228789,22304,39446,2946,8544,2851422,225843,13760,1093,1164,1181,15,29,458,1078,1135,723,upc-block-composition
1165,sp_workloads,1690805680,wl_small_mem,1050,mixed:GM-LM-RR-LSVT-SGD-PATE-sub25100-defpa,1,weighted-dpf+,block-composition,upc,ncd,mixed:GM-LM-RR-LSVT-SGD-PATE,sub25100,nopa,Unlocking,0.2,SVTLaplaceMechanism,{'Optimal': 40},3335945,229922,20624,33624,3350,5904,3302321,226572,14720,1178,1127,1089,14,32,355,1164,1095,734,upc-block-composition
1166,sp_workloads,1690805680,wl_small_mem,1051,mixed:GM-LM-RR-LSVT-SGD-PATE-sub25100-defpa,1,weighted-dpf+,block-composition,upc,ncd,mixed:GM-LM-RR-LSVT-SGD-PATE,sub25100,nopa,Unlocking,0.4,GaussianMechanism,{'Optimal': 40},3132487,230731,21232,0,6244,5840,3132487,224487,15392,1075,1140,1126,0,72,363,1075,1068,763,upc-block-composition
1167,sp_workloads,1690805680,wl_small_mem,1051,mixed:GM-LM-RR-LSVT-SGD-PATE-sub25100-defpa,1,weighted-dpf+,block-composition,upc,ncd,mixed:GM-LM-RR-LSVT-SGD-PATE,sub25100,nopa,Unlocking,0.4,LaplaceMechanism,{'Optimal': 40},3099847,241488,21408,53812,5107,15968,3046035,236381,5440,1140,1163,1130,16,42,816,1124,1121,314,upc-block-composition
1168,sp_workloads,1690805680,wl_small_mem,1051,mixed:GM-LM-RR-LSVT-SGD-PATE-sub25100-defpa,1,weighted-dpf+,block-composition,upc,ncd,mixed:GM-LM-RR-LSVT-SGD-PATE,sub25100,nopa,Unlocking,0.4,MLNoisySGDMechanism,{'Optimal': 40},3154870,213434,22336,7099,2961,4496,3147771,210473,17840,1145,1089,1161,5,40,281,1140,1049,880,upc-block-composition
1169,sp_workloads,1690805680,wl_small_mem,1051,mixed:GM-LM-RR-LSVT-SGD-PATE-sub25100-defpa,1,weighted-dpf+,block-composition,upc,ncd,mixed:GM-LM-RR-LSVT-SGD-PATE,sub25100,nopa,Unlocking,0.4,MLPateGaussianMechanism,{'Optimal': 40},3325335,225275,21360,1925,7377,5344,3323410,217898,16016,1163,1144,1138,1,76,334,1162,1068,804,upc-block-composition
1170,sp_workloads,1690805680,wl_small_mem,1051,mixed:GM-LM-RR-LSVT-SGD-PATE-sub25100-defpa,1,weighted-dpf+,block-composition,upc,ncd,mixed:GM-LM-RR-LSVT-SGD-PATE,sub25100,nopa,Unlocking,0.4,RandResponseMechanism,{'Optimal': 40},2890868,228789,22304,20331,4157,13872,2870537,224632,8432,1093,1164,1181,7,32,726,1086,1132,455,upc-block-composition
1171,sp_workloads,1690805680,wl_small_mem,1051,mixed:GM-LM-RR-LSVT-SGD-PATE-sub25100-defpa,1,weighted-dpf+,block-composition,upc,ncd,mixed:GM-LM-RR-LSVT-SGD-PATE,sub25100,nopa,Unlocking,0.4,SVTLaplaceMechanism,{'Optimal': 40},3335945,229922,20624,19976,4494,11664,3315969,225428,8960,1178,1127,1089,6,45,610,1172,1082,479,upc-block-composition
1172,sp_workloads,1690805680,wl_small_mem,1052,mixed:GM-LM-RR-LSVT-SGD-PATE-sub25100-defpa,1,weighted-dpf+,block-composition,poisson,equal-ncd,mixed:GM-LM-RR-LSVT-SGD-PATE,sub25100,nopa,Unlocking,0.2,GaussianMechanism,{'Optimal': 40},1075,1140,1126,0,0,690,1075,1140,436,1075,1140,1126,0,0,690,1075,1140,436,poisson-block-composition
1173,sp_workloads,1690805680,wl_small_mem,1052,mixed:GM-LM-RR-LSVT-SGD-PATE-sub25100-defpa,1,weighted-dpf+,block-composition,poisson,equal-ncd,mixed:GM-LM-RR-LSVT-SGD-PATE,sub25100,nopa,Unlocking,0.2,LaplaceMechanism,{'Optimal': 40},1140,1163,1130,0,560,1130,1140,603,0,1140,1163,1130,0,560,1130,1140,603,0,poisson-block-composition
1174,sp_workloads,1690805680,wl_small_mem,1052,mixed:GM-LM-RR-LSVT-SGD-PATE-sub25100-defpa,1,weighted-dpf+,block-composition,poisson,equal-ncd,mixed:GM-LM-RR-LSVT-SGD-PATE,sub25100,nopa,Unlocking,0.2,MLNoisySGDMechanism,{'Optimal': 40},1145,1089,1161,0,0,141,1145,1089,1020,1145,1089,1161,0,0,141,1145,1089,1020,poisson-block-composition
1175,sp_workloads,1690805680,wl_small_mem,1052,mixed:GM-LM-RR-LSVT-SGD-PATE-sub25100-defpa,1,weighted-dpf+,block-composition,poisson,equal-ncd,mixed:GM-LM-RR-LSVT-SGD-PATE,sub25100,nopa,Unlocking,0.2,MLPateGaussianMechanism,{'Optimal': 40},1163,1144,1138,0,2,531,1163,1142,607,1163,1144,1138,0,2,531,1163,1142,607,poisson-block-composition
1176,sp_workloads,1690805680,wl_small_mem,1052,mixed:GM-LM-RR-LSVT-SGD-PATE-sub25100-defpa,1,weighted-dpf+,block-composition,poisson,equal-ncd,mixed:GM-LM-RR-LSVT-SGD-PATE,sub25100,nopa,Unlocking,0.2,RandResponseMechanism,{'Optimal': 40},1093,1164,1181,0,15,1181,1093,1149,0,1093,1164,1181,0,15,1181,1093,1149,0,poisson-block-composition
1177,sp_workloads,1690805680,wl_small_mem,1052,mixed:GM-LM-RR-LSVT-SGD-PATE-sub25100-defpa,1,weighted-dpf+,block-composition,poisson,equal-ncd,mixed:GM-LM-RR-LSVT-SGD-PATE,sub25100,nopa,Unlocking,0.2,SVTLaplaceMechanism,{'Optimal': 40},1178,1127,1089,0,290,1089,1178,837,0,1178,1127,1089,0,290,1089,1178,837,0,poisson-block-composition
1178,sp_workloads,1690805680,wl_small_mem,1053,mixed:GM-LM-RR-LSVT-SGD-PATE-sub25100-defpa,1,weighted-dpf+,block-composition,poisson,equal-ncd,mixed:GM-LM-RR-LSVT-SGD-PATE,sub25100,nopa,Unlocking,0.4,GaussianMechanism,{'Optimal': 40},1075,1140,1126,0,0,591,1075,1140,535,1075,1140,1126,0,0,591,1075,1140,535,poisson-block-composition
1179,sp_workloads,1690805680,wl_small_mem,1053,mixed:GM-LM-RR-LSVT-SGD-PATE-sub25100-defpa,1,weighted-dpf+,block-composition,poisson,equal-ncd,mixed:GM-LM-RR-LSVT-SGD-PATE,sub25100,nopa,Unlocking,0.4,LaplaceMechanism,{'Optimal': 40},1140,1163,1130,0,523,1130,1140,640,0,1140,1163,1130,0,523,1130,1140,640,0,poisson-block-composition
1180,sp_workloads,1690805680,wl_small_mem,1053,mixed:GM-LM-RR-LSVT-SGD-PATE-sub25100-defpa,1,weighted-dpf+,block-composition,poisson,equal-ncd,mixed:GM-LM-RR-LSVT-SGD-PATE,sub25100,nopa,Unlocking,0.4,MLNoisySGDMechanism,{'Optimal': 40},1145,1089,1161,0,0,91,1145,1089,1070,1145,1089,1161,0,0,91,1145,1089,1070,poisson-block-composition
1181,sp_workloads,1690805680,wl_small_mem,1053,mixed:GM-LM-RR-LSVT-SGD-PATE-sub25100-defpa,1,weighted-dpf+,block-composition,poisson,equal-ncd,mixed:GM-LM-RR-LSVT-SGD-PATE,sub25100,nopa,Unlocking,0.4,MLPateGaussianMechanism,{'Optimal': 40},1163,1144,1138,0,8,454,1163,1136,684,1163,1144,1138,0,8,454,1163,1136,684,poisson-block-composition
1182,sp_workloads,1690805680,wl_small_mem,1053,mixed:GM-LM-RR-LSVT-SGD-PATE-sub25100-defpa,1,weighted-dpf+,block-composition,poisson,equal-ncd,mixed:GM-LM-RR-LSVT-SGD-PATE,sub25100,nopa,Unlocking,0.4,RandResponseMechanism,{'Optimal': 40},1093,1164,1181,0,66,1181,1093,1098,0,1093,1164,1181,0,66,1181,1093,1098,0,poisson-block-composition
1183,sp_workloads,1690805680,wl_small_mem,1053,mixed:GM-LM-RR-LSVT-SGD-PATE-sub25100-defpa,1,weighted-dpf+,block-composition,poisson,equal-ncd,mixed:GM-LM-RR-LSVT-SGD-PATE,sub25100,nopa,Unlocking,0.4,SVTLaplaceMechanism,{'Optimal': 40},1178,1127,1089,0,289,1089,1178,838,0,1178,1127,1089,0,289,1089,1178,838,0,poisson-block-composition
1184,sp_workloads,1690805680,wl_small_mem,1054,mixed:GM-LM-RR-LSVT-SGD-PATE-sub25100-defpa,1,weighted-dpf+,block-composition,upc,equal-ncd,mixed:GM-LM-RR-LSVT-SGD-PATE,sub25100,nopa,Unlocking,0.2,GaussianMechanism,{'Optimal': 40},1075,1140,1126,0,59,705,1075,1081,421,1075,1140,1126,0,59,705,1075,1081,421,upc-block-composition
1185,sp_workloads,1690805680,wl_small_mem,1054,mixed:GM-LM-RR-LSVT-SGD-PATE-sub25100-defpa,1,weighted-dpf+,block-composition,upc,equal-ncd,mixed:GM-LM-RR-LSVT-SGD-PATE,sub25100,nopa,Unlocking,0.2,LaplaceMechanism,{'Optimal': 40},1140,1163,1130,0,69,1048,1140,1094,82,1140,1163,1130,0,69,1048,1140,1094,82,upc-block-composition
1186,sp_workloads,1690805680,wl_small_mem,1054,mixed:GM-LM-RR-LSVT-SGD-PATE-sub25100-defpa,1,weighted-dpf+,block-composition,upc,equal-ncd,mixed:GM-LM-RR-LSVT-SGD-PATE,sub25100,nopa,Unlocking,0.2,MLNoisySGDMechanism,{'Optimal': 40},1145,1089,1161,0,51,309,1145,1038,852,1145,1089,1161,0,51,309,1145,1038,852,upc-block-composition
1187,sp_workloads,1690805680,wl_small_mem,1054,mixed:GM-LM-RR-LSVT-SGD-PATE-sub25100-defpa,1,weighted-dpf+,block-composition,upc,equal-ncd,mixed:GM-LM-RR-LSVT-SGD-PATE,sub25100,nopa,Unlocking,0.2,MLPateGaussianMechanism,{'Optimal': 40},1163,1144,1138,0,117,468,1163,1027,670,1163,1144,1138,0,117,468,1163,1027,670,upc-block-composition
1188,sp_workloads,1690805680,wl_small_mem,1054,mixed:GM-LM-RR-LSVT-SGD-PATE-sub25100-defpa,1,weighted-dpf+,block-composition,upc,equal-ncd,mixed:GM-LM-RR-LSVT-SGD-PATE,sub25100,nopa,Unlocking,0.2,RandResponseMechanism,{'Optimal': 40},1093,1164,1181,0,73,1039,1093,1091,142,1093,1164,1181,0,73,1039,1093,1091,142,upc-block-composition
1189,sp_workloads,1690805680,wl_small_mem,1054,mixed:GM-LM-RR-LSVT-SGD-PATE-sub25100-defpa,1,weighted-dpf+,block-composition,upc,equal-ncd,mixed:GM-LM-RR-LSVT-SGD-PATE,sub25100,nopa,Unlocking,0.2,SVTLaplaceMechanism,{'Optimal': 40},1178,1127,1089,0,70,960,1178,1057,129,1178,1127,1089,0,70,960,1178,1057,129,upc-block-composition
1190,sp_workloads,1690805680,wl_small_mem,1055,mixed:GM-LM-RR-LSVT-SGD-PATE-sub25100-defpa,1,weighted-dpf+,block-composition,upc,equal-ncd,mixed:GM-LM-RR-LSVT-SGD-PATE,sub25100,nopa,Unlocking,0.4,GaussianMechanism,{'Optimal': 40},1075,1140,1126,0,82,504,1075,1058,622,1075,1140,1126,0,82,504,1075,1058,622,upc-block-composition
1191,sp_workloads,1690805680,wl_small_mem,1055,mixed:GM-LM-RR-LSVT-SGD-PATE-sub25100-defpa,1,weighted-dpf+,block-composition,upc,equal-ncd,mixed:GM-LM-RR-LSVT-SGD-PATE,sub25100,nopa,Unlocking,0.4,LaplaceMechanism,{'Optimal': 40},1140,1163,1130,0,97,1127,1140,1066,3,1140,1163,1130,0,97,1127,1140,1066,3,upc-block-composition
1192,sp_workloads,1690805680,wl_small_mem,1055,mixed:GM-LM-RR-LSVT-SGD-PATE-sub25100-defpa,1,weighted-dpf+,block-composition,upc,equal-ncd,mixed:GM-LM-RR-LSVT-SGD-PATE,sub25100,nopa,Unlocking,0.4,MLNoisySGDMechanism,{'Optimal': 40},1145,1089,1161,1,63,288,1144,1026,873,1145,1089,1161,1,63,288,1144,1026,873,upc-block-composition
1193,sp_workloads,1690805680,wl_small_mem,1055,mixed:GM-LM-RR-LSVT-SGD-PATE-sub25100-defpa,1,weighted-dpf+,block-composition,upc,equal-ncd,mixed:GM-LM-RR-LSVT-SGD-PATE,sub25100,nopa,Unlocking,0.4,MLPateGaussianMechanism,{'Optimal': 40},1163,1144,1138,0,147,366,1163,997,772,1163,1144,1138,0,147,366,1163,997,772,upc-block-composition
1194,sp_workloads,1690805680,wl_small_mem,1055,mixed:GM-LM-RR-LSVT-SGD-PATE-sub25100-defpa,1,weighted-dpf+,block-composition,upc,equal-ncd,mixed:GM-LM-RR-LSVT-SGD-PATE,sub25100,nopa,Unlocking,0.4,RandResponseMechanism,{'Optimal': 40},1093,1164,1181,0,60,1152,1093,1104,29,1093,1164,1181,0,60,1152,1093,1104,29,upc-block-composition
1195,sp_workloads,1690805680,wl_small_mem,1055,mixed:GM-LM-RR-LSVT-SGD-PATE-sub25100-defpa,1,weighted-dpf+,block-composition,upc,equal-ncd,mixed:GM-LM-RR-LSVT-SGD-PATE,sub25100,nopa,Unlocking,0.4,SVTLaplaceMechanism,{'Optimal': 40},1178,1127,1089,0,69,1029,1178,1058,60,1178,1127,1089,0,69,1029,1178,1058,60,upc-block-composition
1196,sp_workloads,1690805680,wl_small_mem,1056,mixed:GM-LM-RR-LSVT-SGD-PATE-sub25100-defpa,2,weighted-dpf+,block-composition,poisson,ncd,mixed:GM-LM-RR-LSVT-SGD-PATE,sub25100,nopa,Unlocking,0.2,GaussianMechanism,{'Optimal': 40},3297557,222693,20889,0,0,3915,3297557,222693,16974,1107,1156,1159,0,0,261,1107,1156,898,poisson-block-composition
1197,sp_workloads,1690805680,wl_small_mem,1056,mixed:GM-LM-RR-LSVT-SGD-PATE-sub25100-defpa,2,weighted-dpf+,block-composition,poisson,ncd,mixed:GM-LM-RR-LSVT-SGD-PATE,sub25100,nopa,Unlocking,0.2,LaplaceMechanism,{'Optimal': 40},2847135,226653,20024,324218,1732,12706,2522917,224921,7318,1061,1136,1112,150,12,718,911,1124,394,poisson-block-composition
1198,sp_workloads,1690805680,wl_small_mem,1056,mixed:GM-LM-RR-LSVT-SGD-PATE-sub25100-defpa,2,weighted-dpf+,block-composition,poisson,ncd,mixed:GM-LM-RR-LSVT-SGD-PATE,sub25100,nopa,Unlocking,0.2,MLNoisySGDMechanism,{'Optimal': 40},3065470,217531,20600,0,0,0,3065470,217531,20600,1088,1113,1144,0,0,0,1088,1113,1144,poisson-block-composition
1199,sp_workloads,1690805680,wl_small_mem,1056,mixed:GM-LM-RR-LSVT-SGD-PATE-sub25100-defpa,2,weighted-dpf+,block-composition,poisson,ncd,mixed:GM-LM-RR-LSVT-SGD-PATE,sub25100,nopa,Unlocking,0.2,MLPateGaussianMechanism,{'Optimal': 40},3183074,228777,19443,0,0,195,3183074,228777,19248,1123,1178,1085,0,0,13,1123,1178,1072,poisson-block-composition
1200,sp_workloads,1690805680,wl_small_mem,1056,mixed:GM-LM-RR-LSVT-SGD-PATE-sub25100-defpa,2,weighted-dpf+,block-composition,poisson,ncd,mixed:GM-LM-RR-LSVT-SGD-PATE,sub25100,nopa,Unlocking,0.2,RandResponseMechanism,{'Optimal': 40},3253029,217115,19830,42334,0,12140,3210695,217115,7690,1136,1135,1114,19,0,676,1117,1135,438,poisson-block-composition
1201,sp_workloads,1690805680,wl_small_mem,1056,mixed:GM-LM-RR-LSVT-SGD-PATE-sub25100-defpa,2,weighted-dpf+,block-composition,poisson,ncd,mixed:GM-LM-RR-LSVT-SGD-PATE,sub25100,nopa,Unlocking,0.2,SVTLaplaceMechanism,{'Optimal': 40},3041723,217557,19755,66908,572,11012,2974815,216985,8743,1106,1092,1109,30,4,636,1076,1088,473,poisson-block-composition
1202,sp_workloads,1690805680,wl_small_mem,1057,mixed:GM-LM-RR-LSVT-SGD-PATE-sub25100-defpa,2,weighted-dpf+,block-composition,poisson,ncd,mixed:GM-LM-RR-LSVT-SGD-PATE,sub25100,nopa,Unlocking,0.4,GaussianMechanism,{'Optimal': 40},3297557,222693,20889,0,0,4095,3297557,222693,16794,1107,1156,1159,0,0,273,1107,1156,886,poisson-block-composition
1203,sp_workloads,1690805680,wl_small_mem,1057,mixed:GM-LM-RR-LSVT-SGD-PATE-sub25100-defpa,2,weighted-dpf+,block-composition,poisson,ncd,mixed:GM-LM-RR-LSVT-SGD-PATE,sub25100,nopa,Unlocking,0.4,LaplaceMechanism,{'Optimal': 40},2847135,226653,20024,319909,4290,12827,2527226,222363,7197,1061,1136,1112,148,30,709,913,1106,403,poisson-block-composition
1204,sp_workloads,1690805680,wl_small_mem,1057,mixed:GM-LM-RR-LSVT-SGD-PATE-sub25100-defpa,2,weighted-dpf+,block-composition,poisson,ncd,mixed:GM-LM-RR-LSVT-SGD-PATE,sub25100,nopa,Unlocking,0.4,MLNoisySGDMechanism,{'Optimal': 40},3065470,217531,20600,0,0,0,3065470,217531,20600,1088,1113,1144,0,0,0,1088,1113,1144,poisson-block-composition
1205,sp_workloads,1690805680,wl_small_mem,1057,mixed:GM-LM-RR-LSVT-SGD-PATE-sub25100-defpa,2,weighted-dpf+,block-composition,poisson,ncd,mixed:GM-LM-RR-LSVT-SGD-PATE,sub25100,nopa,Unlocking,0.4,MLPateGaussianMechanism,{'Optimal': 40},3183074,228777,19443,0,0,105,3183074,228777,19338,1123,1178,1085,0,0,7,1123,1178,1078,poisson-block-composition
1206,sp_workloads,1690805680,wl_small_mem,1057,mixed:GM-LM-RR-LSVT-SGD-PATE-sub25100-defpa,2,weighted-dpf+,block-composition,poisson,ncd,mixed:GM-LM-RR-LSVT-SGD-PATE,sub25100,nopa,Unlocking,0.4,RandResponseMechanism,{'Optimal': 40},3253029,217115,19830,51270,0,11693,3201759,217115,8137,1136,1135,1114,23,0,659,1113,1135,455,poisson-block-composition
1207,sp_workloads,1690805680,wl_small_mem,1057,mixed:GM-LM-RR-LSVT-SGD-PATE-sub25100-defpa,2,weighted-dpf+,block-composition,poisson,ncd,mixed:GM-LM-RR-LSVT-SGD-PATE,sub25100,nopa,Unlocking,0.4,SVTLaplaceMechanism,{'Optimal': 40},3041723,217557,19755,66732,143,9643,2974991,217414,10112,1106,1092,1109,30,1,581,1076,1091,528,poisson-block-composition
1208,sp_workloads,1690805680,wl_small_mem,1058,mixed:GM-LM-RR-LSVT-SGD-PATE-sub25100-defpa,2,weighted-dpf+,block-composition,upc,ncd,mixed:GM-LM-RR-LSVT-SGD-PATE,sub25100,nopa,Unlocking,0.2,GaussianMechanism,{'Optimal': 40},3028685,226201,22304,0,5590,4544,3028685,220611,17760,1107,1156,1159,0,68,268,1107,1088,891,upc-block-composition
1209,sp_workloads,1690805680,wl_small_mem,1058,mixed:GM-LM-RR-LSVT-SGD-PATE-sub25100-defpa,2,weighted-dpf+,block-composition,upc,ncd,mixed:GM-LM-RR-LSVT-SGD-PATE,sub25100,nopa,Unlocking,0.2,LaplaceMechanism,{'Optimal': 40},2820488,216183,20704,50766,7862,11104,2769722,208321,9600,1061,1136,1112,11,44,601,1050,1092,511,upc-block-composition
1210,sp_workloads,1690805680,wl_small_mem,1058,mixed:GM-LM-RR-LSVT-SGD-PATE-sub25100-defpa,2,weighted-dpf+,block-composition,upc,ncd,mixed:GM-LM-RR-LSVT-SGD-PATE,sub25100,nopa,Unlocking,0.2,MLNoisySGDMechanism,{'Optimal': 40},3179489,220472,21440,64,4299,3088,3179425,216173,18352,1088,1113,1144,1,58,192,1087,1055,952,upc-block-composition
1211,sp_workloads,1690805680,wl_small_mem,1058,mixed:GM-LM-RR-LSVT-SGD-PATE-sub25100-defpa,2,weighted-dpf+,block-composition,upc,ncd,mixed:GM-LM-RR-LSVT-SGD-PATE,sub25100,nopa,Unlocking,0.2,MLPateGaussianMechanism,{'Optimal': 40},3159577,225347,20608,1717,6912,3440,3157860,218435,17168,1123,1178,1085,1,81,208,1122,1097,877,upc-block-composition
1212,sp_workloads,1690805680,wl_small_mem,1058,mixed:GM-LM-RR-LSVT-SGD-PATE-sub25100-defpa,2,weighted-dpf+,block-composition,upc,ncd,mixed:GM-LM-RR-LSVT-SGD-PATE,sub25100,nopa,Unlocking,0.2,RandResponseMechanism,{'Optimal': 40},3276567,216246,21344,21836,4576,11408,3254731,211670,9936,1136,1135,1114,7,39,603,1129,1096,511,upc-block-composition
1213,sp_workloads,1690805680,wl_small_mem,1058,mixed:GM-LM-RR-LSVT-SGD-PATE-sub25100-defpa,2,weighted-dpf+,block-composition,upc,ncd,mixed:GM-LM-RR-LSVT-SGD-PATE,sub25100,nopa,Unlocking,0.2,SVTLaplaceMechanism,{'Optimal': 40},3232745,216520,21504,17509,4914,9392,3215236,211606,12112,1106,1092,1109,8,42,508,1098,1050,601,upc-block-composition
1214,sp_workloads,1690805680,wl_small_mem,1059,mixed:GM-LM-RR-LSVT-SGD-PATE-sub25100-defpa,2,weighted-dpf+,block-composition,upc,ncd,mixed:GM-LM-RR-LSVT-SGD-PATE,sub25100,nopa,Unlocking,0.4,GaussianMechanism,{'Optimal': 40},3028685,226201,22304,0,7521,5360,3028685,218680,16944,1107,1156,1159,0,84,331,1107,1072,828,upc-block-composition
1215,sp_workloads,1690805680,wl_small_mem,1059,mixed:GM-LM-RR-LSVT-SGD-PATE-sub25100-defpa,2,weighted-dpf+,block-composition,upc,ncd,mixed:GM-LM-RR-LSVT-SGD-PATE,sub25100,nopa,Unlocking,0.4,LaplaceMechanism,{'Optimal': 40},2820488,216183,20704,50557,5726,15696,2769931,210457,5008,1061,1136,1112,11,43,809,1050,1093,303,upc-block-composition
1216,sp_workloads,1690805680,wl_small_mem,1059,mixed:GM-LM-RR-LSVT-SGD-PATE-sub25100-defpa,2,weighted-dpf+,block-composition,upc,ncd,mixed:GM-LM-RR-LSVT-SGD-PATE,sub25100,nopa,Unlocking,0.4,MLNoisySGDMechanism,{'Optimal': 40},3179489,220472,21440,3983,3109,4592,3175506,217363,16848,1088,1113,1144,5,36,287,1083,1077,857,upc-block-composition
1217,sp_workloads,1690805680,wl_small_mem,1059,mixed:GM-LM-RR-LSVT-SGD-PATE-sub25100-defpa,2,weighted-dpf+,block-composition,upc,ncd,mixed:GM-LM-RR-LSVT-SGD-PATE,sub25100,nopa,Unlocking,0.4,MLPateGaussianMechanism,{'Optimal': 40},3159577,225347,20608,0,8281,4704,3159577,217066,15904,1123,1178,1085,0,90,294,1123,1088,791,upc-block-composition
1218,sp_workloads,1690805680,wl_small_mem,1059,mixed:GM-LM-RR-LSVT-SGD-PATE-sub25100-defpa,2,weighted-dpf+,block-composition,upc,ncd,mixed:GM-LM-RR-LSVT-SGD-PATE,sub25100,nopa,Unlocking,0.4,RandResponseMechanism,{'Optimal': 40},3276567,216246,21344,10997,4703,14832,3265570,211543,6512,1136,1135,1114,5,49,764,1131,1086,350,upc-block-composition
1219,sp_workloads,1690805680,wl_small_mem,1059,mixed:GM-LM-RR-LSVT-SGD-PATE-sub25100-defpa,2,weighted-dpf+,block-composition,upc,ncd,mixed:GM-LM-RR-LSVT-SGD-PATE,sub25100,nopa,Unlocking,0.4,SVTLaplaceMechanism,{'Optimal': 40},3232745,216520,21504,12406,5709,12448,3220339,210811,9056,1106,1092,1109,7,50,643,1099,1042,466,upc-block-composition
1220,sp_workloads,1690805680,wl_small_mem,1060,mixed:GM-LM-RR-LSVT-SGD-PATE-sub25100-defpa,2,weighted-dpf+,block-composition,poisson,equal-ncd,mixed:GM-LM-RR-LSVT-SGD-PATE,sub25100,nopa,Unlocking,0.2,GaussianMechanism,{'Optimal': 40},1107,1156,1159,0,0,654,1107,1156,505,1107,1156,1159,0,0,654,1107,1156,505,poisson-block-composition
1221,sp_workloads,1690805680,wl_small_mem,1060,mixed:GM-LM-RR-LSVT-SGD-PATE-sub25100-defpa,2,weighted-dpf+,block-composition,poisson,equal-ncd,mixed:GM-LM-RR-LSVT-SGD-PATE,sub25100,nopa,Unlocking,0.2,LaplaceMechanism,{'Optimal': 40},1061,1136,1112,0,550,1112,1061,586,0,1061,1136,1112,0,550,1112,1061,586,0,poisson-block-composition
1222,sp_workloads,1690805680,wl_small_mem,1060,mixed:GM-LM-RR-LSVT-SGD-PATE-sub25100-defpa,2,weighted-dpf+,block-composition,poisson,equal-ncd,mixed:GM-LM-RR-LSVT-SGD-PATE,sub25100,nopa,Unlocking,0.2,MLNoisySGDMechanism,{'Optimal': 40},1088,1113,1144,0,0,183,1088,1113,961,1088,1113,1144,0,0,183,1088,1113,961,poisson-block-composition
1223,sp_workloads,1690805680,wl_small_mem,1060,mixed:GM-LM-RR-LSVT-SGD-PATE-sub25100-defpa,2,weighted-dpf+,block-composition,poisson,equal-ncd,mixed:GM-LM-RR-LSVT-SGD-PATE,sub25100,nopa,Unlocking,0.2,MLPateGaussianMechanism,{'Optimal': 40},1123,1178,1085,0,2,507,1123,1176,578,1123,1178,1085,0,2,507,1123,1176,578,poisson-block-composition
1224,sp_workloads,1690805680,wl_small_mem,1060,mixed:GM-LM-RR-LSVT-SGD-PATE-sub25100-defpa,2,weighted-dpf+,block-composition,poisson,equal-ncd,mixed:GM-LM-RR-LSVT-SGD-PATE,sub25100,nopa,Unlocking,0.2,RandResponseMechanism,{'Optimal': 40},1136,1135,1114,0,27,1114,1136,1108,0,1136,1135,1114,0,27,1114,1136,1108,0,poisson-block-composition
1225,sp_workloads,1690805680,wl_small_mem,1060,mixed:GM-LM-RR-LSVT-SGD-PATE-sub25100-defpa,2,weighted-dpf+,block-composition,poisson,equal-ncd,mixed:GM-LM-RR-LSVT-SGD-PATE,sub25100,nopa,Unlocking,0.2,SVTLaplaceMechanism,{'Optimal': 40},1106,1092,1109,0,290,1109,1106,802,0,1106,1092,1109,0,290,1109,1106,802,0,poisson-block-composition
1226,sp_workloads,1690805680,wl_small_mem,1061,mixed:GM-LM-RR-LSVT-SGD-PATE-sub25100-defpa,2,weighted-dpf+,block-composition,poisson,equal-ncd,mixed:GM-LM-RR-LSVT-SGD-PATE,sub25100,nopa,Unlocking,0.4,GaussianMechanism,{'Optimal': 40},1107,1156,1159,0,0,565,1107,1156,594,1107,1156,1159,0,0,565,1107,1156,594,poisson-block-composition
1227,sp_workloads,1690805680,wl_small_mem,1061,mixed:GM-LM-RR-LSVT-SGD-PATE-sub25100-defpa,2,weighted-dpf+,block-composition,poisson,equal-ncd,mixed:GM-LM-RR-LSVT-SGD-PATE,sub25100,nopa,Unlocking,0.4,LaplaceMechanism,{'Optimal': 40},1061,1136,1112,0,507,1112,1061,629,0,1061,1136,1112,0,507,1112,1061,629,0,poisson-block-composition
1228,sp_workloads,1690805680,wl_small_mem,1061,mixed:GM-LM-RR-LSVT-SGD-PATE-sub25100-defpa,2,weighted-dpf+,block-composition,poisson,equal-ncd,mixed:GM-LM-RR-LSVT-SGD-PATE,sub25100,nopa,Unlocking,0.4,MLNoisySGDMechanism,{'Optimal': 40},1088,1113,1144,0,0,152,1088,1113,992,1088,1113,1144,0,0,152,1088,1113,992,poisson-block-composition
1229,sp_workloads,1690805680,wl_small_mem,1061,mixed:GM-LM-RR-LSVT-SGD-PATE-sub25100-defpa,2,weighted-dpf+,block-composition,poisson,equal-ncd,mixed:GM-LM-RR-LSVT-SGD-PATE,sub25100,nopa,Unlocking,0.4,MLPateGaussianMechanism,{'Optimal': 40},1123,1178,1085,0,0,447,1123,1178,638,1123,1178,1085,0,0,447,1123,1178,638,poisson-block-composition
1230,sp_workloads,1690805680,wl_small_mem,1061,mixed:GM-LM-RR-LSVT-SGD-PATE-sub25100-defpa,2,weighted-dpf+,block-composition,poisson,equal-ncd,mixed:GM-LM-RR-LSVT-SGD-PATE,sub25100,nopa,Unlocking,0.4,RandResponseMechanism,{'Optimal': 40},1136,1135,1114,0,85,1114,1136,1050,0,1136,1135,1114,0,85,1114,1136,1050,0,poisson-block-composition
1231,sp_workloads,1690805680,wl_small_mem,1061,mixed:GM-LM-RR-LSVT-SGD-PATE-sub25100-defpa,2,weighted-dpf+,block-composition,poisson,equal-ncd,mixed:GM-LM-RR-LSVT-SGD-PATE,sub25100,nopa,Unlocking,0.4,SVTLaplaceMechanism,{'Optimal': 40},1106,1092,1109,0,286,1109,1106,806,0,1106,1092,1109,0,286,1109,1106,806,0,poisson-block-composition
1232,sp_workloads,1690805680,wl_small_mem,1062,mixed:GM-LM-RR-LSVT-SGD-PATE-sub25100-defpa,2,weighted-dpf+,block-composition,upc,equal-ncd,mixed:GM-LM-RR-LSVT-SGD-PATE,sub25100,nopa,Unlocking,0.2,GaussianMechanism,{'Optimal': 40},1107,1156,1159,0,84,673,1107,1072,486,1107,1156,1159,0,84,673,1107,1072,486,upc-block-composition
1233,sp_workloads,1690805680,wl_small_mem,1062,mixed:GM-LM-RR-LSVT-SGD-PATE-sub25100-defpa,2,weighted-dpf+,block-composition,upc,equal-ncd,mixed:GM-LM-RR-LSVT-SGD-PATE,sub25100,nopa,Unlocking,0.2,LaplaceMechanism,{'Optimal': 40},1061,1136,1112,0,66,1033,1061,1070,79,1061,1136,1112,0,66,1033,1061,1070,79,upc-block-composition
1234,sp_workloads,1690805680,wl_small_mem,1062,mixed:GM-LM-RR-LSVT-SGD-PATE-sub25100-defpa,2,weighted-dpf+,block-composition,upc,equal-ncd,mixed:GM-LM-RR-LSVT-SGD-PATE,sub25100,nopa,Unlocking,0.2,MLNoisySGDMechanism,{'Optimal': 40},1088,1113,1144,0,46,328,1088,1067,816,1088,1113,1144,0,46,328,1088,1067,816,upc-block-composition
1235,sp_workloads,1690805680,wl_small_mem,1062,mixed:GM-LM-RR-LSVT-SGD-PATE-sub25100-defpa,2,weighted-dpf+,block-composition,upc,equal-ncd,mixed:GM-LM-RR-LSVT-SGD-PATE,sub25100,nopa,Unlocking,0.2,MLPateGaussianMechanism,{'Optimal': 40},1123,1178,1085,0,148,453,1123,1030,632,1123,1178,1085,0,148,453,1123,1030,632,upc-block-composition
1236,sp_workloads,1690805680,wl_small_mem,1062,mixed:GM-LM-RR-LSVT-SGD-PATE-sub25100-defpa,2,weighted-dpf+,block-composition,upc,equal-ncd,mixed:GM-LM-RR-LSVT-SGD-PATE,sub25100,nopa,Unlocking,0.2,RandResponseMechanism,{'Optimal': 40},1136,1135,1114,0,58,959,1136,1077,155,1136,1135,1114,0,58,959,1136,1077,155,upc-block-composition
1237,sp_workloads,1690805680,wl_small_mem,1062,mixed:GM-LM-RR-LSVT-SGD-PATE-sub25100-defpa,2,weighted-dpf+,block-composition,upc,equal-ncd,mixed:GM-LM-RR-LSVT-SGD-PATE,sub25100,nopa,Unlocking,0.2,SVTLaplaceMechanism,{'Optimal': 40},1106,1092,1109,0,84,946,1106,1008,163,1106,1092,1109,0,84,946,1106,1008,163,upc-block-composition
1238,sp_workloads,1690805680,wl_small_mem,1063,mixed:GM-LM-RR-LSVT-SGD-PATE-sub25100-defpa,2,weighted-dpf+,block-composition,upc,equal-ncd,mixed:GM-LM-RR-LSVT-SGD-PATE,sub25100,nopa,Unlocking,0.4,GaussianMechanism,{'Optimal': 40},1107,1156,1159,0,80,593,1107,1076,566,1107,1156,1159,0,80,593,1107,1076,566,upc-block-composition
1239,sp_workloads,1690805680,wl_small_mem,1063,mixed:GM-LM-RR-LSVT-SGD-PATE-sub25100-defpa,2,weighted-dpf+,block-composition,upc,equal-ncd,mixed:GM-LM-RR-LSVT-SGD-PATE,sub25100,nopa,Unlocking,0.4,LaplaceMechanism,{'Optimal': 40},1061,1136,1112,1,87,1088,1060,1049,24,1061,1136,1112,1,87,1088,1060,1049,24,upc-block-composition
1240,sp_workloads,1690805680,wl_small_mem,1063,mixed:GM-LM-RR-LSVT-SGD-PATE-sub25100-defpa,2,weighted-dpf+,block-composition,upc,equal-ncd,mixed:GM-LM-RR-LSVT-SGD-PATE,sub25100,nopa,Unlocking,0.4,MLNoisySGDMechanism,{'Optimal': 40},1088,1113,1144,2,83,308,1086,1030,836,1088,1113,1144,2,83,308,1086,1030,836,upc-block-composition
1241,sp_workloads,1690805680,wl_small_mem,1063,mixed:GM-LM-RR-LSVT-SGD-PATE-sub25100-defpa,2,weighted-dpf+,block-composition,upc,equal-ncd,mixed:GM-LM-RR-LSVT-SGD-PATE,sub25100,nopa,Unlocking,0.4,MLPateGaussianMechanism,{'Optimal': 40},1123,1178,1085,0,163,390,1123,1015,695,1123,1178,1085,0,163,390,1123,1015,695,upc-block-composition
1242,sp_workloads,1690805680,wl_small_mem,1063,mixed:GM-LM-RR-LSVT-SGD-PATE-sub25100-defpa,2,weighted-dpf+,block-composition,upc,equal-ncd,mixed:GM-LM-RR-LSVT-SGD-PATE,sub25100,nopa,Unlocking,0.4,RandResponseMechanism,{'Optimal': 40},1136,1135,1114,1,68,1061,1135,1067,53,1136,1135,1114,1,68,1061,1135,1067,53,upc-block-composition
1243,sp_workloads,1690805680,wl_small_mem,1063,mixed:GM-LM-RR-LSVT-SGD-PATE-sub25100-defpa,2,weighted-dpf+,block-composition,upc,equal-ncd,mixed:GM-LM-RR-LSVT-SGD-PATE,sub25100,nopa,Unlocking,0.4,SVTLaplaceMechanism,{'Optimal': 40},1106,1092,1109,0,53,1026,1106,1039,83,1106,1092,1109,0,53,1026,1106,1039,83,upc-block-composition
1244,sp_workloads,1690805680,wl_small_mem,1064,mixed:GM-LM-RR-LSVT-SGD-PATE-sub25100-defpa,3,weighted-dpf+,block-composition,poisson,ncd,mixed:GM-LM-RR-LSVT-SGD-PATE,sub25100,nopa,Unlocking,0.2,GaussianMechanism,{'Optimal': 40},3014106,221031,21056,0,0,4240,3014106,221031,16816,1094,1113,1104,0,0,265,1094,1113,839,poisson-block-composition
1245,sp_workloads,1690805680,wl_small_mem,1064,mixed:GM-LM-RR-LSVT-SGD-PATE-sub25100-defpa,3,weighted-dpf+,block-composition,poisson,ncd,mixed:GM-LM-RR-LSVT-SGD-PATE,sub25100,nopa,Unlocking,0.2,LaplaceMechanism,{'Optimal': 40},3356641,218178,20864,397558,1450,12576,2959083,216728,8288,1169,1154,1119,182,10,707,987,1144,412,poisson-block-composition
1246,sp_workloads,1690805680,wl_small_mem,1064,mixed:GM-LM-RR-LSVT-SGD-PATE-sub25100-defpa,3,weighted-dpf+,block-composition,poisson,ncd,mixed:GM-LM-RR-LSVT-SGD-PATE,sub25100,nopa,Unlocking,0.2,MLNoisySGDMechanism,{'Optimal': 40},2886113,212328,21728,0,0,0,2886113,212328,21728,1057,1087,1124,0,0,0,1057,1087,1124,poisson-block-composition
1247,sp_workloads,1690805680,wl_small_mem,1064,mixed:GM-LM-RR-LSVT-SGD-PATE-sub25100-defpa,3,weighted-dpf+,block-composition,poisson,ncd,mixed:GM-LM-RR-LSVT-SGD-PATE,sub25100,nopa,Unlocking,0.2,MLPateGaussianMechanism,{'Optimal': 40},3286989,218751,22304,0,0,384,3286989,218751,21920,1114,1105,1168,0,0,24,1114,1105,1144,poisson-block-composition
1248,sp_workloads,1690805680,wl_small_mem,1064,mixed:GM-LM-RR-LSVT-SGD-PATE-sub25100-defpa,3,weighted-dpf+,block-composition,poisson,ncd,mixed:GM-LM-RR-LSVT-SGD-PATE,sub25100,nopa,Unlocking,0.2,RandResponseMechanism,{'Optimal': 40},3304405,225397,21760,40612,0,12448,3263793,225397,9312,1160,1175,1154,18,0,688,1142,1175,466,poisson-block-composition
1249,sp_workloads,1690805680,wl_small_mem,1064,mixed:GM-LM-RR-LSVT-SGD-PATE-sub25100-defpa,3,weighted-dpf+,block-composition,poisson,ncd,mixed:GM-LM-RR-LSVT-SGD-PATE,sub25100,nopa,Unlocking,0.2,SVTLaplaceMechanism,{'Optimal': 40},2975196,221951,22352,27096,435,11696,2948100,221516,10656,1080,1132,1168,12,3,662,1068,1129,506,poisson-block-composition
1250,sp_workloads,1690805680,wl_small_mem,1065,mixed:GM-LM-RR-LSVT-SGD-PATE-sub25100-defpa,3,weighted-dpf+,block-composition,poisson,ncd,mixed:GM-LM-RR-LSVT-SGD-PATE,sub25100,nopa,Unlocking,0.4,GaussianMechanism,{'Optimal': 40},3014106,221031,21056,0,0,4256,3014106,221031,16800,1094,1113,1104,0,0,266,1094,1113,838,poisson-block-composition
1251,sp_workloads,1690805680,wl_small_mem,1065,mixed:GM-LM-RR-LSVT-SGD-PATE-sub25100-defpa,3,weighted-dpf+,block-composition,poisson,ncd,mixed:GM-LM-RR-LSVT-SGD-PATE,sub25100,nopa,Unlocking,0.4,LaplaceMechanism,{'Optimal': 40},3356641,218178,20864,364190,1869,14224,2992451,216309,6640,1169,1154,1119,166,13,753,1003,1141,366,poisson-block-composition
1252,sp_workloads,1690805680,wl_small_mem,1065,mixed:GM-LM-RR-LSVT-SGD-PATE-sub25100-defpa,3,weighted-dpf+,block-composition,poisson,ncd,mixed:GM-LM-RR-LSVT-SGD-PATE,sub25100,nopa,Unlocking,0.4,MLNoisySGDMechanism,{'Optimal': 40},2886113,212328,21728,0,0,0,2886113,212328,21728,1057,1087,1124,0,0,0,1057,1087,1124,poisson-block-composition
1253,sp_workloads,1690805680,wl_small_mem,1065,mixed:GM-LM-RR-LSVT-SGD-PATE-sub25100-defpa,3,weighted-dpf+,block-composition,poisson,ncd,mixed:GM-LM-RR-LSVT-SGD-PATE,sub25100,nopa,Unlocking,0.4,MLPateGaussianMechanism,{'Optimal': 40},3286989,218751,22304,0,0,192,3286989,218751,22112,1114,1105,1168,0,0,12,1114,1105,1156,poisson-block-composition
1254,sp_workloads,1690805680,wl_small_mem,1065,mixed:GM-LM-RR-LSVT-SGD-PATE-sub25100-defpa,3,weighted-dpf+,block-composition,poisson,ncd,mixed:GM-LM-RR-LSVT-SGD-PATE,sub25100,nopa,Unlocking,0.4,RandResponseMechanism,{'Optimal': 40},3304405,225397,21760,56451,0,14208,3247954,225397,7552,1160,1175,1154,22,0,743,1138,1175,411,poisson-block-composition
1255,sp_workloads,1690805680,wl_small_mem,1065,mixed:GM-LM-RR-LSVT-SGD-PATE-sub25100-defpa,3,weighted-dpf+,block-composition,poisson,ncd,mixed:GM-LM-RR-LSVT-SGD-PATE,sub25100,nopa,Unlocking,0.4,SVTLaplaceMechanism,{'Optimal': 40},2975196,221951,22352,31612,580,12576,2943584,221371,9776,1080,1132,1168,14,4,673,1066,1128,495,poisson-block-composition
1256,sp_workloads,1690805680,wl_small_mem,1066,mixed:GM-LM-RR-LSVT-SGD-PATE-sub25100-defpa,3,weighted-dpf+,block-composition,upc,ncd,mixed:GM-LM-RR-LSVT-SGD-PATE,sub25100,nopa,Unlocking,0.2,GaussianMechanism,{'Optimal': 40},3015210,216424,20816,0,4888,3248,3015210,211536,17568,1094,1113,1104,0,53,196,1094,1060,908,upc-block-composition
1257,sp_workloads,1690805680,wl_small_mem,1066,mixed:GM-LM-RR-LSVT-SGD-PATE-sub25100-defpa,3,weighted-dpf+,block-composition,upc,ncd,mixed:GM-LM-RR-LSVT-SGD-PATE,sub25100,nopa,Unlocking,0.2,LaplaceMechanism,{'Optimal': 40},3318690,224507,21008,62364,4445,9584,3256326,220062,11424,1169,1154,1119,17,36,519,1152,1118,600,upc-block-composition
1258,sp_workloads,1690805680,wl_small_mem,1066,mixed:GM-LM-RR-LSVT-SGD-PATE-sub25100-defpa,3,weighted-dpf+,block-composition,upc,ncd,mixed:GM-LM-RR-LSVT-SGD-PATE,sub25100,nopa,Unlocking,0.2,MLNoisySGDMechanism,{'Optimal': 40},3049040,216655,21456,112,2750,2352,3048928,213905,19104,1057,1087,1124,1,37,147,1056,1050,977,upc-block-composition
1259,sp_workloads,1690805680,wl_small_mem,1066,mixed:GM-LM-RR-LSVT-SGD-PATE-sub25100-defpa,3,weighted-dpf+,block-composition,upc,ncd,mixed:GM-LM-RR-LSVT-SGD-PATE,sub25100,nopa,Unlocking,0.2,MLPateGaussianMechanism,{'Optimal': 40},3068572,223959,21712,1209,5454,3296,3067363,218505,18416,1114,1105,1168,1,59,196,1113,1046,972,upc-block-composition
1260,sp_workloads,1690805680,wl_small_mem,1066,mixed:GM-LM-RR-LSVT-SGD-PATE-sub25100-defpa,3,weighted-dpf+,block-composition,upc,ncd,mixed:GM-LM-RR-LSVT-SGD-PATE,sub25100,nopa,Unlocking,0.2,RandResponseMechanism,{'Optimal': 40},3242042,226884,21536,26865,2494,8640,3215177,224390,12896,1160,1175,1154,11,24,486,1149,1151,668,upc-block-composition
1261,sp_workloads,1690805680,wl_small_mem,1066,mixed:GM-LM-RR-LSVT-SGD-PATE-sub25100-defpa,3,weighted-dpf+,block-composition,upc,ncd,mixed:GM-LM-RR-LSVT-SGD-PATE,sub25100,nopa,Unlocking,0.2,SVTLaplaceMechanism,{'Optimal': 40},3121265,219086,22384,26882,3317,7760,3094383,215769,14624,1080,1132,1168,14,31,457,1066,1101,711,upc-block-composition
1262,sp_workloads,1690805680,wl_small_mem,1067,mixed:GM-LM-RR-LSVT-SGD-PATE-sub25100-defpa,3,weighted-dpf+,block-composition,upc,ncd,mixed:GM-LM-RR-LSVT-SGD-PATE,sub25100,nopa,Unlocking,0.4,GaussianMechanism,{'Optimal': 40},3015210,216424,20816,2225,7107,5088,3012985,209317,15728,1094,1113,1104,1,80,318,1093,1033,786,upc-block-composition
1263,sp_workloads,1690805680,wl_small_mem,1067,mixed:GM-LM-RR-LSVT-SGD-PATE-sub25100-defpa,3,weighted-dpf+,block-composition,upc,ncd,mixed:GM-LM-RR-LSVT-SGD-PATE,sub25100,nopa,Unlocking,0.4,LaplaceMechanism,{'Optimal': 40},3318690,224507,21008,47866,5618,14544,3270824,218889,6464,1169,1154,1119,11,44,751,1158,1110,368,upc-block-composition
1264,sp_workloads,1690805680,wl_small_mem,1067,mixed:GM-LM-RR-LSVT-SGD-PATE-sub25100-defpa,3,weighted-dpf+,block-composition,upc,ncd,mixed:GM-LM-RR-LSVT-SGD-PATE,sub25100,nopa,Unlocking,0.4,MLNoisySGDMechanism,{'Optimal': 40},3049040,216655,21456,1015,4293,3792,3048025,212362,17664,1057,1087,1124,2,53,236,1055,1034,888,upc-block-composition
1265,sp_workloads,1690805680,wl_small_mem,1067,mixed:GM-LM-RR-LSVT-SGD-PATE-sub25100-defpa,3,weighted-dpf+,block-composition,upc,ncd,mixed:GM-LM-RR-LSVT-SGD-PATE,sub25100,nopa,Unlocking,0.4,MLPateGaussianMechanism,{'Optimal': 40},3068572,223959,21712,0,8333,5184,3068572,215626,16528,1114,1105,1168,0,87,324,1114,1018,844,upc-block-composition
1266,sp_workloads,1690805680,wl_small_mem,1067,mixed:GM-LM-RR-LSVT-SGD-PATE-sub25100-defpa,3,weighted-dpf+,block-composition,upc,ncd,mixed:GM-LM-RR-LSVT-SGD-PATE,sub25100,nopa,Unlocking,0.4,RandResponseMechanism,{'Optimal': 40},3242042,226884,21536,15949,5149,12656,3226093,221735,8880,1160,1175,1154,9,47,672,1151,1128,482,upc-block-composition
1267,sp_workloads,1690805680,wl_small_mem,1067,mixed:GM-LM-RR-LSVT-SGD-PATE-sub25100-defpa,3,weighted-dpf+,block-composition,upc,ncd,mixed:GM-LM-RR-LSVT-SGD-PATE,sub25100,nopa,Unlocking,0.4,SVTLaplaceMechanism,{'Optimal': 40},3121265,219086,22384,14803,5232,12272,3106462,213854,10112,1080,1132,1168,7,46,638,1073,1086,530,upc-block-composition
1268,sp_workloads,1690805680,wl_small_mem,1068,mixed:GM-LM-RR-LSVT-SGD-PATE-sub25100-defpa,3,weighted-dpf+,block-composition,poisson,equal-ncd,mixed:GM-LM-RR-LSVT-SGD-PATE,sub25100,nopa,Unlocking,0.2,GaussianMechanism,{'Optimal': 40},1094,1113,1104,0,0,600,1094,1113,504,1094,1113,1104,0,0,600,1094,1113,504,poisson-block-composition
1269,sp_workloads,1690805680,wl_small_mem,1068,mixed:GM-LM-RR-LSVT-SGD-PATE-sub25100-defpa,3,weighted-dpf+,block-composition,poisson,equal-ncd,mixed:GM-LM-RR-LSVT-SGD-PATE,sub25100,nopa,Unlocking,0.2,LaplaceMechanism,{'Optimal': 40},1169,1154,1119,0,584,1119,1169,570,0,1169,1154,1119,0,584,1119,1169,570,0,poisson-block-composition
1270,sp_workloads,1690805680,wl_small_mem,1068,mixed:GM-LM-RR-LSVT-SGD-PATE-sub25100-defpa,3,weighted-dpf+,block-composition,poisson,equal-ncd,mixed:GM-LM-RR-LSVT-SGD-PATE,sub25100,nopa,Unlocking,0.2,MLNoisySGDMechanism,{'Optimal': 40},1057,1087,1124,0,0,149,1057,1087,975,1057,1087,1124,0,0,149,1057,1087,975,poisson-block-composition
1271,sp_workloads,1690805680,wl_small_mem,1068,mixed:GM-LM-RR-LSVT-SGD-PATE-sub25100-defpa,3,weighted-dpf+,block-composition,poisson,equal-ncd,mixed:GM-LM-RR-LSVT-SGD-PATE,sub25100,nopa,Unlocking,0.2,MLPateGaussianMechanism,{'Optimal': 40},1114,1105,1168,0,2,503,1114,1103,665,1114,1105,1168,0,2,503,1114,1103,665,poisson-block-composition
1272,sp_workloads,1690805680,wl_small_mem,1068,mixed:GM-LM-RR-LSVT-SGD-PATE-sub25100-defpa,3,weighted-dpf+,block-composition,poisson,equal-ncd,mixed:GM-LM-RR-LSVT-SGD-PATE,sub25100,nopa,Unlocking,0.2,RandResponseMechanism,{'Optimal': 40},1160,1175,1154,0,14,1154,1160,1161,0,1160,1175,1154,0,14,1154,1160,1161,0,poisson-block-composition
1273,sp_workloads,1690805680,wl_small_mem,1068,mixed:GM-LM-RR-LSVT-SGD-PATE-sub25100-defpa,3,weighted-dpf+,block-composition,poisson,equal-ncd,mixed:GM-LM-RR-LSVT-SGD-PATE,sub25100,nopa,Unlocking,0.2,SVTLaplaceMechanism,{'Optimal': 40},1080,1132,1168,0,288,1168,1080,844,0,1080,1132,1168,0,288,1168,1080,844,0,poisson-block-composition
1274,sp_workloads,1690805680,wl_small_mem,1069,mixed:GM-LM-RR-LSVT-SGD-PATE-sub25100-defpa,3,weighted-dpf+,block-composition,poisson,equal-ncd,mixed:GM-LM-RR-LSVT-SGD-PATE,sub25100,nopa,Unlocking,0.4,GaussianMechanism,{'Optimal': 40},1094,1113,1104,0,0,628,1094,1113,476,1094,1113,1104,0,0,628,1094,1113,476,poisson-block-composition
1275,sp_workloads,1690805680,wl_small_mem,1069,mixed:GM-LM-RR-LSVT-SGD-PATE-sub25100-defpa,3,weighted-dpf+,block-composition,poisson,equal-ncd,mixed:GM-LM-RR-LSVT-SGD-PATE,sub25100,nopa,Unlocking,0.4,LaplaceMechanism,{'Optimal': 40},1169,1154,1119,0,550,1119,1169,604,0,1169,1154,1119,0,550,1119,1169,604,0,poisson-block-composition
1276,sp_workloads,1690805680,wl_small_mem,1069,mixed:GM-LM-RR-LSVT-SGD-PATE-sub25100-defpa,3,weighted-dpf+,block-composition,poisson,equal-ncd,mixed:GM-LM-RR-LSVT-SGD-PATE,sub25100,nopa,Unlocking,0.4,MLNoisySGDMechanism,{'Optimal': 40},1057,1087,1124,0,0,146,1057,1087,978,1057,1087,1124,0,0,146,1057,1087,978,poisson-block-composition
1277,sp_workloads,1690805680,wl_small_mem,1069,mixed:GM-LM-RR-LSVT-SGD-PATE-sub25100-defpa,3,weighted-dpf+,block-composition,poisson,equal-ncd,mixed:GM-LM-RR-LSVT-SGD-PATE,sub25100,nopa,Unlocking,0.4,MLPateGaussianMechanism,{'Optimal': 40},1114,1105,1168,0,4,521,1114,1101,647,1114,1105,1168,0,4,521,1114,1101,647,poisson-block-composition
1278,sp_workloads,1690805680,wl_small_mem,1069,mixed:GM-LM-RR-LSVT-SGD-PATE-sub25100-defpa,3,weighted-dpf+,block-composition,poisson,equal-ncd,mixed:GM-LM-RR-LSVT-SGD-PATE,sub25100,nopa,Unlocking,0.4,RandResponseMechanism,{'Optimal': 40},1160,1175,1154,0,37,1154,1160,1138,0,1160,1175,1154,0,37,1154,1160,1138,0,poisson-block-composition
1279,sp_workloads,1690805680,wl_small_mem,1069,mixed:GM-LM-RR-LSVT-SGD-PATE-sub25100-defpa,3,weighted-dpf+,block-composition,poisson,equal-ncd,mixed:GM-LM-RR-LSVT-SGD-PATE,sub25100,nopa,Unlocking,0.4,SVTLaplaceMechanism,{'Optimal': 40},1080,1132,1168,0,303,1168,1080,829,0,1080,1132,1168,0,303,1168,1080,829,0,poisson-block-composition
1280,sp_workloads,1690805680,wl_small_mem,1070,mixed:GM-LM-RR-LSVT-SGD-PATE-sub25100-defpa,3,weighted-dpf+,block-composition,upc,equal-ncd,mixed:GM-LM-RR-LSVT-SGD-PATE,sub25100,nopa,Unlocking,0.2,GaussianMechanism,{'Optimal': 40},1094,1113,1104,0,66,787,1094,1047,317,1094,1113,1104,0,66,787,1094,1047,317,upc-block-composition
1281,sp_workloads,1690805680,wl_small_mem,1070,mixed:GM-LM-RR-LSVT-SGD-PATE-sub25100-defpa,3,weighted-dpf+,block-composition,upc,equal-ncd,mixed:GM-LM-RR-LSVT-SGD-PATE,sub25100,nopa,Unlocking,0.2,LaplaceMechanism,{'Optimal': 40},1169,1154,1119,0,91,1058,1169,1063,61,1169,1154,1119,0,91,1058,1169,1063,61,upc-block-composition
1282,sp_workloads,1690805680,wl_small_mem,1070,mixed:GM-LM-RR-LSVT-SGD-PATE-sub25100-defpa,3,weighted-dpf+,block-composition,upc,equal-ncd,mixed:GM-LM-RR-LSVT-SGD-PATE,sub25100,nopa,Unlocking,0.2,MLNoisySGDMechanism,{'Optimal': 40},1057,1087,1124,1,39,316,1056,1048,808,1057,1087,1124,1,39,316,1056,1048,808,upc-block-composition
1283,sp_workloads,1690805680,wl_small_mem,1070,mixed:GM-LM-RR-LSVT-SGD-PATE-sub25100-defpa,3,weighted-dpf+,block-composition,upc,equal-ncd,mixed:GM-LM-RR-LSVT-SGD-PATE,sub25100,nopa,Unlocking,0.2,MLPateGaussianMechanism,{'Optimal': 40},1114,1105,1168,0,97,504,1114,1008,664,1114,1105,1168,0,97,504,1114,1008,664,upc-block-composition
1284,sp_workloads,1690805680,wl_small_mem,1070,mixed:GM-LM-RR-LSVT-SGD-PATE-sub25100-defpa,3,weighted-dpf+,block-composition,upc,equal-ncd,mixed:GM-LM-RR-LSVT-SGD-PATE,sub25100,nopa,Unlocking,0.2,RandResponseMechanism,{'Optimal': 40},1160,1175,1154,0,51,1043,1160,1124,111,1160,1175,1154,0,51,1043,1160,1124,111,upc-block-composition
1285,sp_workloads,1690805680,wl_small_mem,1070,mixed:GM-LM-RR-LSVT-SGD-PATE-sub25100-defpa,3,weighted-dpf+,block-composition,upc,equal-ncd,mixed:GM-LM-RR-LSVT-SGD-PATE,sub25100,nopa,Unlocking,0.2,SVTLaplaceMechanism,{'Optimal': 40},1080,1132,1168,0,65,1037,1080,1067,131,1080,1132,1168,0,65,1037,1080,1067,131,upc-block-composition
1286,sp_workloads,1690805680,wl_small_mem,1071,mixed:GM-LM-RR-LSVT-SGD-PATE-sub25100-defpa,3,weighted-dpf+,block-composition,upc,equal-ncd,mixed:GM-LM-RR-LSVT-SGD-PATE,sub25100,nopa,Unlocking,0.4,GaussianMechanism,{'Optimal': 40},1094,1113,1104,0,88,493,1094,1025,611,1094,1113,1104,0,88,493,1094,1025,611,upc-block-composition
1287,sp_workloads,1690805680,wl_small_mem,1071,mixed:GM-LM-RR-LSVT-SGD-PATE-sub25100-defpa,3,weighted-dpf+,block-composition,upc,equal-ncd,mixed:GM-LM-RR-LSVT-SGD-PATE,sub25100,nopa,Unlocking,0.4,LaplaceMechanism,{'Optimal': 40},1169,1154,1119,0,98,1112,1169,1056,7,1169,1154,1119,0,98,1112,1169,1056,7,upc-block-composition
1288,sp_workloads,1690805680,wl_small_mem,1071,mixed:GM-LM-RR-LSVT-SGD-PATE-sub25100-defpa,3,weighted-dpf+,block-composition,upc,equal-ncd,mixed:GM-LM-RR-LSVT-SGD-PATE,sub25100,nopa,Unlocking,0.4,MLNoisySGDMechanism,{'Optimal': 40},1057,1087,1124,4,69,286,1053,1018,838,1057,1087,1124,4,69,286,1053,1018,838,upc-block-composition
1289,sp_workloads,1690805680,wl_small_mem,1071,mixed:GM-LM-RR-LSVT-SGD-PATE-sub25100-defpa,3,weighted-dpf+,block-composition,upc,equal-ncd,mixed:GM-LM-RR-LSVT-SGD-PATE,sub25100,nopa,Unlocking,0.4,MLPateGaussianMechanism,{'Optimal': 40},1114,1105,1168,0,110,354,1114,995,814,1114,1105,1168,0,110,354,1114,995,814,upc-block-composition
1290,sp_workloads,1690805680,wl_small_mem,1071,mixed:GM-LM-RR-LSVT-SGD-PATE-sub25100-defpa,3,weighted-dpf+,block-composition,upc,equal-ncd,mixed:GM-LM-RR-LSVT-SGD-PATE,sub25100,nopa,Unlocking,0.4,RandResponseMechanism,{'Optimal': 40},1160,1175,1154,0,61,1074,1160,1114,80,1160,1175,1154,0,61,1074,1160,1114,80,upc-block-composition
1291,sp_workloads,1690805680,wl_small_mem,1071,mixed:GM-LM-RR-LSVT-SGD-PATE-sub25100-defpa,3,weighted-dpf+,block-composition,upc,equal-ncd,mixed:GM-LM-RR-LSVT-SGD-PATE,sub25100,nopa,Unlocking,0.4,SVTLaplaceMechanism,{'Optimal': 40},1080,1132,1168,0,76,1017,1080,1056,151,1080,1132,1168,0,76,1017,1080,1056,151,upc-block-composition
1292,sp_workloads,1690805680,wl_small_mem,1072,mixed:GM-LM-RR-LSVT-SGD-PATE-sub25100-defpa,4,weighted-dpf+,block-composition,poisson,ncd,mixed:GM-LM-RR-LSVT-SGD-PATE,sub25100,nopa,Unlocking,0.2,GaussianMechanism,{'Optimal': 40},3164159,212016,19356,0,0,3600,3164159,212016,15756,1113,1088,1060,0,0,240,1113,1088,820,poisson-block-composition
1293,sp_workloads,1690805680,wl_small_mem,1072,mixed:GM-LM-RR-LSVT-SGD-PATE-sub25100-defpa,4,weighted-dpf+,block-composition,poisson,ncd,mixed:GM-LM-RR-LSVT-SGD-PATE,sub25100,nopa,Unlocking,0.2,LaplaceMechanism,{'Optimal': 40},2854575,215653,19585,342692,2002,12683,2511883,213651,6902,1062,1115,1087,158,14,709,904,1101,378,poisson-block-composition
1294,sp_workloads,1690805680,wl_small_mem,1072,mixed:GM-LM-RR-LSVT-SGD-PATE-sub25100-defpa,4,weighted-dpf+,block-composition,poisson,ncd,mixed:GM-LM-RR-LSVT-SGD-PATE,sub25100,nopa,Unlocking,0.2,MLNoisySGDMechanism,{'Optimal': 40},3215801,221736,20277,0,0,0,3215801,221736,20277,1144,1128,1131,0,0,0,1144,1128,1131,poisson-block-composition
1295,sp_workloads,1690805680,wl_small_mem,1072,mixed:GM-LM-RR-LSVT-SGD-PATE-sub25100-defpa,4,weighted-dpf+,block-composition,poisson,ncd,mixed:GM-LM-RR-LSVT-SGD-PATE,sub25100,nopa,Unlocking,0.2,MLPateGaussianMechanism,{'Optimal': 40},3246364,219077,18914,0,0,210,3246364,219077,18704,1154,1099,1070,0,0,14,1154,1099,1056,poisson-block-composition
1296,sp_workloads,1690805680,wl_small_mem,1072,mixed:GM-LM-RR-LSVT-SGD-PATE-sub25100-defpa,4,weighted-dpf+,block-composition,poisson,ncd,mixed:GM-LM-RR-LSVT-SGD-PATE,sub25100,nopa,Unlocking,0.2,RandResponseMechanism,{'Optimal': 40},3086084,218125,20774,48036,0,12209,3038048,218125,8565,1149,1123,1162,22,0,687,1127,1123,475,poisson-block-composition
1297,sp_workloads,1690805680,wl_small_mem,1072,mixed:GM-LM-RR-LSVT-SGD-PATE-sub25100-defpa,4,weighted-dpf+,block-composition,poisson,ncd,mixed:GM-LM-RR-LSVT-SGD-PATE,sub25100,nopa,Unlocking,0.2,SVTLaplaceMechanism,{'Optimal': 40},3076541,223346,21123,49188,143,11740,3027353,223203,9383,1073,1134,1197,22,1,692,1051,1133,505,poisson-block-composition
1298,sp_workloads,1690805680,wl_small_mem,1073,mixed:GM-LM-RR-LSVT-SGD-PATE-sub25100-defpa,4,weighted-dpf+,block-composition,poisson,ncd,mixed:GM-LM-RR-LSVT-SGD-PATE,sub25100,nopa,Unlocking,0.4,GaussianMechanism,{'Optimal': 40},3164159,212016,19356,0,0,4140,3164159,212016,15216,1113,1088,1060,0,0,276,1113,1088,784,poisson-block-composition
1299,sp_workloads,1690805680,wl_small_mem,1073,mixed:GM-LM-RR-LSVT-SGD-PATE-sub25100-defpa,4,weighted-dpf+,block-composition,poisson,ncd,mixed:GM-LM-RR-LSVT-SGD-PATE,sub25100,nopa,Unlocking,0.4,LaplaceMechanism,{'Optimal': 40},2854575,215653,19585,326963,3289,12774,2527612,212364,6811,1062,1115,1087,151,23,698,911,1092,389,poisson-block-composition
1300,sp_workloads,1690805680,wl_small_mem,1073,mixed:GM-LM-RR-LSVT-SGD-PATE-sub25100-defpa,4,weighted-dpf+,block-composition,poisson,ncd,mixed:GM-LM-RR-LSVT-SGD-PATE,sub25100,nopa,Unlocking,0.4,MLNoisySGDMechanism,{'Optimal': 40},3215801,221736,20277,0,0,0,3215801,221736,20277,1144,1128,1131,0,0,0,1144,1128,1131,poisson-block-composition
1301,sp_workloads,1690805680,wl_small_mem,1073,mixed:GM-LM-RR-LSVT-SGD-PATE-sub25100-defpa,4,weighted-dpf+,block-composition,poisson,ncd,mixed:GM-LM-RR-LSVT-SGD-PATE,sub25100,nopa,Unlocking,0.4,MLPateGaussianMechanism,{'Optimal': 40},3246364,219077,18914,0,0,165,3246364,219077,18749,1154,1099,1070,0,0,11,1154,1099,1059,poisson-block-composition
1302,sp_workloads,1690805680,wl_small_mem,1073,mixed:GM-LM-RR-LSVT-SGD-PATE-sub25100-defpa,4,weighted-dpf+,block-composition,poisson,ncd,mixed:GM-LM-RR-LSVT-SGD-PATE,sub25100,nopa,Unlocking,0.4,RandResponseMechanism,{'Optimal': 40},3086084,218125,20774,53790,0,12562,3032294,218125,8212,1149,1123,1162,25,0,702,1124,1123,460,poisson-block-composition
1303,sp_workloads,1690805680,wl_small_mem,1073,mixed:GM-LM-RR-LSVT-SGD-PATE-sub25100-defpa,4,weighted-dpf+,block-composition,poisson,ncd,mixed:GM-LM-RR-LSVT-SGD-PATE,sub25100,nopa,Unlocking,0.4,SVTLaplaceMechanism,{'Optimal': 40},3076541,223346,21123,58124,0,11206,3018417,223346,9917,1073,1134,1197,26,0,666,1047,1134,531,poisson-block-composition
1304,sp_workloads,1690805680,wl_small_mem,1074,mixed:GM-LM-RR-LSVT-SGD-PATE-sub25100-defpa,4,weighted-dpf+,block-composition,upc,ncd,mixed:GM-LM-RR-LSVT-SGD-PATE,sub25100,nopa,Unlocking,0.2,GaussianMechanism,{'Optimal': 40},3153220,205905,19356,0,3952,2130,3153220,201953,17226,1113,1088,1060,0,48,142,1113,1040,918,upc-block-composition
1305,sp_workloads,1690805680,wl_small_mem,1074,mixed:GM-LM-RR-LSVT-SGD-PATE-sub25100-defpa,4,weighted-dpf+,block-composition,upc,ncd,mixed:GM-LM-RR-LSVT-SGD-PATE,sub25100,nopa,Unlocking,0.2,LaplaceMechanism,{'Optimal': 40},2793843,215187,19457,62884,2185,8636,2730959,213002,10821,1062,1115,1087,21,23,452,1041,1092,635,upc-block-composition
1306,sp_workloads,1690805680,wl_small_mem,1074,mixed:GM-LM-RR-LSVT-SGD-PATE-sub25100-defpa,4,weighted-dpf+,block-composition,upc,ncd,mixed:GM-LM-RR-LSVT-SGD-PATE,sub25100,nopa,Unlocking,0.2,MLNoisySGDMechanism,{'Optimal': 40},3134809,228778,20357,30,2810,1875,3134779,225968,18482,1144,1128,1131,2,38,125,1142,1090,1006,upc-block-composition
1307,sp_workloads,1690805680,wl_small_mem,1074,mixed:GM-LM-RR-LSVT-SGD-PATE-sub25100-defpa,4,weighted-dpf+,block-composition,upc,ncd,mixed:GM-LM-RR-LSVT-SGD-PATE,sub25100,nopa,Unlocking,0.2,MLPateGaussianMechanism,{'Optimal': 40},3244641,218308,19042,0,5639,2325,3244641,212669,16717,1154,1099,1070,0,57,155,1154,1042,915,upc-block-composition
1308,sp_workloads,1690805680,wl_small_mem,1074,mixed:GM-LM-RR-LSVT-SGD-PATE-sub25100-defpa,4,weighted-dpf+,block-composition,upc,ncd,mixed:GM-LM-RR-LSVT-SGD-PATE,sub25100,nopa,Unlocking,0.2,RandResponseMechanism,{'Optimal': 40},3229961,212087,20918,46912,3023,7982,3183049,209064,12936,1149,1123,1162,13,33,434,1136,1090,728,upc-block-composition
1309,sp_workloads,1690805680,wl_small_mem,1074,mixed:GM-LM-RR-LSVT-SGD-PATE-sub25100-defpa,4,weighted-dpf+,block-composition,upc,ncd,mixed:GM-LM-RR-LSVT-SGD-PATE,sub25100,nopa,Unlocking,0.2,SVTLaplaceMechanism,{'Optimal': 40},3098261,219430,21459,18292,1701,6393,3079969,217729,15066,1073,1134,1197,9,27,391,1064,1107,806,upc-block-composition
1310,sp_workloads,1690805680,wl_small_mem,1075,mixed:GM-LM-RR-LSVT-SGD-PATE-sub25100-defpa,4,weighted-dpf+,block-composition,upc,ncd,mixed:GM-LM-RR-LSVT-SGD-PATE,sub25100,nopa,Unlocking,0.4,GaussianMechanism,{'Optimal': 40},3153220,205905,19356,0,5035,4844,3153220,200870,14512,1113,1088,1060,0,53,308,1113,1035,752,upc-block-composition
1311,sp_workloads,1690805680,wl_small_mem,1075,mixed:GM-LM-RR-LSVT-SGD-PATE-sub25100-defpa,4,weighted-dpf+,block-composition,upc,ncd,mixed:GM-LM-RR-LSVT-SGD-PATE,sub25100,nopa,Unlocking,0.4,LaplaceMechanism,{'Optimal': 40},2793843,215187,19457,56634,8427,14684,2737209,206760,4773,1062,1115,1087,11,54,804,1051,1061,283,upc-block-composition
1312,sp_workloads,1690805680,wl_small_mem,1075,mixed:GM-LM-RR-LSVT-SGD-PATE-sub25100-defpa,4,weighted-dpf+,block-composition,upc,ncd,mixed:GM-LM-RR-LSVT-SGD-PATE,sub25100,nopa,Unlocking,0.4,MLNoisySGDMechanism,{'Optimal': 40},3134809,228778,20357,1065,4322,3708,3133744,224456,16649,1144,1128,1131,2,46,244,1142,1082,887,upc-block-composition
1313,sp_workloads,1690805680,wl_small_mem,1075,mixed:GM-LM-RR-LSVT-SGD-PATE-sub25100-defpa,4,weighted-dpf+,block-composition,upc,ncd,mixed:GM-LM-RR-LSVT-SGD-PATE,sub25100,nopa,Unlocking,0.4,MLPateGaussianMechanism,{'Optimal': 40},3244641,218308,19042,0,6427,4157,3244641,211881,14885,1154,1099,1070,0,66,275,1154,1033,795,upc-block-composition
1314,sp_workloads,1690805680,wl_small_mem,1075,mixed:GM-LM-RR-LSVT-SGD-PATE-sub25100-defpa,4,weighted-dpf+,block-composition,upc,ncd,mixed:GM-LM-RR-LSVT-SGD-PATE,sub25100,nopa,Unlocking,0.4,RandResponseMechanism,{'Optimal': 40},3229961,212087,20918,12742,3868,13971,3217219,208219,6947,1149,1123,1162,3,36,749,1146,1087,413,upc-block-composition
1315,sp_workloads,1690805680,wl_small_mem,1075,mixed:GM-LM-RR-LSVT-SGD-PATE-sub25100-defpa,4,weighted-dpf+,block-composition,upc,ncd,mixed:GM-LM-RR-LSVT-SGD-PATE,sub25100,nopa,Unlocking,0.4,SVTLaplaceMechanism,{'Optimal': 40},3098261,219430,21459,16972,5533,13202,3081289,213897,8257,1073,1134,1197,9,45,718,1064,1089,479,upc-block-composition
1316,sp_workloads,1690805680,wl_small_mem,1076,mixed:GM-LM-RR-LSVT-SGD-PATE-sub25100-defpa,4,weighted-dpf+,block-composition,poisson,equal-ncd,mixed:GM-LM-RR-LSVT-SGD-PATE,sub25100,nopa,Unlocking,0.2,GaussianMechanism,{'Optimal': 40},1113,1088,1060,0,0,558,1113,1088,502,1113,1088,1060,0,0,558,1113,1088,502,poisson-block-composition
1317,sp_workloads,1690805680,wl_small_mem,1076,mixed:GM-LM-RR-LSVT-SGD-PATE-sub25100-defpa,4,weighted-dpf+,block-composition,poisson,equal-ncd,mixed:GM-LM-RR-LSVT-SGD-PATE,sub25100,nopa,Unlocking,0.2,LaplaceMechanism,{'Optimal': 40},1062,1115,1087,0,559,1087,1062,556,0,1062,1115,1087,0,559,1087,1062,556,0,poisson-block-composition
1318,sp_workloads,1690805680,wl_small_mem,1076,mixed:GM-LM-RR-LSVT-SGD-PATE-sub25100-defpa,4,weighted-dpf+,block-composition,poisson,equal-ncd,mixed:GM-LM-RR-LSVT-SGD-PATE,sub25100,nopa,Unlocking,0.2,MLNoisySGDMechanism,{'Optimal': 40},1144,1128,1131,0,0,150,1144,1128,981,1144,1128,1131,0,0,150,1144,1128,981,poisson-block-composition
1319,sp_workloads,1690805680,wl_small_mem,1076,mixed:GM-LM-RR-LSVT-SGD-PATE-sub25100-defpa,4,weighted-dpf+,block-composition,poisson,equal-ncd,mixed:GM-LM-RR-LSVT-SGD-PATE,sub25100,nopa,Unlocking,0.2,MLPateGaussianMechanism,{'Optimal': 40},1154,1099,1070,0,1,447,1154,1098,623,1154,1099,1070,0,1,447,1154,1098,623,poisson-block-composition
1320,sp_workloads,1690805680,wl_small_mem,1076,mixed:GM-LM-RR-LSVT-SGD-PATE-sub25100-defpa,4,weighted-dpf+,block-composition,poisson,equal-ncd,mixed:GM-LM-RR-LSVT-SGD-PATE,sub25100,nopa,Unlocking,0.2,RandResponseMechanism,{'Optimal': 40},1149,1123,1162,0,21,1162,1149,1102,0,1149,1123,1162,0,21,1162,1149,1102,0,poisson-block-composition
1321,sp_workloads,1690805680,wl_small_mem,1076,mixed:GM-LM-RR-LSVT-SGD-PATE-sub25100-defpa,4,weighted-dpf+,block-composition,poisson,equal-ncd,mixed:GM-LM-RR-LSVT-SGD-PATE,sub25100,nopa,Unlocking,0.2,SVTLaplaceMechanism,{'Optimal': 40},1073,1134,1197,0,288,1197,1073,846,0,1073,1134,1197,0,288,1197,1073,846,0,poisson-block-composition
1322,sp_workloads,1690805680,wl_small_mem,1077,mixed:GM-LM-RR-LSVT-SGD-PATE-sub25100-defpa,4,weighted-dpf+,block-composition,poisson,equal-ncd,mixed:GM-LM-RR-LSVT-SGD-PATE,sub25100,nopa,Unlocking,0.4,GaussianMechanism,{'Optimal': 40},1113,1088,1060,0,0,570,1113,1088,490,1113,1088,1060,0,0,570,1113,1088,490,poisson-block-composition
1323,sp_workloads,1690805680,wl_small_mem,1077,mixed:GM-LM-RR-LSVT-SGD-PATE-sub25100-defpa,4,weighted-dpf+,block-composition,poisson,equal-ncd,mixed:GM-LM-RR-LSVT-SGD-PATE,sub25100,nopa,Unlocking,0.4,LaplaceMechanism,{'Optimal': 40},1062,1115,1087,0,522,1087,1062,593,0,1062,1115,1087,0,522,1087,1062,593,0,poisson-block-composition
1324,sp_workloads,1690805680,wl_small_mem,1077,mixed:GM-LM-RR-LSVT-SGD-PATE-sub25100-defpa,4,weighted-dpf+,block-composition,poisson,equal-ncd,mixed:GM-LM-RR-LSVT-SGD-PATE,sub25100,nopa,Unlocking,0.4,MLNoisySGDMechanism,{'Optimal': 40},1144,1128,1131,0,0,136,1144,1128,995,1144,1128,1131,0,0,136,1144,1128,995,poisson-block-composition
1325,sp_workloads,1690805680,wl_small_mem,1077,mixed:GM-LM-RR-LSVT-SGD-PATE-sub25100-defpa,4,weighted-dpf+,block-composition,poisson,equal-ncd,mixed:GM-LM-RR-LSVT-SGD-PATE,sub25100,nopa,Unlocking,0.4,MLPateGaussianMechanism,{'Optimal': 40},1154,1099,1070,0,3,488,1154,1096,582,1154,1099,1070,0,3,488,1154,1096,582,poisson-block-composition
1326,sp_workloads,1690805680,wl_small_mem,1077,mixed:GM-LM-RR-LSVT-SGD-PATE-sub25100-defpa,4,weighted-dpf+,block-composition,poisson,equal-ncd,mixed:GM-LM-RR-LSVT-SGD-PATE,sub25100,nopa,Unlocking,0.4,RandResponseMechanism,{'Optimal': 40},1149,1123,1162,0,68,1162,1149,1055,0,1149,1123,1162,0,68,1162,1149,1055,0,poisson-block-composition
1327,sp_workloads,1690805680,wl_small_mem,1077,mixed:GM-LM-RR-LSVT-SGD-PATE-sub25100-defpa,4,weighted-dpf+,block-composition,poisson,equal-ncd,mixed:GM-LM-RR-LSVT-SGD-PATE,sub25100,nopa,Unlocking,0.4,SVTLaplaceMechanism,{'Optimal': 40},1073,1134,1197,0,285,1197,1073,849,0,1073,1134,1197,0,285,1197,1073,849,0,poisson-block-composition
1328,sp_workloads,1690805680,wl_small_mem,1078,mixed:GM-LM-RR-LSVT-SGD-PATE-sub25100-defpa,4,weighted-dpf+,block-composition,upc,equal-ncd,mixed:GM-LM-RR-LSVT-SGD-PATE,sub25100,nopa,Unlocking,0.2,GaussianMechanism,{'Optimal': 40},1113,1088,1060,0,73,774,1113,1015,286,1113,1088,1060,0,73,774,1113,1015,286,upc-block-composition
1329,sp_workloads,1690805680,wl_small_mem,1078,mixed:GM-LM-RR-LSVT-SGD-PATE-sub25100-defpa,4,weighted-dpf+,block-composition,upc,equal-ncd,mixed:GM-LM-RR-LSVT-SGD-PATE,sub25100,nopa,Unlocking,0.2,LaplaceMechanism,{'Optimal': 40},1062,1115,1087,0,65,1044,1062,1050,43,1062,1115,1087,0,65,1044,1062,1050,43,upc-block-composition
1330,sp_workloads,1690805680,wl_small_mem,1078,mixed:GM-LM-RR-LSVT-SGD-PATE-sub25100-defpa,4,weighted-dpf+,block-composition,upc,equal-ncd,mixed:GM-LM-RR-LSVT-SGD-PATE,sub25100,nopa,Unlocking,0.2,MLNoisySGDMechanism,{'Optimal': 40},1144,1128,1131,1,49,335,1143,1079,796,1144,1128,1131,1,49,335,1143,1079,796,upc-block-composition
1331,sp_workloads,1690805680,wl_small_mem,1078,mixed:GM-LM-RR-LSVT-SGD-PATE-sub25100-defpa,4,weighted-dpf+,block-composition,upc,equal-ncd,mixed:GM-LM-RR-LSVT-SGD-PATE,sub25100,nopa,Unlocking,0.2,MLPateGaussianMechanism,{'Optimal': 40},1154,1099,1070,0,107,482,1154,992,588,1154,1099,1070,0,107,482,1154,992,588,upc-block-composition
1332,sp_workloads,1690805680,wl_small_mem,1078,mixed:GM-LM-RR-LSVT-SGD-PATE-sub25100-defpa,4,weighted-dpf+,block-composition,upc,equal-ncd,mixed:GM-LM-RR-LSVT-SGD-PATE,sub25100,nopa,Unlocking,0.2,RandResponseMechanism,{'Optimal': 40},1149,1123,1162,0,69,1084,1149,1054,78,1149,1123,1162,0,69,1084,1149,1054,78,upc-block-composition
1333,sp_workloads,1690805680,wl_small_mem,1078,mixed:GM-LM-RR-LSVT-SGD-PATE-sub25100-defpa,4,weighted-dpf+,block-composition,upc,equal-ncd,mixed:GM-LM-RR-LSVT-SGD-PATE,sub25100,nopa,Unlocking,0.2,SVTLaplaceMechanism,{'Optimal': 40},1073,1134,1197,0,61,1135,1073,1073,62,1073,1134,1197,0,61,1135,1073,1073,62,upc-block-composition
1334,sp_workloads,1690805680,wl_small_mem,1079,mixed:GM-LM-RR-LSVT-SGD-PATE-sub25100-defpa,4,weighted-dpf+,block-composition,upc,equal-ncd,mixed:GM-LM-RR-LSVT-SGD-PATE,sub25100,nopa,Unlocking,0.4,GaussianMechanism,{'Optimal': 40},1113,1088,1060,0,90,454,1113,998,606,1113,1088,1060,0,90,454,1113,998,606,upc-block-composition
1335,sp_workloads,1690805680,wl_small_mem,1079,mixed:GM-LM-RR-LSVT-SGD-PATE-sub25100-defpa,4,weighted-dpf+,block-composition,upc,equal-ncd,mixed:GM-LM-RR-LSVT-SGD-PATE,sub25100,nopa,Unlocking,0.4,LaplaceMechanism,{'Optimal': 40},1062,1115,1087,0,85,1051,1062,1030,36,1062,1115,1087,0,85,1051,1062,1030,36,upc-block-composition
1336,sp_workloads,1690805680,wl_small_mem,1079,mixed:GM-LM-RR-LSVT-SGD-PATE-sub25100-defpa,4,weighted-dpf+,block-composition,upc,equal-ncd,mixed:GM-LM-RR-LSVT-SGD-PATE,sub25100,nopa,Unlocking,0.4,MLNoisySGDMechanism,{'Optimal': 40},1144,1128,1131,1,74,301,1143,1054,830,1144,1128,1131,1,74,301,1143,1054,830,upc-block-composition
1337,sp_workloads,1690805680,wl_small_mem,1079,mixed:GM-LM-RR-LSVT-SGD-PATE-sub25100-defpa,4,weighted-dpf+,block-composition,upc,equal-ncd,mixed:GM-LM-RR-LSVT-SGD-PATE,sub25100,nopa,Unlocking,0.4,MLPateGaussianMechanism,{'Optimal': 40},1154,1099,1070,0,159,331,1154,940,739,1154,1099,1070,0,159,331,1154,940,739,upc-block-composition
1338,sp_workloads,1690805680,wl_small_mem,1079,mixed:GM-LM-RR-LSVT-SGD-PATE-sub25100-defpa,4,weighted-dpf+,block-composition,upc,equal-ncd,mixed:GM-LM-RR-LSVT-SGD-PATE,sub25100,nopa,Unlocking,0.4,RandResponseMechanism,{'Optimal': 40},1149,1123,1162,1,63,1113,1148,1060,49,1149,1123,1162,1,63,1113,1148,1060,49,upc-block-composition
1339,sp_workloads,1690805680,wl_small_mem,1079,mixed:GM-LM-RR-LSVT-SGD-PATE-sub25100-defpa,4,weighted-dpf+,block-composition,upc,equal-ncd,mixed:GM-LM-RR-LSVT-SGD-PATE,sub25100,nopa,Unlocking,0.4,SVTLaplaceMechanism,{'Optimal': 40},1073,1134,1197,0,69,1090,1073,1065,107,1073,1134,1197,0,69,1090,1073,1065,107,upc-block-composition
1340,sp_workloads,1690805680,wl_small_mem,1080,basic:GM-LM-RR-LSVT-sub25100-defpa,0,weighted-dpf+,block-composition,poisson,ncd,basic:GM-LM-RR-LSVT,sub25100,nopa,Unlocking,0.2,GaussianMechanism,{'Optimal': 40},4847751,317174,28905,0,0,3855,4847751,317174,25050,1760,1618,1607,0,0,257,1760,1618,1350,poisson-block-composition
1341,sp_workloads,1690805680,wl_small_mem,1080,basic:GM-LM-RR-LSVT-sub25100-defpa,0,weighted-dpf+,block-composition,poisson,ncd,basic:GM-LM-RR-LSVT,sub25100,nopa,Unlocking,0.2,LaplaceMechanism,{'Optimal': 40},4580618,310999,29482,394627,1529,18206,4185991,309470,11276,1690,1679,1654,184,11,1026,1506,1668,628,poisson-block-composition
1342,sp_workloads,1690805680,wl_small_mem,1080,basic:GM-LM-RR-LSVT-sub25100-defpa,0,weighted-dpf+,block-composition,poisson,ncd,basic:GM-LM-RR-LSVT,sub25100,nopa,Unlocking,0.2,RandResponseMechanism,{'Optimal': 40},4834309,320190,30099,30542,0,17638,4803767,320190,12461,1752,1677,1693,8,0,1002,1744,1677,691,poisson-block-composition
1343,sp_workloads,1690805680,wl_small_mem,1080,basic:GM-LM-RR-LSVT-sub25100-defpa,0,weighted-dpf+,block-composition,poisson,ncd,basic:GM-LM-RR-LSVT,sub25100,nopa,Unlocking,0.2,SVTLaplaceMechanism,{'Optimal': 40},4502539,307841,30348,15239,556,15887,4487300,307285,14461,1685,1652,1684,7,4,929,1678,1648,755,poisson-block-composition
1344,sp_workloads,1690805680,wl_small_mem,1081,basic:GM-LM-RR-LSVT-sub25100-defpa,0,weighted-dpf+,block-composition,poisson,ncd,basic:GM-LM-RR-LSVT,sub25100,nopa,Unlocking,0.4,GaussianMechanism,{'Optimal': 40},4847751,317174,28905,0,0,3540,4847751,317174,25365,1760,1618,1607,0,0,236,1760,1618,1371,poisson-block-composition
1345,sp_workloads,1690805680,wl_small_mem,1081,basic:GM-LM-RR-LSVT-sub25100-defpa,0,weighted-dpf+,block-composition,poisson,ncd,basic:GM-LM-RR-LSVT,sub25100,nopa,Unlocking,0.4,LaplaceMechanism,{'Optimal': 40},4580618,310999,29482,414111,1390,18709,4166507,309609,10773,1690,1679,1654,194,10,1035,1496,1669,619,poisson-block-composition
1346,sp_workloads,1690805680,wl_small_mem,1081,basic:GM-LM-RR-LSVT-sub25100-defpa,0,weighted-dpf+,block-composition,poisson,ncd,basic:GM-LM-RR-LSVT,sub25100,nopa,Unlocking,0.4,RandResponseMechanism,{'Optimal': 40},4834309,320190,30099,15239,0,15577,4819070,320190,14522,1752,1677,1693,7,0,935,1745,1677,758,poisson-block-composition
1347,sp_workloads,1690805680,wl_small_mem,1081,basic:GM-LM-RR-LSVT-sub25100-defpa,0,weighted-dpf+,block-composition,poisson,ncd,basic:GM-LM-RR-LSVT,sub25100,nopa,Unlocking,0.4,SVTLaplaceMechanism,{'Optimal': 40},4502539,307841,30348,34832,417,13822,4467707,307424,16526,1685,1652,1684,16,3,882,1669,1649,802,poisson-block-composition
1348,sp_workloads,1690805680,wl_small_mem,1082,basic:GM-LM-RR-LSVT-sub25100-defpa,0,weighted-dpf+,block-composition,upc,ncd,basic:GM-LM-RR-LSVT,sub25100,nopa,Unlocking,0.2,GaussianMechanism,{'Optimal': 40},4839540,325950,29705,0,3932,2295,4839540,322018,27410,1760,1618,1607,0,51,153,1760,1567,1454,upc-block-composition
1349,sp_workloads,1690805680,wl_small_mem,1082,basic:GM-LM-RR-LSVT-sub25100-defpa,0,weighted-dpf+,block-composition,upc,ncd,basic:GM-LM-RR-LSVT,sub25100,nopa,Unlocking,0.2,LaplaceMechanism,{'Optimal': 40},4568749,317398,30234,82236,2816,8423,4486513,314582,21811,1690,1679,1654,23,28,473,1667,1651,1181,upc-block-composition
1350,sp_workloads,1690805680,wl_small_mem,1082,basic:GM-LM-RR-LSVT-sub25100-defpa,0,weighted-dpf+,block-composition,upc,ncd,basic:GM-LM-RR-LSVT,sub25100,nopa,Unlocking,0.2,RandResponseMechanism,{'Optimal': 40},4657750,323549,30931,34979,2815,10029,4622771,320734,20902,1752,1677,1693,18,28,547,1734,1649,1146,upc-block-composition
1351,sp_workloads,1690805680,wl_small_mem,1082,basic:GM-LM-RR-LSVT-sub25100-defpa,0,weighted-dpf+,block-composition,upc,ncd,basic:GM-LM-RR-LSVT,sub25100,nopa,Unlocking,0.2,SVTLaplaceMechanism,{'Optimal': 40},4659614,324927,30284,28701,2798,6482,4630913,322129,23802,1685,1652,1684,14,28,430,1671,1624,1254,upc-block-composition
1352,sp_workloads,1690805680,wl_small_mem,1083,basic:GM-LM-RR-LSVT-sub25100-defpa,0,weighted-dpf+,block-composition,upc,ncd,basic:GM-LM-RR-LSVT,sub25100,nopa,Unlocking,0.4,GaussianMechanism,{'Optimal': 40},4839540,325950,29705,0,8563,6753,4839540,317387,22952,1760,1618,1607,0,102,431,1760,1516,1176,upc-block-composition
1353,sp_workloads,1690805680,wl_small_mem,1083,basic:GM-LM-RR-LSVT-sub25100-defpa,0,weighted-dpf+,block-composition,upc,ncd,basic:GM-LM-RR-LSVT,sub25100,nopa,Unlocking,0.4,LaplaceMechanism,{'Optimal': 40},4568749,317398,30234,58854,6400,19762,4509895,310998,10472,1690,1679,1654,12,56,1022,1678,1623,632,upc-block-composition
1354,sp_workloads,1690805680,wl_small_mem,1083,basic:GM-LM-RR-LSVT-sub25100-defpa,0,weighted-dpf+,block-composition,upc,ncd,basic:GM-LM-RR-LSVT,sub25100,nopa,Unlocking,0.4,RandResponseMechanism,{'Optimal': 40},4657750,323549,30931,10793,4491,17795,4646957,319058,13136,1752,1677,1693,6,40,941,1746,1637,752,upc-block-composition
1355,sp_workloads,1690805680,wl_small_mem,1083,basic:GM-LM-RR-LSVT-sub25100-defpa,0,weighted-dpf+,block-composition,upc,ncd,basic:GM-LM-RR-LSVT,sub25100,nopa,Unlocking,0.4,SVTLaplaceMechanism,{'Optimal': 40},4659614,324927,30284,12666,8034,15340,4646948,316893,14944,1685,1652,1684,7,59,852,1678,1593,832,upc-block-composition
1356,sp_workloads,1690805680,wl_small_mem,1084,basic:GM-LM-RR-LSVT-sub25100-defpa,0,weighted-dpf+,block-composition,poisson,equal-ncd,basic:GM-LM-RR-LSVT,sub25100,nopa,Unlocking,0.2,GaussianMechanism,{'Optimal': 40},1760,1618,1607,0,2,818,1760,1616,789,1760,1618,1607,0,2,818,1760,1616,789,poisson-block-composition
1357,sp_workloads,1690805680,wl_small_mem,1084,basic:GM-LM-RR-LSVT-sub25100-defpa,0,weighted-dpf+,block-composition,poisson,equal-ncd,basic:GM-LM-RR-LSVT,sub25100,nopa,Unlocking,0.2,LaplaceMechanism,{'Optimal': 40},1690,1679,1654,0,740,1654,1690,939,0,1690,1679,1654,0,740,1654,1690,939,0,poisson-block-composition
1358,sp_workloads,1690805680,wl_small_mem,1084,basic:GM-LM-RR-LSVT-sub25100-defpa,0,weighted-dpf+,block-composition,poisson,equal-ncd,basic:GM-LM-RR-LSVT,sub25100,nopa,Unlocking,0.2,RandResponseMechanism,{'Optimal': 40},1752,1677,1693,0,0,1693,1752,1677,0,1752,1677,1693,0,0,1693,1752,1677,0,poisson-block-composition
1359,sp_workloads,1690805680,wl_small_mem,1084,basic:GM-LM-RR-LSVT-sub25100-defpa,0,weighted-dpf+,block-composition,poisson,equal-ncd,basic:GM-LM-RR-LSVT,sub25100,nopa,Unlocking,0.2,SVTLaplaceMechanism,{'Optimal': 40},1685,1652,1684,0,103,1684,1685,1549,0,1685,1652,1684,0,103,1684,1685,1549,0,poisson-block-composition
1360,sp_workloads,1690805680,wl_small_mem,1085,basic:GM-LM-RR-LSVT-sub25100-defpa,0,weighted-dpf+,block-composition,poisson,equal-ncd,basic:GM-LM-RR-LSVT,sub25100,nopa,Unlocking,0.4,GaussianMechanism,{'Optimal': 40},1760,1618,1607,0,5,833,1760,1613,774,1760,1618,1607,0,5,833,1760,1613,774,poisson-block-composition
1361,sp_workloads,1690805680,wl_small_mem,1085,basic:GM-LM-RR-LSVT-sub25100-defpa,0,weighted-dpf+,block-composition,poisson,equal-ncd,basic:GM-LM-RR-LSVT,sub25100,nopa,Unlocking,0.4,LaplaceMechanism,{'Optimal': 40},1690,1679,1654,0,566,1654,1690,1113,0,1690,1679,1654,0,566,1654,1690,1113,0,poisson-block-composition
1362,sp_workloads,1690805680,wl_small_mem,1085,basic:GM-LM-RR-LSVT-sub25100-defpa,0,weighted-dpf+,block-composition,poisson,equal-ncd,basic:GM-LM-RR-LSVT,sub25100,nopa,Unlocking,0.4,RandResponseMechanism,{'Optimal': 40},1752,1677,1693,0,0,1693,1752,1677,0,1752,1677,1693,0,0,1693,1752,1677,0,poisson-block-composition
1363,sp_workloads,1690805680,wl_small_mem,1085,basic:GM-LM-RR-LSVT-sub25100-defpa,0,weighted-dpf+,block-composition,poisson,equal-ncd,basic:GM-LM-RR-LSVT,sub25100,nopa,Unlocking,0.4,SVTLaplaceMechanism,{'Optimal': 40},1685,1652,1684,0,232,1684,1685,1420,0,1685,1652,1684,0,232,1684,1685,1420,0,poisson-block-composition
1364,sp_workloads,1690805680,wl_small_mem,1086,basic:GM-LM-RR-LSVT-sub25100-defpa,0,weighted-dpf+,block-composition,upc,equal-ncd,basic:GM-LM-RR-LSVT,sub25100,nopa,Unlocking,0.2,GaussianMechanism,{'Optimal': 40},1760,1618,1607,0,87,654,1760,1531,953,1760,1618,1607,0,87,654,1760,1531,953,upc-block-composition
1365,sp_workloads,1690805680,wl_small_mem,1086,basic:GM-LM-RR-LSVT-sub25100-defpa,0,weighted-dpf+,block-composition,upc,equal-ncd,basic:GM-LM-RR-LSVT,sub25100,nopa,Unlocking,0.2,LaplaceMechanism,{'Optimal': 40},1690,1679,1654,0,84,1493,1690,1595,161,1690,1679,1654,0,84,1493,1690,1595,161,upc-block-composition
1366,sp_workloads,1690805680,wl_small_mem,1086,basic:GM-LM-RR-LSVT-sub25100-defpa,0,weighted-dpf+,block-composition,upc,equal-ncd,basic:GM-LM-RR-LSVT,sub25100,nopa,Unlocking,0.2,RandResponseMechanism,{'Optimal': 40},1752,1677,1693,0,63,1497,1752,1614,196,1752,1677,1693,0,63,1497,1752,1614,196,upc-block-composition
1367,sp_workloads,1690805680,wl_small_mem,1086,basic:GM-LM-RR-LSVT-sub25100-defpa,0,weighted-dpf+,block-composition,upc,equal-ncd,basic:GM-LM-RR-LSVT,sub25100,nopa,Unlocking,0.2,SVTLaplaceMechanism,{'Optimal': 40},1685,1652,1684,0,73,1484,1685,1579,200,1685,1652,1684,0,73,1484,1685,1579,200,upc-block-composition
1368,sp_workloads,1690805680,wl_small_mem,1087,basic:GM-LM-RR-LSVT-sub25100-defpa,0,weighted-dpf+,block-composition,upc,equal-ncd,basic:GM-LM-RR-LSVT,sub25100,nopa,Unlocking,0.4,GaussianMechanism,{'Optimal': 40},1760,1618,1607,1,224,842,1759,1394,765,1760,1618,1607,1,224,842,1759,1394,765,upc-block-composition
1369,sp_workloads,1690805680,wl_small_mem,1087,basic:GM-LM-RR-LSVT-sub25100-defpa,0,weighted-dpf+,block-composition,upc,equal-ncd,basic:GM-LM-RR-LSVT,sub25100,nopa,Unlocking,0.4,LaplaceMechanism,{'Optimal': 40},1690,1679,1654,0,64,1634,1690,1615,20,1690,1679,1654,0,64,1634,1690,1615,20,upc-block-composition
1370,sp_workloads,1690805680,wl_small_mem,1087,basic:GM-LM-RR-LSVT-sub25100-defpa,0,weighted-dpf+,block-composition,upc,equal-ncd,basic:GM-LM-RR-LSVT,sub25100,nopa,Unlocking,0.4,RandResponseMechanism,{'Optimal': 40},1752,1677,1693,0,48,1627,1752,1629,66,1752,1677,1693,0,48,1627,1752,1629,66,upc-block-composition
1371,sp_workloads,1690805680,wl_small_mem,1087,basic:GM-LM-RR-LSVT-sub25100-defpa,0,weighted-dpf+,block-composition,upc,equal-ncd,basic:GM-LM-RR-LSVT,sub25100,nopa,Unlocking,0.4,SVTLaplaceMechanism,{'Optimal': 40},1685,1652,1684,0,76,1572,1685,1576,112,1685,1652,1684,0,76,1572,1685,1576,112,upc-block-composition
1372,sp_workloads,1690805680,wl_small_mem,1088,basic:GM-LM-RR-LSVT-sub25100-defpa,1,weighted-dpf+,block-composition,poisson,ncd,basic:GM-LM-RR-LSVT,sub25100,nopa,Unlocking,0.2,GaussianMechanism,{'Optimal': 40},4674135,351804,29818,0,0,3720,4674135,351804,26098,1725,1745,1670,0,0,248,1725,1745,1422,poisson-block-composition
1373,sp_workloads,1690805680,wl_small_mem,1088,basic:GM-LM-RR-LSVT-sub25100-defpa,1,weighted-dpf+,block-composition,poisson,ncd,basic:GM-LM-RR-LSVT,sub25100,nopa,Unlocking,0.2,LaplaceMechanism,{'Optimal': 40},4701336,316959,30901,408890,2660,18632,4292446,314299,12269,1705,1659,1707,191,19,1032,1514,1640,675,poisson-block-composition
1374,sp_workloads,1690805680,wl_small_mem,1088,basic:GM-LM-RR-LSVT-sub25100-defpa,1,weighted-dpf+,block-composition,poisson,ncd,basic:GM-LM-RR-LSVT,sub25100,nopa,Unlocking,0.2,RandResponseMechanism,{'Optimal': 40},4751311,334074,30363,24046,0,18223,4727265,334074,12140,1634,1678,1701,11,0,1025,1623,1678,676,poisson-block-composition
1375,sp_workloads,1690805680,wl_small_mem,1088,basic:GM-LM-RR-LSVT-sub25100-defpa,1,weighted-dpf+,block-composition,poisson,ncd,basic:GM-LM-RR-LSVT,sub25100,nopa,Unlocking,0.2,SVTLaplaceMechanism,{'Optimal': 40},4658717,301226,29963,15302,140,15061,4643415,301086,14902,1700,1628,1669,7,1,891,1693,1627,778,poisson-block-composition
1376,sp_workloads,1690805680,wl_small_mem,1089,basic:GM-LM-RR-LSVT-sub25100-defpa,1,weighted-dpf+,block-composition,poisson,ncd,basic:GM-LM-RR-LSVT,sub25100,nopa,Unlocking,0.4,GaussianMechanism,{'Optimal': 40},4674135,351804,29818,0,0,3645,4674135,351804,26173,1725,1745,1670,0,0,243,1725,1745,1427,poisson-block-composition
1377,sp_workloads,1690805680,wl_small_mem,1089,basic:GM-LM-RR-LSVT-sub25100-defpa,1,weighted-dpf+,block-composition,poisson,ncd,basic:GM-LM-RR-LSVT,sub25100,nopa,Unlocking,0.4,LaplaceMechanism,{'Optimal': 40},4701336,316959,30901,377006,1260,19070,4324330,315699,11831,1705,1659,1707,177,9,1042,1528,1650,665,poisson-block-composition
1378,sp_workloads,1690805680,wl_small_mem,1089,basic:GM-LM-RR-LSVT-sub25100-defpa,1,weighted-dpf+,block-composition,poisson,ncd,basic:GM-LM-RR-LSVT,sub25100,nopa,Unlocking,0.4,RandResponseMechanism,{'Optimal': 40},4751311,334074,30363,39380,0,16828,4711931,334074,13535,1634,1678,1701,15,0,980,1619,1678,721,poisson-block-composition
1379,sp_workloads,1690805680,wl_small_mem,1089,basic:GM-LM-RR-LSVT-sub25100-defpa,1,weighted-dpf+,block-composition,poisson,ncd,basic:GM-LM-RR-LSVT,sub25100,nopa,Unlocking,0.4,SVTLaplaceMechanism,{'Optimal': 40},4658717,301226,29963,30604,420,13344,4628113,300806,16619,1700,1628,1669,14,3,848,1686,1625,821,poisson-block-composition
1380,sp_workloads,1690805680,wl_small_mem,1090,basic:GM-LM-RR-LSVT-sub25100-defpa,1,weighted-dpf+,block-composition,upc,ncd,basic:GM-LM-RR-LSVT,sub25100,nopa,Unlocking,0.2,GaussianMechanism,{'Optimal': 40},4676698,329662,29265,0,4592,3540,4676698,325070,25725,1725,1745,1670,0,64,236,1725,1681,1434,upc-block-composition
1381,sp_workloads,1690805680,wl_small_mem,1090,basic:GM-LM-RR-LSVT-sub25100-defpa,1,weighted-dpf+,block-composition,upc,ncd,basic:GM-LM-RR-LSVT,sub25100,nopa,Unlocking,0.2,LaplaceMechanism,{'Optimal': 40},4681859,300972,30705,49527,4819,11400,4632332,296153,19305,1705,1659,1707,18,36,670,1687,1623,1037,upc-block-composition
1382,sp_workloads,1690805680,wl_small_mem,1090,basic:GM-LM-RR-LSVT-sub25100-defpa,1,weighted-dpf+,block-composition,upc,ncd,basic:GM-LM-RR-LSVT,sub25100,nopa,Unlocking,0.2,RandResponseMechanism,{'Optimal': 40},4647322,315319,30810,51760,2160,10710,4595562,313159,20100,1634,1678,1701,16,23,627,1618,1655,1074,upc-block-composition
1383,sp_workloads,1690805680,wl_small_mem,1090,basic:GM-LM-RR-LSVT-sub25100-defpa,1,weighted-dpf+,block-composition,upc,ncd,basic:GM-LM-RR-LSVT,sub25100,nopa,Unlocking,0.2,SVTLaplaceMechanism,{'Optimal': 40},4823541,315411,30210,18540,4719,7875,4805001,310692,22335,1700,1628,1669,10,43,502,1690,1585,1167,upc-block-composition
1384,sp_workloads,1690805680,wl_small_mem,1091,basic:GM-LM-RR-LSVT-sub25100-defpa,1,weighted-dpf+,block-composition,upc,ncd,basic:GM-LM-RR-LSVT,sub25100,nopa,Unlocking,0.4,GaussianMechanism,{'Optimal': 40},4676698,329662,29265,0,7604,5610,4676698,322058,23655,1725,1745,1670,0,94,365,1725,1651,1305,upc-block-composition
1385,sp_workloads,1690805680,wl_small_mem,1091,basic:GM-LM-RR-LSVT-sub25100-defpa,1,weighted-dpf+,block-composition,upc,ncd,basic:GM-LM-RR-LSVT,sub25100,nopa,Unlocking,0.4,LaplaceMechanism,{'Optimal': 40},4681859,300972,30705,50494,4429,18495,4631365,296543,12210,1705,1659,1707,12,41,947,1693,1618,760,upc-block-composition
1386,sp_workloads,1690805680,wl_small_mem,1091,basic:GM-LM-RR-LSVT-sub25100-defpa,1,weighted-dpf+,block-composition,upc,ncd,basic:GM-LM-RR-LSVT,sub25100,nopa,Unlocking,0.4,RandResponseMechanism,{'Optimal': 40},4647322,315319,30810,32621,2389,17670,4614701,312930,13140,1634,1678,1701,16,26,928,1618,1652,773,upc-block-composition
1387,sp_workloads,1690805680,wl_small_mem,1091,basic:GM-LM-RR-LSVT-sub25100-defpa,1,weighted-dpf+,block-composition,upc,ncd,basic:GM-LM-RR-LSVT,sub25100,nopa,Unlocking,0.4,SVTLaplaceMechanism,{'Optimal': 40},4823541,315411,30210,18308,5850,14385,4805233,309561,15825,1700,1628,1669,10,49,774,1690,1579,895,upc-block-composition
1388,sp_workloads,1690805680,wl_small_mem,1092,basic:GM-LM-RR-LSVT-sub25100-defpa,1,weighted-dpf+,block-composition,poisson,equal-ncd,basic:GM-LM-RR-LSVT,sub25100,nopa,Unlocking,0.2,GaussianMechanism,{'Optimal': 40},1725,1745,1670,0,4,807,1725,1741,863,1725,1745,1670,0,4,807,1725,1741,863,poisson-block-composition
1389,sp_workloads,1690805680,wl_small_mem,1092,basic:GM-LM-RR-LSVT-sub25100-defpa,1,weighted-dpf+,block-composition,poisson,equal-ncd,basic:GM-LM-RR-LSVT,sub25100,nopa,Unlocking,0.2,LaplaceMechanism,{'Optimal': 40},1705,1659,1707,0,707,1707,1705,952,0,1705,1659,1707,0,707,1707,1705,952,0,poisson-block-composition
1390,sp_workloads,1690805680,wl_small_mem,1092,basic:GM-LM-RR-LSVT-sub25100-defpa,1,weighted-dpf+,block-composition,poisson,equal-ncd,basic:GM-LM-RR-LSVT,sub25100,nopa,Unlocking,0.2,RandResponseMechanism,{'Optimal': 40},1634,1678,1701,0,0,1701,1634,1678,0,1634,1678,1701,0,0,1701,1634,1678,0,poisson-block-composition
1391,sp_workloads,1690805680,wl_small_mem,1092,basic:GM-LM-RR-LSVT-sub25100-defpa,1,weighted-dpf+,block-composition,poisson,equal-ncd,basic:GM-LM-RR-LSVT,sub25100,nopa,Unlocking,0.2,SVTLaplaceMechanism,{'Optimal': 40},1700,1628,1669,0,116,1669,1700,1512,0,1700,1628,1669,0,116,1669,1700,1512,0,poisson-block-composition
1392,sp_workloads,1690805680,wl_small_mem,1093,basic:GM-LM-RR-LSVT-sub25100-defpa,1,weighted-dpf+,block-composition,poisson,equal-ncd,basic:GM-LM-RR-LSVT,sub25100,nopa,Unlocking,0.4,GaussianMechanism,{'Optimal': 40},1725,1745,1670,0,4,965,1725,1741,705,1725,1745,1670,0,4,965,1725,1741,705,poisson-block-composition
1393,sp_workloads,1690805680,wl_small_mem,1093,basic:GM-LM-RR-LSVT-sub25100-defpa,1,weighted-dpf+,block-composition,poisson,equal-ncd,basic:GM-LM-RR-LSVT,sub25100,nopa,Unlocking,0.4,LaplaceMechanism,{'Optimal': 40},1705,1659,1707,0,534,1707,1705,1125,0,1705,1659,1707,0,534,1707,1705,1125,0,poisson-block-composition
1394,sp_workloads,1690805680,wl_small_mem,1093,basic:GM-LM-RR-LSVT-sub25100-defpa,1,weighted-dpf+,block-composition,poisson,equal-ncd,basic:GM-LM-RR-LSVT,sub25100,nopa,Unlocking,0.4,RandResponseMechanism,{'Optimal': 40},1634,1678,1701,0,2,1701,1634,1676,0,1634,1678,1701,0,2,1701,1634,1676,0,poisson-block-composition
1395,sp_workloads,1690805680,wl_small_mem,1093,basic:GM-LM-RR-LSVT-sub25100-defpa,1,weighted-dpf+,block-composition,poisson,equal-ncd,basic:GM-LM-RR-LSVT,sub25100,nopa,Unlocking,0.4,SVTLaplaceMechanism,{'Optimal': 40},1700,1628,1669,0,239,1669,1700,1389,0,1700,1628,1669,0,239,1669,1700,1389,0,poisson-block-composition
1396,sp_workloads,1690805680,wl_small_mem,1094,basic:GM-LM-RR-LSVT-sub25100-defpa,1,weighted-dpf+,block-composition,upc,equal-ncd,basic:GM-LM-RR-LSVT,sub25100,nopa,Unlocking,0.2,GaussianMechanism,{'Optimal': 40},1725,1745,1670,1,100,675,1724,1645,995,1725,1745,1670,1,100,675,1724,1645,995,upc-block-composition
1397,sp_workloads,1690805680,wl_small_mem,1094,basic:GM-LM-RR-LSVT-sub25100-defpa,1,weighted-dpf+,block-composition,upc,equal-ncd,basic:GM-LM-RR-LSVT,sub25100,nopa,Unlocking,0.2,LaplaceMechanism,{'Optimal': 40},1705,1659,1707,1,83,1531,1704,1576,176,1705,1659,1707,1,83,1531,1704,1576,176,upc-block-composition
1398,sp_workloads,1690805680,wl_small_mem,1094,basic:GM-LM-RR-LSVT-sub25100-defpa,1,weighted-dpf+,block-composition,upc,equal-ncd,basic:GM-LM-RR-LSVT,sub25100,nopa,Unlocking,0.2,RandResponseMechanism,{'Optimal': 40},1634,1678,1701,0,56,1515,1634,1622,186,1634,1678,1701,0,56,1515,1634,1622,186,upc-block-composition
1399,sp_workloads,1690805680,wl_small_mem,1094,basic:GM-LM-RR-LSVT-sub25100-defpa,1,weighted-dpf+,block-composition,upc,equal-ncd,basic:GM-LM-RR-LSVT,sub25100,nopa,Unlocking,0.2,SVTLaplaceMechanism,{'Optimal': 40},1700,1628,1669,0,58,1484,1700,1570,185,1700,1628,1669,0,58,1484,1700,1570,185,upc-block-composition
1400,sp_workloads,1690805680,wl_small_mem,1095,basic:GM-LM-RR-LSVT-sub25100-defpa,1,weighted-dpf+,block-composition,upc,equal-ncd,basic:GM-LM-RR-LSVT,sub25100,nopa,Unlocking,0.4,GaussianMechanism,{'Optimal': 40},1725,1745,1670,1,198,851,1724,1547,819,1725,1745,1670,1,198,851,1724,1547,819,upc-block-composition
1401,sp_workloads,1690805680,wl_small_mem,1095,basic:GM-LM-RR-LSVT-sub25100-defpa,1,weighted-dpf+,block-composition,upc,equal-ncd,basic:GM-LM-RR-LSVT,sub25100,nopa,Unlocking,0.4,LaplaceMechanism,{'Optimal': 40},1705,1659,1707,0,63,1605,1705,1596,102,1705,1659,1707,0,63,1605,1705,1596,102,upc-block-composition
1402,sp_workloads,1690805680,wl_small_mem,1095,basic:GM-LM-RR-LSVT-sub25100-defpa,1,weighted-dpf+,block-composition,upc,equal-ncd,basic:GM-LM-RR-LSVT,sub25100,nopa,Unlocking,0.4,RandResponseMechanism,{'Optimal': 40},1634,1678,1701,0,82,1457,1634,1596,244,1634,1678,1701,0,82,1457,1634,1596,244,upc-block-composition
1403,sp_workloads,1690805680,wl_small_mem,1095,basic:GM-LM-RR-LSVT-sub25100-defpa,1,weighted-dpf+,block-composition,upc,equal-ncd,basic:GM-LM-RR-LSVT,sub25100,nopa,Unlocking,0.4,SVTLaplaceMechanism,{'Optimal': 40},1700,1628,1669,0,65,1340,1700,1563,329,1700,1628,1669,0,65,1340,1700,1563,329,upc-block-composition
1404,sp_workloads,1690805680,wl_small_mem,1096,basic:GM-LM-RR-LSVT-sub25100-defpa,2,weighted-dpf+,block-composition,poisson,ncd,basic:GM-LM-RR-LSVT,sub25100,nopa,Unlocking,0.2,GaussianMechanism,{'Optimal': 40},4344073,336565,33248,0,0,4544,4344073,336565,28704,1647,1671,1731,0,0,284,1647,1671,1447,poisson-block-composition
1405,sp_workloads,1690805680,wl_small_mem,1096,basic:GM-LM-RR-LSVT-sub25100-defpa,2,weighted-dpf+,block-composition,poisson,ncd,basic:GM-LM-RR-LSVT,sub25100,nopa,Unlocking,0.2,LaplaceMechanism,{'Optimal': 40},4548967,333299,30800,411238,3045,18800,4137729,330254,12000,1660,1661,1646,185,21,999,1475,1640,647,poisson-block-composition
1406,sp_workloads,1690805680,wl_small_mem,1096,basic:GM-LM-RR-LSVT-sub25100-defpa,2,weighted-dpf+,block-composition,poisson,ncd,basic:GM-LM-RR-LSVT,sub25100,nopa,Unlocking,0.2,RandResponseMechanism,{'Optimal': 40},5016525,328891,32448,27131,0,20032,4989394,328891,12416,1714,1690,1723,9,0,1072,1705,1690,651,poisson-block-composition
1407,sp_workloads,1690805680,wl_small_mem,1096,basic:GM-LM-RR-LSVT-sub25100-defpa,2,weighted-dpf+,block-composition,poisson,ncd,basic:GM-LM-RR-LSVT,sub25100,nopa,Unlocking,0.2,SVTLaplaceMechanism,{'Optimal': 40},4781610,327880,32576,20322,0,16240,4761288,327880,16336,1631,1679,1700,9,0,906,1622,1679,794,poisson-block-composition
1408,sp_workloads,1690805680,wl_small_mem,1097,basic:GM-LM-RR-LSVT-sub25100-defpa,2,weighted-dpf+,block-composition,poisson,ncd,basic:GM-LM-RR-LSVT,sub25100,nopa,Unlocking,0.4,GaussianMechanism,{'Optimal': 40},4344073,336565,33248,0,0,4368,4344073,336565,28880,1647,1671,1731,0,0,273,1647,1671,1458,poisson-block-composition
1409,sp_workloads,1690805680,wl_small_mem,1097,basic:GM-LM-RR-LSVT-sub25100-defpa,2,weighted-dpf+,block-composition,poisson,ncd,basic:GM-LM-RR-LSVT,sub25100,nopa,Unlocking,0.4,LaplaceMechanism,{'Optimal': 40},4548967,333299,30800,430209,1015,19680,4118758,332284,11120,1660,1661,1646,195,7,1025,1465,1654,621,poisson-block-composition
1410,sp_workloads,1690805680,wl_small_mem,1097,basic:GM-LM-RR-LSVT-sub25100-defpa,2,weighted-dpf+,block-composition,poisson,ncd,basic:GM-LM-RR-LSVT,sub25100,nopa,Unlocking,0.4,RandResponseMechanism,{'Optimal': 40},5016525,328891,32448,27096,0,18432,4989429,328891,14016,1714,1690,1723,12,0,1021,1702,1690,702,poisson-block-composition
1411,sp_workloads,1690805680,wl_small_mem,1097,basic:GM-LM-RR-LSVT-sub25100-defpa,2,weighted-dpf+,block-composition,poisson,ncd,basic:GM-LM-RR-LSVT,sub25100,nopa,Unlocking,0.4,SVTLaplaceMechanism,{'Optimal': 40},4781610,327880,32576,22580,290,14544,4759030,327590,18032,1631,1679,1700,10,2,879,1621,1677,821,poisson-block-composition
1412,sp_workloads,1690805680,wl_small_mem,1098,basic:GM-LM-RR-LSVT-sub25100-defpa,2,weighted-dpf+,block-composition,upc,ncd,basic:GM-LM-RR-LSVT,sub25100,nopa,Unlocking,0.2,GaussianMechanism,{'Optimal': 40},4516798,323421,31309,0,4425,3285,4516798,318996,28024,1647,1671,1731,0,55,219,1647,1616,1512,upc-block-composition
1413,sp_workloads,1690805680,wl_small_mem,1098,basic:GM-LM-RR-LSVT-sub25100-defpa,2,weighted-dpf+,block-composition,upc,ncd,basic:GM-LM-RR-LSVT,sub25100,nopa,Unlocking,0.2,LaplaceMechanism,{'Optimal': 40},4830469,312603,29634,57285,3707,9308,4773184,308896,20326,1660,1661,1646,18,34,532,1642,1627,1114,upc-block-composition
1414,sp_workloads,1690805680,wl_small_mem,1098,basic:GM-LM-RR-LSVT-sub25100-defpa,2,weighted-dpf+,block-composition,upc,ncd,basic:GM-LM-RR-LSVT,sub25100,nopa,Unlocking,0.2,RandResponseMechanism,{'Optimal': 40},4802902,316035,30613,50690,2646,10235,4752212,313389,20378,1714,1690,1723,14,26,597,1700,1664,1126,upc-block-composition
1415,sp_workloads,1690805680,wl_small_mem,1098,basic:GM-LM-RR-LSVT-sub25100-defpa,2,weighted-dpf+,block-composition,upc,ncd,basic:GM-LM-RR-LSVT,sub25100,nopa,Unlocking,0.2,SVTLaplaceMechanism,{'Optimal': 40},4594159,320873,30876,30435,3614,6742,4563724,317259,24134,1631,1679,1700,15,34,442,1616,1645,1258,upc-block-composition
1416,sp_workloads,1690805680,wl_small_mem,1099,basic:GM-LM-RR-LSVT-sub25100-defpa,2,weighted-dpf+,block-composition,upc,ncd,basic:GM-LM-RR-LSVT,sub25100,nopa,Unlocking,0.4,GaussianMechanism,{'Optimal': 40},4516798,323421,31309,0,9420,6030,4516798,314001,25279,1647,1671,1731,0,100,402,1647,1571,1329,upc-block-composition
1417,sp_workloads,1690805680,wl_small_mem,1099,basic:GM-LM-RR-LSVT-sub25100-defpa,2,weighted-dpf+,block-composition,upc,ncd,basic:GM-LM-RR-LSVT,sub25100,nopa,Unlocking,0.4,LaplaceMechanism,{'Optimal': 40},4830469,312603,29634,63520,7123,18522,4766949,305480,11112,1660,1661,1646,13,58,950,1647,1603,696,upc-block-composition
1418,sp_workloads,1690805680,wl_small_mem,1099,basic:GM-LM-RR-LSVT-sub25100-defpa,2,weighted-dpf+,block-composition,upc,ncd,basic:GM-LM-RR-LSVT,sub25100,nopa,Unlocking,0.4,RandResponseMechanism,{'Optimal': 40},4802902,316035,30613,4450,5026,16600,4798452,311009,14013,1714,1690,1723,2,46,904,1712,1644,819,upc-block-composition
1419,sp_workloads,1690805680,wl_small_mem,1099,basic:GM-LM-RR-LSVT-sub25100-defpa,2,weighted-dpf+,block-composition,upc,ncd,basic:GM-LM-RR-LSVT,sub25100,nopa,Unlocking,0.4,SVTLaplaceMechanism,{'Optimal': 40},4594159,320873,30876,22425,5818,15000,4571734,315055,15876,1631,1679,1700,11,45,824,1620,1634,876,upc-block-composition
1420,sp_workloads,1690805680,wl_small_mem,1100,basic:GM-LM-RR-LSVT-sub25100-defpa,2,weighted-dpf+,block-composition,poisson,equal-ncd,basic:GM-LM-RR-LSVT,sub25100,nopa,Unlocking,0.2,GaussianMechanism,{'Optimal': 40},1647,1671,1731,0,3,838,1647,1668,893,1647,1671,1731,0,3,838,1647,1668,893,poisson-block-composition
1421,sp_workloads,1690805680,wl_small_mem,1100,basic:GM-LM-RR-LSVT-sub25100-defpa,2,weighted-dpf+,block-composition,poisson,equal-ncd,basic:GM-LM-RR-LSVT,sub25100,nopa,Unlocking,0.2,LaplaceMechanism,{'Optimal': 40},1660,1661,1646,0,710,1646,1660,951,0,1660,1661,1646,0,710,1646,1660,951,0,poisson-block-composition
1422,sp_workloads,1690805680,wl_small_mem,1100,basic:GM-LM-RR-LSVT-sub25100-defpa,2,weighted-dpf+,block-composition,poisson,equal-ncd,basic:GM-LM-RR-LSVT,sub25100,nopa,Unlocking,0.2,RandResponseMechanism,{'Optimal': 40},1714,1690,1723,0,0,1723,1714,1690,0,1714,1690,1723,0,0,1723,1714,1690,0,poisson-block-composition
1423,sp_workloads,1690805680,wl_small_mem,1100,basic:GM-LM-RR-LSVT-sub25100-defpa,2,weighted-dpf+,block-composition,poisson,equal-ncd,basic:GM-LM-RR-LSVT,sub25100,nopa,Unlocking,0.2,SVTLaplaceMechanism,{'Optimal': 40},1631,1679,1700,0,121,1700,1631,1558,0,1631,1679,1700,0,121,1700,1631,1558,0,poisson-block-composition
1424,sp_workloads,1690805680,wl_small_mem,1101,basic:GM-LM-RR-LSVT-sub25100-defpa,2,weighted-dpf+,block-composition,poisson,equal-ncd,basic:GM-LM-RR-LSVT,sub25100,nopa,Unlocking,0.4,GaussianMechanism,{'Optimal': 40},1647,1671,1731,0,2,828,1647,1669,903,1647,1671,1731,0,2,828,1647,1669,903,poisson-block-composition
1425,sp_workloads,1690805680,wl_small_mem,1101,basic:GM-LM-RR-LSVT-sub25100-defpa,2,weighted-dpf+,block-composition,poisson,equal-ncd,basic:GM-LM-RR-LSVT,sub25100,nopa,Unlocking,0.4,LaplaceMechanism,{'Optimal': 40},1660,1661,1646,0,552,1646,1660,1109,0,1660,1661,1646,0,552,1646,1660,1109,0,poisson-block-composition
1426,sp_workloads,1690805680,wl_small_mem,1101,basic:GM-LM-RR-LSVT-sub25100-defpa,2,weighted-dpf+,block-composition,poisson,equal-ncd,basic:GM-LM-RR-LSVT,sub25100,nopa,Unlocking,0.4,RandResponseMechanism,{'Optimal': 40},1714,1690,1723,0,0,1723,1714,1690,0,1714,1690,1723,0,0,1723,1714,1690,0,poisson-block-composition
1427,sp_workloads,1690805680,wl_small_mem,1101,basic:GM-LM-RR-LSVT-sub25100-defpa,2,weighted-dpf+,block-composition,poisson,equal-ncd,basic:GM-LM-RR-LSVT,sub25100,nopa,Unlocking,0.4,SVTLaplaceMechanism,{'Optimal': 40},1631,1679,1700,0,240,1700,1631,1439,0,1631,1679,1700,0,240,1700,1631,1439,0,poisson-block-composition
1428,sp_workloads,1690805680,wl_small_mem,1102,basic:GM-LM-RR-LSVT-sub25100-defpa,2,weighted-dpf+,block-composition,upc,equal-ncd,basic:GM-LM-RR-LSVT,sub25100,nopa,Unlocking,0.2,GaussianMechanism,{'Optimal': 40},1647,1671,1731,0,95,639,1647,1576,1092,1647,1671,1731,0,95,639,1647,1576,1092,upc-block-composition
1429,sp_workloads,1690805680,wl_small_mem,1102,basic:GM-LM-RR-LSVT-sub25100-defpa,2,weighted-dpf+,block-composition,upc,equal-ncd,basic:GM-LM-RR-LSVT,sub25100,nopa,Unlocking,0.2,LaplaceMechanism,{'Optimal': 40},1660,1661,1646,0,77,1470,1660,1584,176,1660,1661,1646,0,77,1470,1660,1584,176,upc-block-composition
1430,sp_workloads,1690805680,wl_small_mem,1102,basic:GM-LM-RR-LSVT-sub25100-defpa,2,weighted-dpf+,block-composition,upc,equal-ncd,basic:GM-LM-RR-LSVT,sub25100,nopa,Unlocking,0.2,RandResponseMechanism,{'Optimal': 40},1714,1690,1723,0,70,1498,1714,1620,225,1714,1690,1723,0,70,1498,1714,1620,225,upc-block-composition
1431,sp_workloads,1690805680,wl_small_mem,1102,basic:GM-LM-RR-LSVT-sub25100-defpa,2,weighted-dpf+,block-composition,upc,equal-ncd,basic:GM-LM-RR-LSVT,sub25100,nopa,Unlocking,0.2,SVTLaplaceMechanism,{'Optimal': 40},1631,1679,1700,0,70,1442,1631,1609,258,1631,1679,1700,0,70,1442,1631,1609,258,upc-block-composition
1432,sp_workloads,1690805680,wl_small_mem,1103,basic:GM-LM-RR-LSVT-sub25100-defpa,2,weighted-dpf+,block-composition,upc,equal-ncd,basic:GM-LM-RR-LSVT,sub25100,nopa,Unlocking,0.4,GaussianMechanism,{'Optimal': 40},1647,1671,1731,0,186,933,1647,1485,798,1647,1671,1731,0,186,933,1647,1485,798,upc-block-composition
1433,sp_workloads,1690805680,wl_small_mem,1103,basic:GM-LM-RR-LSVT-sub25100-defpa,2,weighted-dpf+,block-composition,upc,equal-ncd,basic:GM-LM-RR-LSVT,sub25100,nopa,Unlocking,0.4,LaplaceMechanism,{'Optimal': 40},1660,1661,1646,2,64,1542,1658,1597,104,1660,1661,1646,2,64,1542,1658,1597,104,upc-block-composition
1434,sp_workloads,1690805680,wl_small_mem,1103,basic:GM-LM-RR-LSVT-sub25100-defpa,2,weighted-dpf+,block-composition,upc,equal-ncd,basic:GM-LM-RR-LSVT,sub25100,nopa,Unlocking,0.4,RandResponseMechanism,{'Optimal': 40},1714,1690,1723,1,72,1494,1713,1618,229,1714,1690,1723,1,72,1494,1713,1618,229,upc-block-composition
1435,sp_workloads,1690805680,wl_small_mem,1103,basic:GM-LM-RR-LSVT-sub25100-defpa,2,weighted-dpf+,block-composition,upc,equal-ncd,basic:GM-LM-RR-LSVT,sub25100,nopa,Unlocking,0.4,SVTLaplaceMechanism,{'Optimal': 40},1631,1679,1700,0,68,1386,1631,1611,314,1631,1679,1700,0,68,1386,1631,1611,314,upc-block-composition
1436,sp_workloads,1690805680,wl_small_mem,1104,basic:GM-LM-RR-LSVT-sub25100-defpa,3,weighted-dpf+,block-composition,poisson,ncd,basic:GM-LM-RR-LSVT,sub25100,nopa,Unlocking,0.2,GaussianMechanism,{'Optimal': 40},4431438,335185,30243,0,0,3435,4431438,335185,26808,1636,1707,1661,0,0,229,1636,1707,1432,poisson-block-composition
1437,sp_workloads,1690805680,wl_small_mem,1104,basic:GM-LM-RR-LSVT-sub25100-defpa,3,weighted-dpf+,block-composition,poisson,ncd,basic:GM-LM-RR-LSVT,sub25100,nopa,Unlocking,0.2,LaplaceMechanism,{'Optimal': 40},4614241,302136,30909,427949,3146,19772,4186292,298990,11137,1669,1590,1731,195,22,1108,1474,1568,623,poisson-block-composition
1438,sp_workloads,1690805680,wl_small_mem,1104,basic:GM-LM-RR-LSVT-sub25100-defpa,3,weighted-dpf+,block-composition,poisson,ncd,basic:GM-LM-RR-LSVT,sub25100,nopa,Unlocking,0.2,RandResponseMechanism,{'Optimal': 40},4710432,347409,29228,15610,0,18149,4694822,347409,11079,1691,1685,1636,7,0,1019,1684,1685,617,poisson-block-composition
1439,sp_workloads,1690805680,wl_small_mem,1104,basic:GM-LM-RR-LSVT-sub25100-defpa,3,weighted-dpf+,block-composition,poisson,ncd,basic:GM-LM-RR-LSVT,sub25100,nopa,Unlocking,0.2,SVTLaplaceMechanism,{'Optimal': 40},4781445,315437,29779,15610,0,15997,4765835,315437,13782,1697,1624,1645,7,0,899,1690,1624,746,poisson-block-composition
1440,sp_workloads,1690805680,wl_small_mem,1105,basic:GM-LM-RR-LSVT-sub25100-defpa,3,weighted-dpf+,block-composition,poisson,ncd,basic:GM-LM-RR-LSVT,sub25100,nopa,Unlocking,0.4,GaussianMechanism,{'Optimal': 40},4431438,335185,30243,0,0,4170,4431438,335185,26073,1636,1707,1661,0,0,278,1636,1707,1383,poisson-block-composition
1441,sp_workloads,1690805680,wl_small_mem,1105,basic:GM-LM-RR-LSVT-sub25100-defpa,3,weighted-dpf+,block-composition,poisson,ncd,basic:GM-LM-RR-LSVT,sub25100,nopa,Unlocking,0.4,LaplaceMechanism,{'Optimal': 40},4614241,302136,30909,411161,715,19797,4203080,301421,11112,1669,1590,1731,189,5,1083,1480,1585,648,poisson-block-composition
1442,sp_workloads,1690805680,wl_small_mem,1105,basic:GM-LM-RR-LSVT-sub25100-defpa,3,weighted-dpf+,block-composition,poisson,ncd,basic:GM-LM-RR-LSVT,sub25100,nopa,Unlocking,0.4,RandResponseMechanism,{'Optimal': 40},4710432,347409,29228,40208,0,16235,4670224,347409,12993,1691,1685,1636,12,0,949,1679,1685,687,poisson-block-composition
1443,sp_workloads,1690805680,wl_small_mem,1105,basic:GM-LM-RR-LSVT-sub25100-defpa,3,weighted-dpf+,block-composition,poisson,ncd,basic:GM-LM-RR-LSVT,sub25100,nopa,Unlocking,0.4,SVTLaplaceMechanism,{'Optimal': 40},4781445,315437,29779,13380,429,12227,4768065,315008,17552,1697,1624,1645,6,3,797,1691,1621,848,poisson-block-composition
1444,sp_workloads,1690805680,wl_small_mem,1106,basic:GM-LM-RR-LSVT-sub25100-defpa,3,weighted-dpf+,block-composition,upc,ncd,basic:GM-LM-RR-LSVT,sub25100,nopa,Unlocking,0.2,GaussianMechanism,{'Optimal': 40},4564359,342607,29747,0,9652,3600,4564359,332955,26147,1636,1707,1661,0,108,240,1636,1599,1421,upc-block-composition
1445,sp_workloads,1690805680,wl_small_mem,1106,basic:GM-LM-RR-LSVT-sub25100-defpa,3,weighted-dpf+,block-composition,upc,ncd,basic:GM-LM-RR-LSVT,sub25100,nopa,Unlocking,0.2,LaplaceMechanism,{'Optimal': 40},4480666,307160,31021,75272,4262,10778,4405394,302898,20243,1669,1590,1731,19,42,630,1650,1548,1101,upc-block-composition
1446,sp_workloads,1690805680,wl_small_mem,1106,basic:GM-LM-RR-LSVT-sub25100-defpa,3,weighted-dpf+,block-composition,upc,ncd,basic:GM-LM-RR-LSVT,sub25100,nopa,Unlocking,0.2,RandResponseMechanism,{'Optimal': 40},4713077,327965,29084,28108,3073,10345,4684969,324892,18739,1691,1685,1636,13,31,615,1678,1654,1021,upc-block-composition
1447,sp_workloads,1690805680,wl_small_mem,1106,basic:GM-LM-RR-LSVT-sub25100-defpa,3,weighted-dpf+,block-composition,upc,ncd,basic:GM-LM-RR-LSVT,sub25100,nopa,Unlocking,0.2,SVTLaplaceMechanism,{'Optimal': 40},4783523,317659,29347,19228,3596,6967,4764295,314063,22380,1697,1624,1645,10,36,457,1687,1588,1188,upc-block-composition
1448,sp_workloads,1690805680,wl_small_mem,1107,basic:GM-LM-RR-LSVT-sub25100-defpa,3,weighted-dpf+,block-composition,upc,ncd,basic:GM-LM-RR-LSVT,sub25100,nopa,Unlocking,0.4,GaussianMechanism,{'Optimal': 40},4564359,342607,29747,1916,10178,6180,4562443,332429,23567,1636,1707,1661,1,110,412,1635,1597,1249,upc-block-composition
1449,sp_workloads,1690805680,wl_small_mem,1107,basic:GM-LM-RR-LSVT-sub25100-defpa,3,weighted-dpf+,block-composition,upc,ncd,basic:GM-LM-RR-LSVT,sub25100,nopa,Unlocking,0.4,LaplaceMechanism,{'Optimal': 40},4480666,307160,31021,44575,5812,20028,4436091,301348,10993,1669,1590,1731,12,42,1076,1657,1548,655,upc-block-composition
1450,sp_workloads,1690805680,wl_small_mem,1107,basic:GM-LM-RR-LSVT-sub25100-defpa,3,weighted-dpf+,block-composition,upc,ncd,basic:GM-LM-RR-LSVT,sub25100,nopa,Unlocking,0.4,RandResponseMechanism,{'Optimal': 40},4713077,327965,29084,12041,5560,16796,4701036,322405,12288,1691,1685,1636,7,56,932,1684,1629,704,upc-block-composition
1451,sp_workloads,1690805680,wl_small_mem,1107,basic:GM-LM-RR-LSVT-sub25100-defpa,3,weighted-dpf+,block-composition,upc,ncd,basic:GM-LM-RR-LSVT,sub25100,nopa,Unlocking,0.4,SVTLaplaceMechanism,{'Optimal': 40},4783523,317659,29347,26320,6584,14188,4757203,311075,15159,1697,1624,1645,12,55,804,1685,1569,841,upc-block-composition
1452,sp_workloads,1690805680,wl_small_mem,1108,basic:GM-LM-RR-LSVT-sub25100-defpa,3,weighted-dpf+,block-composition,poisson,equal-ncd,basic:GM-LM-RR-LSVT,sub25100,nopa,Unlocking,0.2,GaussianMechanism,{'Optimal': 40},1636,1707,1661,0,2,806,1636,1705,855,1636,1707,1661,0,2,806,1636,1705,855,poisson-block-composition
1453,sp_workloads,1690805680,wl_small_mem,1108,basic:GM-LM-RR-LSVT-sub25100-defpa,3,weighted-dpf+,block-composition,poisson,equal-ncd,basic:GM-LM-RR-LSVT,sub25100,nopa,Unlocking,0.2,LaplaceMechanism,{'Optimal': 40},1669,1590,1731,0,681,1731,1669,909,0,1669,1590,1731,0,681,1731,1669,909,0,poisson-block-composition
1454,sp_workloads,1690805680,wl_small_mem,1108,basic:GM-LM-RR-LSVT-sub25100-defpa,3,weighted-dpf+,block-composition,poisson,equal-ncd,basic:GM-LM-RR-LSVT,sub25100,nopa,Unlocking,0.2,RandResponseMechanism,{'Optimal': 40},1691,1685,1636,0,0,1636,1691,1685,0,1691,1685,1636,0,0,1636,1691,1685,0,poisson-block-composition
1455,sp_workloads,1690805680,wl_small_mem,1108,basic:GM-LM-RR-LSVT-sub25100-defpa,3,weighted-dpf+,block-composition,poisson,equal-ncd,basic:GM-LM-RR-LSVT,sub25100,nopa,Unlocking,0.2,SVTLaplaceMechanism,{'Optimal': 40},1697,1624,1645,0,143,1645,1697,1481,0,1697,1624,1645,0,143,1645,1697,1481,0,poisson-block-composition
1456,sp_workloads,1690805680,wl_small_mem,1109,basic:GM-LM-RR-LSVT-sub25100-defpa,3,weighted-dpf+,block-composition,poisson,equal-ncd,basic:GM-LM-RR-LSVT,sub25100,nopa,Unlocking,0.4,GaussianMechanism,{'Optimal': 40},1636,1707,1661,0,2,808,1636,1705,853,1636,1707,1661,0,2,808,1636,1705,853,poisson-block-composition
1457,sp_workloads,1690805680,wl_small_mem,1109,basic:GM-LM-RR-LSVT-sub25100-defpa,3,weighted-dpf+,block-composition,poisson,equal-ncd,basic:GM-LM-RR-LSVT,sub25100,nopa,Unlocking,0.4,LaplaceMechanism,{'Optimal': 40},1669,1590,1731,0,532,1731,1669,1058,0,1669,1590,1731,0,532,1731,1669,1058,0,poisson-block-composition
1458,sp_workloads,1690805680,wl_small_mem,1109,basic:GM-LM-RR-LSVT-sub25100-defpa,3,weighted-dpf+,block-composition,poisson,equal-ncd,basic:GM-LM-RR-LSVT,sub25100,nopa,Unlocking,0.4,RandResponseMechanism,{'Optimal': 40},1691,1685,1636,0,2,1636,1691,1683,0,1691,1685,1636,0,2,1636,1691,1683,0,poisson-block-composition
1459,sp_workloads,1690805680,wl_small_mem,1109,basic:GM-LM-RR-LSVT-sub25100-defpa,3,weighted-dpf+,block-composition,poisson,equal-ncd,basic:GM-LM-RR-LSVT,sub25100,nopa,Unlocking,0.4,SVTLaplaceMechanism,{'Optimal': 40},1697,1624,1645,0,256,1645,1697,1368,0,1697,1624,1645,0,256,1645,1697,1368,0,poisson-block-composition
1460,sp_workloads,1690805680,wl_small_mem,1110,basic:GM-LM-RR-LSVT-sub25100-defpa,3,weighted-dpf+,block-composition,upc,equal-ncd,basic:GM-LM-RR-LSVT,sub25100,nopa,Unlocking,0.2,GaussianMechanism,{'Optimal': 40},1636,1707,1661,0,92,717,1636,1615,944,1636,1707,1661,0,92,717,1636,1615,944,upc-block-composition
1461,sp_workloads,1690805680,wl_small_mem,1110,basic:GM-LM-RR-LSVT-sub25100-defpa,3,weighted-dpf+,block-composition,upc,equal-ncd,basic:GM-LM-RR-LSVT,sub25100,nopa,Unlocking,0.2,LaplaceMechanism,{'Optimal': 40},1669,1590,1731,1,80,1530,1668,1510,201,1669,1590,1731,1,80,1530,1668,1510,201,upc-block-composition
1462,sp_workloads,1690805680,wl_small_mem,1110,basic:GM-LM-RR-LSVT-sub25100-defpa,3,weighted-dpf+,block-composition,upc,equal-ncd,basic:GM-LM-RR-LSVT,sub25100,nopa,Unlocking,0.2,RandResponseMechanism,{'Optimal': 40},1691,1685,1636,0,74,1387,1691,1611,249,1691,1685,1636,0,74,1387,1691,1611,249,upc-block-composition
1463,sp_workloads,1690805680,wl_small_mem,1110,basic:GM-LM-RR-LSVT-sub25100-defpa,3,weighted-dpf+,block-composition,upc,equal-ncd,basic:GM-LM-RR-LSVT,sub25100,nopa,Unlocking,0.2,SVTLaplaceMechanism,{'Optimal': 40},1697,1624,1645,0,69,1360,1697,1555,285,1697,1624,1645,0,69,1360,1697,1555,285,upc-block-composition
1464,sp_workloads,1690805680,wl_small_mem,1111,basic:GM-LM-RR-LSVT-sub25100-defpa,3,weighted-dpf+,block-composition,upc,equal-ncd,basic:GM-LM-RR-LSVT,sub25100,nopa,Unlocking,0.4,GaussianMechanism,{'Optimal': 40},1636,1707,1661,0,215,784,1636,1492,877,1636,1707,1661,0,215,784,1636,1492,877,upc-block-composition
1465,sp_workloads,1690805680,wl_small_mem,1111,basic:GM-LM-RR-LSVT-sub25100-defpa,3,weighted-dpf+,block-composition,upc,equal-ncd,basic:GM-LM-RR-LSVT,sub25100,nopa,Unlocking,0.4,LaplaceMechanism,{'Optimal': 40},1669,1590,1731,0,71,1655,1669,1519,76,1669,1590,1731,0,71,1655,1669,1519,76,upc-block-composition
1466,sp_workloads,1690805680,wl_small_mem,1111,basic:GM-LM-RR-LSVT-sub25100-defpa,3,weighted-dpf+,block-composition,upc,equal-ncd,basic:GM-LM-RR-LSVT,sub25100,nopa,Unlocking,0.4,RandResponseMechanism,{'Optimal': 40},1691,1685,1636,0,58,1443,1691,1627,193,1691,1685,1636,0,58,1443,1691,1627,193,upc-block-composition
1467,sp_workloads,1690805680,wl_small_mem,1111,basic:GM-LM-RR-LSVT-sub25100-defpa,3,weighted-dpf+,block-composition,upc,equal-ncd,basic:GM-LM-RR-LSVT,sub25100,nopa,Unlocking,0.4,SVTLaplaceMechanism,{'Optimal': 40},1697,1624,1645,0,82,1409,1697,1542,236,1697,1624,1645,0,82,1409,1697,1542,236,upc-block-composition
1468,sp_workloads,1690805680,wl_small_mem,1112,basic:GM-LM-RR-LSVT-sub25100-defpa,4,weighted-dpf+,block-composition,poisson,ncd,basic:GM-LM-RR-LSVT,sub25100,nopa,Unlocking,0.2,GaussianMechanism,{'Optimal': 40},4571824,341651,31424,0,0,3952,4571824,341651,27472,1667,1683,1652,0,0,247,1667,1683,1405,poisson-block-composition
1469,sp_workloads,1690805680,wl_small_mem,1112,basic:GM-LM-RR-LSVT-sub25100-defpa,4,weighted-dpf+,block-composition,poisson,ncd,basic:GM-LM-RR-LSVT,sub25100,nopa,Unlocking,0.2,LaplaceMechanism,{'Optimal': 40},4559498,310728,31904,398230,1296,19552,4161268,309432,12352,1705,1675,1674,180,9,1032,1525,1666,642,poisson-block-composition
1470,sp_workloads,1690805680,wl_small_mem,1112,basic:GM-LM-RR-LSVT-sub25100-defpa,4,weighted-dpf+,block-composition,poisson,ncd,basic:GM-LM-RR-LSVT,sub25100,nopa,Unlocking,0.2,RandResponseMechanism,{'Optimal': 40},4915555,321907,33248,33754,0,21520,4881801,321907,11728,1732,1682,1739,9,0,1113,1723,1682,626,poisson-block-composition
1471,sp_workloads,1690805680,wl_small_mem,1112,basic:GM-LM-RR-LSVT-sub25100-defpa,4,weighted-dpf+,block-composition,poisson,ncd,basic:GM-LM-RR-LSVT,sub25100,nopa,Unlocking,0.2,SVTLaplaceMechanism,{'Optimal': 40},4827443,310825,33008,15706,432,17888,4811737,310393,15120,1701,1631,1753,7,3,984,1694,1628,769,poisson-block-composition
1472,sp_workloads,1690805680,wl_small_mem,1113,basic:GM-LM-RR-LSVT-sub25100-defpa,4,weighted-dpf+,block-composition,poisson,ncd,basic:GM-LM-RR-LSVT,sub25100,nopa,Unlocking,0.4,GaussianMechanism,{'Optimal': 40},4571824,341651,31424,0,0,4832,4571824,341651,26592,1667,1683,1652,0,0,302,1667,1683,1350,poisson-block-composition
1473,sp_workloads,1690805680,wl_small_mem,1113,basic:GM-LM-RR-LSVT-sub25100-defpa,4,weighted-dpf+,block-composition,poisson,ncd,basic:GM-LM-RR-LSVT,sub25100,nopa,Unlocking,0.4,LaplaceMechanism,{'Optimal': 40},4559498,310728,31904,408122,1872,19568,4151376,308856,12336,1705,1675,1674,182,13,1024,1523,1662,650,poisson-block-composition
1474,sp_workloads,1690805680,wl_small_mem,1113,basic:GM-LM-RR-LSVT-sub25100-defpa,4,weighted-dpf+,block-composition,poisson,ncd,basic:GM-LM-RR-LSVT,sub25100,nopa,Unlocking,0.4,RandResponseMechanism,{'Optimal': 40},4915555,321907,33248,15722,0,18592,4899833,321907,14656,1732,1682,1739,7,0,1019,1725,1682,720,poisson-block-composition
1475,sp_workloads,1690805680,wl_small_mem,1113,basic:GM-LM-RR-LSVT-sub25100-defpa,4,weighted-dpf+,block-composition,poisson,ncd,basic:GM-LM-RR-LSVT,sub25100,nopa,Unlocking,0.4,SVTLaplaceMechanism,{'Optimal': 40},4827443,310825,33008,38134,432,15248,4789309,310393,17760,1701,1631,1753,14,3,920,1687,1628,833,poisson-block-composition
1476,sp_workloads,1690805680,wl_small_mem,1114,basic:GM-LM-RR-LSVT-sub25100-defpa,4,weighted-dpf+,block-composition,upc,ncd,basic:GM-LM-RR-LSVT,sub25100,nopa,Unlocking,0.2,GaussianMechanism,{'Optimal': 40},4695849,326924,29724,0,5879,3187,4695849,321045,26537,1667,1683,1652,0,68,205,1667,1615,1447,upc-block-composition
1477,sp_workloads,1690805680,wl_small_mem,1114,basic:GM-LM-RR-LSVT-sub25100-defpa,4,weighted-dpf+,block-composition,upc,ncd,basic:GM-LM-RR-LSVT,sub25100,nopa,Unlocking,0.2,LaplaceMechanism,{'Optimal': 40},4679017,325790,30262,67269,2372,9259,4611748,323418,21003,1705,1675,1674,19,30,533,1686,1645,1141,upc-block-composition
1478,sp_workloads,1690805680,wl_small_mem,1114,basic:GM-LM-RR-LSVT-sub25100-defpa,4,weighted-dpf+,block-composition,upc,ncd,basic:GM-LM-RR-LSVT,sub25100,nopa,Unlocking,0.2,RandResponseMechanism,{'Optimal': 40},4775505,333039,31541,49676,3308,10742,4725829,329731,20799,1732,1682,1739,14,31,602,1718,1651,1137,upc-block-composition
1479,sp_workloads,1690805680,wl_small_mem,1114,basic:GM-LM-RR-LSVT-sub25100-defpa,4,weighted-dpf+,block-composition,upc,ncd,basic:GM-LM-RR-LSVT,sub25100,nopa,Unlocking,0.2,SVTLaplaceMechanism,{'Optimal': 40},4720990,300216,31735,23262,3181,7066,4697728,297035,24669,1701,1631,1753,11,33,454,1690,1598,1299,upc-block-composition
1480,sp_workloads,1690805680,wl_small_mem,1115,basic:GM-LM-RR-LSVT-sub25100-defpa,4,weighted-dpf+,block-composition,upc,ncd,basic:GM-LM-RR-LSVT,sub25100,nopa,Unlocking,0.4,GaussianMechanism,{'Optimal': 40},4695849,326924,29724,0,7956,5490,4695849,318968,24234,1667,1683,1652,0,91,366,1667,1592,1286,upc-block-composition
1481,sp_workloads,1690805680,wl_small_mem,1115,basic:GM-LM-RR-LSVT-sub25100-defpa,4,weighted-dpf+,block-composition,upc,ncd,basic:GM-LM-RR-LSVT,sub25100,nopa,Unlocking,0.4,LaplaceMechanism,{'Optimal': 40},4679017,325790,30262,61934,5282,18376,4617083,320508,11886,1705,1675,1674,13,42,952,1692,1633,722,upc-block-composition
1482,sp_workloads,1690805680,wl_small_mem,1115,basic:GM-LM-RR-LSVT-sub25100-defpa,4,weighted-dpf+,block-composition,upc,ncd,basic:GM-LM-RR-LSVT,sub25100,nopa,Unlocking,0.4,RandResponseMechanism,{'Optimal': 40},4775505,333039,31541,15406,5104,17828,4760099,327935,13713,1732,1682,1739,8,49,940,1724,1633,799,upc-block-composition
1483,sp_workloads,1690805680,wl_small_mem,1115,basic:GM-LM-RR-LSVT-sub25100-defpa,4,weighted-dpf+,block-composition,upc,ncd,basic:GM-LM-RR-LSVT,sub25100,nopa,Unlocking,0.4,SVTLaplaceMechanism,{'Optimal': 40},4720990,300216,31735,18844,6104,15605,4702146,294112,16130,1701,1631,1753,10,44,859,1691,1587,894,upc-block-composition
1484,sp_workloads,1690805680,wl_small_mem,1116,basic:GM-LM-RR-LSVT-sub25100-defpa,4,weighted-dpf+,block-composition,poisson,equal-ncd,basic:GM-LM-RR-LSVT,sub25100,nopa,Unlocking,0.2,GaussianMechanism,{'Optimal': 40},1667,1683,1652,0,4,772,1667,1679,880,1667,1683,1652,0,4,772,1667,1679,880,poisson-block-composition
1485,sp_workloads,1690805680,wl_small_mem,1116,basic:GM-LM-RR-LSVT-sub25100-defpa,4,weighted-dpf+,block-composition,poisson,equal-ncd,basic:GM-LM-RR-LSVT,sub25100,nopa,Unlocking,0.2,LaplaceMechanism,{'Optimal': 40},1705,1675,1674,0,671,1674,1705,1004,0,1705,1675,1674,0,671,1674,1705,1004,0,poisson-block-composition
1486,sp_workloads,1690805680,wl_small_mem,1116,basic:GM-LM-RR-LSVT-sub25100-defpa,4,weighted-dpf+,block-composition,poisson,equal-ncd,basic:GM-LM-RR-LSVT,sub25100,nopa,Unlocking,0.2,RandResponseMechanism,{'Optimal': 40},1732,1682,1739,0,0,1739,1732,1682,0,1732,1682,1739,0,0,1739,1732,1682,0,poisson-block-composition
1487,sp_workloads,1690805680,wl_small_mem,1116,basic:GM-LM-RR-LSVT-sub25100-defpa,4,weighted-dpf+,block-composition,poisson,equal-ncd,basic:GM-LM-RR-LSVT,sub25100,nopa,Unlocking,0.2,SVTLaplaceMechanism,{'Optimal': 40},1701,1631,1753,0,139,1753,1701,1492,0,1701,1631,1753,0,139,1753,1701,1492,0,poisson-block-composition
1488,sp_workloads,1690805680,wl_small_mem,1117,basic:GM-LM-RR-LSVT-sub25100-defpa,4,weighted-dpf+,block-composition,poisson,equal-ncd,basic:GM-LM-RR-LSVT,sub25100,nopa,Unlocking,0.4,GaussianMechanism,{'Optimal': 40},1667,1683,1652,0,1,838,1667,1682,814,1667,1683,1652,0,1,838,1667,1682,814,poisson-block-composition
1489,sp_workloads,1690805680,wl_small_mem,1117,basic:GM-LM-RR-LSVT-sub25100-defpa,4,weighted-dpf+,block-composition,poisson,equal-ncd,basic:GM-LM-RR-LSVT,sub25100,nopa,Unlocking,0.4,LaplaceMechanism,{'Optimal': 40},1705,1675,1674,0,530,1674,1705,1145,0,1705,1675,1674,0,530,1674,1705,1145,0,poisson-block-composition
1490,sp_workloads,1690805680,wl_small_mem,1117,basic:GM-LM-RR-LSVT-sub25100-defpa,4,weighted-dpf+,block-composition,poisson,equal-ncd,basic:GM-LM-RR-LSVT,sub25100,nopa,Unlocking,0.4,RandResponseMechanism,{'Optimal': 40},1732,1682,1739,0,0,1739,1732,1682,0,1732,1682,1739,0,0,1739,1732,1682,0,poisson-block-composition
1491,sp_workloads,1690805680,wl_small_mem,1117,basic:GM-LM-RR-LSVT-sub25100-defpa,4,weighted-dpf+,block-composition,poisson,equal-ncd,basic:GM-LM-RR-LSVT,sub25100,nopa,Unlocking,0.4,SVTLaplaceMechanism,{'Optimal': 40},1701,1631,1753,0,248,1753,1701,1383,0,1701,1631,1753,0,248,1753,1701,1383,0,poisson-block-composition
1492,sp_workloads,1690805680,wl_small_mem,1118,basic:GM-LM-RR-LSVT-sub25100-defpa,4,weighted-dpf+,block-composition,upc,equal-ncd,basic:GM-LM-RR-LSVT,sub25100,nopa,Unlocking,0.2,GaussianMechanism,{'Optimal': 40},1667,1683,1652,0,133,700,1667,1550,952,1667,1683,1652,0,133,700,1667,1550,952,upc-block-composition
1493,sp_workloads,1690805680,wl_small_mem,1118,basic:GM-LM-RR-LSVT-sub25100-defpa,4,weighted-dpf+,block-composition,upc,equal-ncd,basic:GM-LM-RR-LSVT,sub25100,nopa,Unlocking,0.2,LaplaceMechanism,{'Optimal': 40},1705,1675,1674,0,80,1530,1705,1595,144,1705,1675,1674,0,80,1530,1705,1595,144,upc-block-composition
1494,sp_workloads,1690805680,wl_small_mem,1118,basic:GM-LM-RR-LSVT-sub25100-defpa,4,weighted-dpf+,block-composition,upc,equal-ncd,basic:GM-LM-RR-LSVT,sub25100,nopa,Unlocking,0.2,RandResponseMechanism,{'Optimal': 40},1732,1682,1739,1,57,1567,1731,1625,172,1732,1682,1739,1,57,1567,1731,1625,172,upc-block-composition
1495,sp_workloads,1690805680,wl_small_mem,1118,basic:GM-LM-RR-LSVT-sub25100-defpa,4,weighted-dpf+,block-composition,upc,equal-ncd,basic:GM-LM-RR-LSVT,sub25100,nopa,Unlocking,0.2,SVTLaplaceMechanism,{'Optimal': 40},1701,1631,1753,0,66,1524,1701,1565,229,1701,1631,1753,0,66,1524,1701,1565,229,upc-block-composition
1496,sp_workloads,1690805680,wl_small_mem,1119,basic:GM-LM-RR-LSVT-sub25100-defpa,4,weighted-dpf+,block-composition,upc,equal-ncd,basic:GM-LM-RR-LSVT,sub25100,nopa,Unlocking,0.4,GaussianMechanism,{'Optimal': 40},1667,1683,1652,0,209,825,1667,1474,827,1667,1683,1652,0,209,825,1667,1474,827,upc-block-composition
1497,sp_workloads,1690805680,wl_small_mem,1119,basic:GM-LM-RR-LSVT-sub25100-defpa,4,weighted-dpf+,block-composition,upc,equal-ncd,basic:GM-LM-RR-LSVT,sub25100,nopa,Unlocking,0.4,LaplaceMechanism,{'Optimal': 40},1705,1675,1674,0,82,1594,1705,1593,80,1705,1675,1674,0,82,1594,1705,1593,80,upc-block-composition
1498,sp_workloads,1690805680,wl_small_mem,1119,basic:GM-LM-RR-LSVT-sub25100-defpa,4,weighted-dpf+,block-composition,upc,equal-ncd,basic:GM-LM-RR-LSVT,sub25100,nopa,Unlocking,0.4,RandResponseMechanism,{'Optimal': 40},1732,1682,1739,0,63,1599,1732,1619,140,1732,1682,1739,0,63,1599,1732,1619,140,upc-block-composition
1499,sp_workloads,1690805680,wl_small_mem,1119,basic:GM-LM-RR-LSVT-sub25100-defpa,4,weighted-dpf+,block-composition,upc,equal-ncd,basic:GM-LM-RR-LSVT,sub25100,nopa,Unlocking,0.4,SVTLaplaceMechanism,{'Optimal': 40},1701,1631,1753,0,62,1541,1701,1569,212,1701,1631,1753,0,62,1541,1701,1569,212,upc-block-composition
1500,sp_workloads,1690805680,wl_small_mem,1120,gm:GM-sub25100-defpa,0,weighted-dpf+,block-composition-pa,poisson,ncd,gm:GM,sub25100,defpa,Unlocking,0.2,GaussianMechanism,{'Optimal': 40},18864461,1345041,130912,4749699,1106691,122080,14114762,238350,8832,6716,6728,6904,2980,5423,6414,3736,1305,490,poisson-block-composition-pa
1501,sp_workloads,1690805680,wl_small_mem,1121,gm:GM-sub25100-defpa,0,weighted-dpf+,block-composition-pa,poisson,ncd,gm:GM,sub25100,defpa,Unlocking,0.4,GaussianMechanism,{'Optimal': 40},18864461,1345041,130912,6523136,927004,114096,12341325,418037,16816,6716,6728,6904,2954,4737,6023,3762,1991,881,poisson-block-composition-pa
1502,sp_workloads,1690805680,wl_small_mem,1122,gm:GM-sub25100-defpa,0,weighted-dpf+,block-composition-pa,poisson,equal-ncd,gm:GM,sub25100,defpa,Unlocking,0.2,GaussianMechanism,{'Optimal': 40},6716,6728,6904,3338,5884,6904,3378,844,0,6716,6728,6904,3338,5884,6904,3378,844,0,poisson-block-composition-pa
1503,sp_workloads,1690805680,wl_small_mem,1123,gm:GM-sub25100-defpa,0,weighted-dpf+,block-composition-pa,poisson,equal-ncd,gm:GM,sub25100,defpa,Unlocking,0.4,GaussianMechanism,{'Optimal': 40},6716,6728,6904,3281,6158,6904,3435,570,0,6716,6728,6904,3281,6158,6904,3435,570,0,poisson-block-composition-pa
1504,sp_workloads,1690805680,wl_small_mem,1124,gm:GM-sub25100-defpa,1,weighted-dpf+,block-composition-pa,poisson,ncd,gm:GM,sub25100,defpa,Unlocking,0.2,GaussianMechanism,{'Optimal': 40},18715267,1320958,128176,4561068,1113654,120752,14154199,207304,7424,6673,6765,6731,2986,5586,6313,3687,1179,418,poisson-block-composition-pa
1505,sp_workloads,1690805680,wl_small_mem,1125,gm:GM-sub25100-defpa,1,weighted-dpf+,block-composition-pa,poisson,ncd,gm:GM,sub25100,defpa,Unlocking,0.4,GaussianMechanism,{'Optimal': 40},18715267,1320958,128176,6259067,916687,113824,12456200,404271,14352,6673,6765,6731,2981,4829,5954,3692,1936,777,poisson-block-composition-pa
1506,sp_workloads,1690805680,wl_small_mem,1126,gm:GM-sub25100-defpa,1,weighted-dpf+,block-composition-pa,poisson,equal-ncd,gm:GM,sub25100,defpa,Unlocking,0.2,GaussianMechanism,{'Optimal': 40},6673,6765,6731,3319,5880,6731,3354,885,0,6673,6765,6731,3319,5880,6731,3354,885,0,poisson-block-composition-pa
1507,sp_workloads,1690805680,wl_small_mem,1127,gm:GM-sub25100-defpa,1,weighted-dpf+,block-composition-pa,poisson,equal-ncd,gm:GM,sub25100,defpa,Unlocking,0.4,GaussianMechanism,{'Optimal': 40},6673,6765,6731,3310,6077,6731,3363,688,0,6673,6765,6731,3310,6077,6731,3363,688,0,poisson-block-composition-pa
1508,sp_workloads,1690805680,wl_small_mem,1128,gm:GM-sub25100-defpa,2,weighted-dpf+,block-composition-pa,poisson,ncd,gm:GM,sub25100,defpa,Unlocking,0.2,GaussianMechanism,{'Optimal': 40},18806374,1355979,126784,4464794,1140030,119888,14341580,215949,6896,6783,6833,6678,2977,5652,6285,3806,1181,393,poisson-block-composition-pa
1509,sp_workloads,1690805680,wl_small_mem,1129,gm:GM-sub25100-defpa,2,weighted-dpf+,block-composition-pa,poisson,ncd,gm:GM,sub25100,defpa,Unlocking,0.4,GaussianMechanism,{'Optimal': 40},18806374,1355979,126784,6430949,920513,112128,12375425,435466,14656,6783,6833,6678,2937,4773,5896,3846,2060,782,poisson-block-composition-pa
1510,sp_workloads,1690805680,wl_small_mem,1130,gm:GM-sub25100-defpa,2,weighted-dpf+,block-composition-pa,poisson,equal-ncd,gm:GM,sub25100,defpa,Unlocking,0.2,GaussianMechanism,{'Optimal': 40},6783,6833,6678,3331,6005,6678,3452,828,0,6783,6833,6678,3331,6005,6678,3452,828,0,poisson-block-composition-pa
1511,sp_workloads,1690805680,wl_small_mem,1131,gm:GM-sub25100-defpa,2,weighted-dpf+,block-composition-pa,poisson,equal-ncd,gm:GM,sub25100,defpa,Unlocking,0.4,GaussianMechanism,{'Optimal': 40},6783,6833,6678,3298,6232,6678,3485,601,0,6783,6833,6678,3298,6232,6678,3485,601,0,poisson-block-composition-pa
1512,sp_workloads,1690805680,wl_small_mem,1132,gm:GM-sub25100-defpa,3,weighted-dpf+,block-composition-pa,poisson,ncd,gm:GM,sub25100,defpa,Unlocking,0.2,GaussianMechanism,{'Optimal': 40},18672541,1292482,118587,4354110,1080704,112575,14318431,211778,6012,6771,6693,6629,2993,5552,6273,3778,1141,356,poisson-block-composition-pa
1513,sp_workloads,1690805680,wl_small_mem,1133,gm:GM-sub25100-defpa,3,weighted-dpf+,block-composition-pa,poisson,ncd,gm:GM,sub25100,defpa,Unlocking,0.4,GaussianMechanism,{'Optimal': 40},18672541,1292482,118587,6315115,865150,105291,12357426,427332,13296,6771,6693,6629,2953,4659,5877,3818,2034,752,poisson-block-composition-pa
1514,sp_workloads,1690805680,wl_small_mem,1134,gm:GM-sub25100-defpa,3,weighted-dpf+,block-composition-pa,poisson,equal-ncd,gm:GM,sub25100,defpa,Unlocking,0.2,GaussianMechanism,{'Optimal': 40},6771,6693,6629,3312,5866,6629,3459,827,0,6771,6693,6629,3312,5866,6629,3459,827,0,poisson-block-composition-pa
1515,sp_workloads,1690805680,wl_small_mem,1135,gm:GM-sub25100-defpa,3,weighted-dpf+,block-composition-pa,poisson,equal-ncd,gm:GM,sub25100,defpa,Unlocking,0.4,GaussianMechanism,{'Optimal': 40},6771,6693,6629,3289,6088,6629,3482,605,0,6771,6693,6629,3289,6088,6629,3482,605,0,poisson-block-composition-pa
1516,sp_workloads,1690805680,wl_small_mem,1136,gm:GM-sub25100-defpa,4,weighted-dpf+,block-composition-pa,poisson,ncd,gm:GM,sub25100,defpa,Unlocking,0.2,GaussianMechanism,{'Optimal': 40},18857452,1277663,120343,4571012,1068320,112361,14286440,209343,7982,6862,6691,6713,3022,5506,6231,3840,1185,482,poisson-block-composition-pa
1517,sp_workloads,1690805680,wl_small_mem,1137,gm:GM-sub25100-defpa,4,weighted-dpf+,block-composition-pa,poisson,ncd,gm:GM,sub25100,defpa,Unlocking,0.4,GaussianMechanism,{'Optimal': 40},18857452,1277663,120343,6424380,858041,106630,12433072,419622,13713,6862,6691,6713,2961,4672,5914,3901,2019,799,poisson-block-composition-pa
1518,sp_workloads,1690805680,wl_small_mem,1138,gm:GM-sub25100-defpa,4,weighted-dpf+,block-composition-pa,poisson,equal-ncd,gm:GM,sub25100,defpa,Unlocking,0.2,GaussianMechanism,{'Optimal': 40},6862,6691,6713,3387,5817,6713,3475,874,0,6862,6691,6713,3387,5817,6713,3475,874,0,poisson-block-composition-pa
1519,sp_workloads,1690805680,wl_small_mem,1139,gm:GM-sub25100-defpa,4,weighted-dpf+,block-composition-pa,poisson,equal-ncd,gm:GM,sub25100,defpa,Unlocking,0.4,GaussianMechanism,{'Optimal': 40},6862,6691,6713,3357,6066,6713,3505,625,0,6862,6691,6713,3357,6066,6713,3505,625,0,poisson-block-composition-pa
1520,sp_workloads,1690805680,wl_small_mem,1140,ml:SGD-PATE-sub25100-defpa,0,weighted-dpf+,block-composition-pa,poisson,ncd,ml:SGD-PATE,sub25100,defpa,Unlocking,0.2,MLNoisySGDMechanism,{'Optimal': 40},9320337,647144,60780,1504500,79194,30285,7815837,567950,30495,3347,3348,3392,789,484,1884,2558,2864,1508,poisson-block-composition-pa
1521,sp_workloads,1690805680,wl_small_mem,1140,ml:SGD-PATE-sub25100-defpa,0,weighted-dpf+,block-composition-pa,poisson,ncd,ml:SGD-PATE,sub25100,defpa,Unlocking,0.2,MLPateGaussianMechanism,{'Optimal': 40},9560711,630849,59490,1044132,102089,28995,8516579,528760,30495,3488,3389,3328,532,756,1845,2956,2633,1483,poisson-block-composition-pa
1522,sp_workloads,1690805680,wl_small_mem,1141,ml:SGD-PATE-sub25100-defpa,0,weighted-dpf+,block-composition-pa,poisson,ncd,ml:SGD-PATE,sub25100,defpa,Unlocking,0.4,MLNoisySGDMechanism,{'Optimal': 40},9320337,647144,60780,1495556,87018,29385,7824781,560126,31395,3347,3348,3392,792,562,1853,2555,2786,1539,poisson-block-composition-pa
1523,sp_workloads,1690805680,wl_small_mem,1141,ml:SGD-PATE-sub25100-defpa,0,weighted-dpf+,block-composition-pa,poisson,ncd,ml:SGD-PATE,sub25100,defpa,Unlocking,0.4,MLPateGaussianMechanism,{'Optimal': 40},9560711,630849,59490,1011654,113328,28890,8549057,517521,30600,3488,3389,3328,529,824,1844,2959,2565,1484,poisson-block-composition-pa
1524,sp_workloads,1690805680,wl_small_mem,1142,ml:SGD-PATE-sub25100-defpa,0,weighted-dpf+,block-composition-pa,poisson,equal-ncd,ml:SGD-PATE,sub25100,defpa,Unlocking,0.2,MLNoisySGDMechanism,{'Optimal': 40},3347,3348,3392,923,1749,3392,2424,1599,0,3347,3348,3392,923,1749,3392,2424,1599,0,poisson-block-composition-pa
1525,sp_workloads,1690805680,wl_small_mem,1142,ml:SGD-PATE-sub25100-defpa,0,weighted-dpf+,block-composition-pa,poisson,equal-ncd,ml:SGD-PATE,sub25100,defpa,Unlocking,0.2,MLPateGaussianMechanism,{'Optimal': 40},3488,3389,3328,117,1735,3328,3371,1654,0,3488,3389,3328,117,1735,3328,3371,1654,0,poisson-block-composition-pa
1526,sp_workloads,1690805680,wl_small_mem,1143,ml:SGD-PATE-sub25100-defpa,0,weighted-dpf+,block-composition-pa,poisson,equal-ncd,ml:SGD-PATE,sub25100,defpa,Unlocking,0.4,MLNoisySGDMechanism,{'Optimal': 40},3347,3348,3392,881,1766,3392,2466,1582,0,3347,3348,3392,881,1766,3392,2466,1582,0,poisson-block-composition-pa
1527,sp_workloads,1690805680,wl_small_mem,1143,ml:SGD-PATE-sub25100-defpa,0,weighted-dpf+,block-composition-pa,poisson,equal-ncd,ml:SGD-PATE,sub25100,defpa,Unlocking,0.4,MLPateGaussianMechanism,{'Optimal': 40},3488,3389,3328,132,1745,3328,3356,1644,0,3488,3389,3328,132,1745,3328,3356,1644,0,poisson-block-composition-pa
1528,sp_workloads,1690805680,wl_small_mem,1144,ml:SGD-PATE-sub25100-defpa,1,weighted-dpf+,block-composition-pa,poisson,ncd,ml:SGD-PATE,sub25100,defpa,Unlocking,0.2,MLNoisySGDMechanism,{'Optimal': 40},9612014,638642,60437,1543831,79052,31717,8068183,559590,28720,3436,3336,3371,799,484,1979,2637,2852,1392,poisson-block-composition-pa
1529,sp_workloads,1690805680,wl_small_mem,1144,ml:SGD-PATE-sub25100-defpa,1,weighted-dpf+,block-composition-pa,poisson,ncd,ml:SGD-PATE,sub25100,defpa,Unlocking,0.2,MLPateGaussianMechanism,{'Optimal': 40},9101816,660711,61026,1043974,89914,29225,8057842,570797,31801,3337,3307,3358,536,685,1863,2801,2622,1495,poisson-block-composition-pa
1530,sp_workloads,1690805680,wl_small_mem,1145,ml:SGD-PATE-sub25100-defpa,1,weighted-dpf+,block-composition-pa,poisson,ncd,ml:SGD-PATE,sub25100,defpa,Unlocking,0.4,MLNoisySGDMechanism,{'Optimal': 40},9612014,638642,60437,1578851,92972,31888,8033163,545670,28549,3436,3336,3371,825,573,1968,2611,2763,1403,poisson-block-composition-pa
1531,sp_workloads,1690805680,wl_small_mem,1145,ml:SGD-PATE-sub25100-defpa,1,weighted-dpf+,block-composition-pa,poisson,ncd,ml:SGD-PATE,sub25100,defpa,Unlocking,0.4,MLPateGaussianMechanism,{'Optimal': 40},9101816,660711,61026,1020927,88608,29820,8080889,572103,31206,3337,3307,3358,536,695,1876,2801,2612,1482,poisson-block-composition-pa
1532,sp_workloads,1690805680,wl_small_mem,1146,ml:SGD-PATE-sub25100-defpa,1,weighted-dpf+,block-composition-pa,poisson,equal-ncd,ml:SGD-PATE,sub25100,defpa,Unlocking,0.2,MLNoisySGDMechanism,{'Optimal': 40},3436,3336,3371,934,1721,3371,2502,1615,0,3436,3336,3371,934,1721,3371,2502,1615,0,poisson-block-composition-pa
1533,sp_workloads,1690805680,wl_small_mem,1146,ml:SGD-PATE-sub25100-defpa,1,weighted-dpf+,block-composition-pa,poisson,equal-ncd,ml:SGD-PATE,sub25100,defpa,Unlocking,0.2,MLPateGaussianMechanism,{'Optimal': 40},3337,3307,3358,116,1629,3358,3221,1678,0,3337,3307,3358,116,1629,3358,3221,1678,0,poisson-block-composition-pa
1534,sp_workloads,1690805680,wl_small_mem,1147,ml:SGD-PATE-sub25100-defpa,1,weighted-dpf+,block-composition-pa,poisson,equal-ncd,ml:SGD-PATE,sub25100,defpa,Unlocking,0.4,MLNoisySGDMechanism,{'Optimal': 40},3436,3336,3371,924,1723,3371,2512,1613,0,3436,3336,3371,924,1723,3371,2512,1613,0,poisson-block-composition-pa
1535,sp_workloads,1690805680,wl_small_mem,1147,ml:SGD-PATE-sub25100-defpa,1,weighted-dpf+,block-composition-pa,poisson,equal-ncd,ml:SGD-PATE,sub25100,defpa,Unlocking,0.4,MLPateGaussianMechanism,{'Optimal': 40},3337,3307,3358,125,1627,3358,3212,1680,0,3337,3307,3358,125,1627,3358,3212,1680,0,poisson-block-composition-pa
1536,sp_workloads,1690805680,wl_small_mem,1148,ml:SGD-PATE-sub25100-defpa,2,weighted-dpf+,block-composition-pa,poisson,ncd,ml:SGD-PATE,sub25100,defpa,Unlocking,0.2,MLNoisySGDMechanism,{'Optimal': 40},9102086,650387,61289,1493989,78711,30900,7608097,571676,30389,3387,3344,3399,768,499,1932,2619,2845,1467,poisson-block-composition-pa
1537,sp_workloads,1690805680,wl_small_mem,1148,ml:SGD-PATE-sub25100-defpa,2,weighted-dpf+,block-composition-pa,poisson,ncd,ml:SGD-PATE,sub25100,defpa,Unlocking,0.2,MLPateGaussianMechanism,{'Optimal': 40},9667159,651460,60587,1086856,102948,29979,8580303,548512,30608,3356,3340,3381,542,740,1909,2814,2600,1472,poisson-block-composition-pa
1538,sp_workloads,1690805680,wl_small_mem,1149,ml:SGD-PATE-sub25100-defpa,2,weighted-dpf+,block-composition-pa,poisson,ncd,ml:SGD-PATE,sub25100,defpa,Unlocking,0.4,MLNoisySGDMechanism,{'Optimal': 40},9102086,650387,61289,1498025,89024,31136,7604061,561363,30153,3387,3344,3399,779,574,1936,2608,2770,1463,poisson-block-composition-pa
1539,sp_workloads,1690805680,wl_small_mem,1149,ml:SGD-PATE-sub25100-defpa,2,weighted-dpf+,block-composition-pa,poisson,ncd,ml:SGD-PATE,sub25100,defpa,Unlocking,0.4,MLPateGaussianMechanism,{'Optimal': 40},9667159,651460,60587,1050687,102540,29485,8616472,548920,31102,3356,3340,3381,535,757,1891,2821,2583,1490,poisson-block-composition-pa
1540,sp_workloads,1690805680,wl_small_mem,1150,ml:SGD-PATE-sub25100-defpa,2,weighted-dpf+,block-composition-pa,poisson,equal-ncd,ml:SGD-PATE,sub25100,defpa,Unlocking,0.2,MLNoisySGDMechanism,{'Optimal': 40},3387,3344,3399,912,1773,3399,2475,1571,0,3387,3344,3399,912,1773,3399,2475,1571,0,poisson-block-composition-pa
1541,sp_workloads,1690805680,wl_small_mem,1150,ml:SGD-PATE-sub25100-defpa,2,weighted-dpf+,block-composition-pa,poisson,equal-ncd,ml:SGD-PATE,sub25100,defpa,Unlocking,0.2,MLPateGaussianMechanism,{'Optimal': 40},3356,3340,3381,132,1743,3381,3224,1597,0,3356,3340,3381,132,1743,3381,3224,1597,0,poisson-block-composition-pa
1542,sp_workloads,1690805680,wl_small_mem,1151,ml:SGD-PATE-sub25100-defpa,2,weighted-dpf+,block-composition-pa,poisson,equal-ncd,ml:SGD-PATE,sub25100,defpa,Unlocking,0.4,MLNoisySGDMechanism,{'Optimal': 40},3387,3344,3399,915,1763,3399,2472,1581,0,3387,3344,3399,915,1763,3399,2472,1581,0,poisson-block-composition-pa
1543,sp_workloads,1690805680,wl_small_mem,1151,ml:SGD-PATE-sub25100-defpa,2,weighted-dpf+,block-composition-pa,poisson,equal-ncd,ml:SGD-PATE,sub25100,defpa,Unlocking,0.4,MLPateGaussianMechanism,{'Optimal': 40},3356,3340,3381,116,1739,3381,3240,1601,0,3356,3340,3381,116,1739,3381,3240,1601,0,poisson-block-composition-pa
1544,sp_workloads,1690805680,wl_small_mem,1152,ml:SGD-PATE-sub25100-defpa,3,weighted-dpf+,block-composition-pa,poisson,ncd,ml:SGD-PATE,sub25100,defpa,Unlocking,0.2,MLNoisySGDMechanism,{'Optimal': 40},9538338,661542,60462,1468874,92407,31455,8069464,569135,29007,3432,3504,3362,762,551,1969,2670,2953,1393,poisson-block-composition-pa
1545,sp_workloads,1690805680,wl_small_mem,1152,ml:SGD-PATE-sub25100-defpa,3,weighted-dpf+,block-composition-pa,poisson,ncd,ml:SGD-PATE,sub25100,defpa,Unlocking,0.2,MLPateGaussianMechanism,{'Optimal': 40},9431567,656376,60193,1097681,92076,29648,8333886,564300,30545,3379,3400,3343,563,721,1872,2816,2679,1471,poisson-block-composition-pa
1546,sp_workloads,1690805680,wl_small_mem,1153,ml:SGD-PATE-sub25100-defpa,3,weighted-dpf+,block-composition-pa,poisson,ncd,ml:SGD-PATE,sub25100,defpa,Unlocking,0.4,MLNoisySGDMechanism,{'Optimal': 40},9538338,661542,60462,1458671,105813,32133,8079667,555729,28329,3432,3504,3362,770,618,1995,2662,2886,1367,poisson-block-composition-pa
1547,sp_workloads,1690805680,wl_small_mem,1153,ml:SGD-PATE-sub25100-defpa,3,weighted-dpf+,block-composition-pa,poisson,ncd,ml:SGD-PATE,sub25100,defpa,Unlocking,0.4,MLPateGaussianMechanism,{'Optimal': 40},9431567,656376,60193,1059752,101207,29598,8371815,555169,30595,3379,3400,3343,552,752,1874,2827,2648,1469,poisson-block-composition-pa
1548,sp_workloads,1690805680,wl_small_mem,1154,ml:SGD-PATE-sub25100-defpa,3,weighted-dpf+,block-composition-pa,poisson,equal-ncd,ml:SGD-PATE,sub25100,defpa,Unlocking,0.2,MLNoisySGDMechanism,{'Optimal': 40},3432,3504,3362,899,1826,3362,2533,1678,0,3432,3504,3362,899,1826,3362,2533,1678,0,poisson-block-composition-pa
1549,sp_workloads,1690805680,wl_small_mem,1154,ml:SGD-PATE-sub25100-defpa,3,weighted-dpf+,block-composition-pa,poisson,equal-ncd,ml:SGD-PATE,sub25100,defpa,Unlocking,0.2,MLPateGaussianMechanism,{'Optimal': 40},3379,3400,3343,130,1743,3343,3249,1657,0,3379,3400,3343,130,1743,3343,3249,1657,0,poisson-block-composition-pa
1550,sp_workloads,1690805680,wl_small_mem,1155,ml:SGD-PATE-sub25100-defpa,3,weighted-dpf+,block-composition-pa,poisson,equal-ncd,ml:SGD-PATE,sub25100,defpa,Unlocking,0.4,MLNoisySGDMechanism,{'Optimal': 40},3432,3504,3362,895,1828,3362,2537,1676,0,3432,3504,3362,895,1828,3362,2537,1676,0,poisson-block-composition-pa
1551,sp_workloads,1690805680,wl_small_mem,1155,ml:SGD-PATE-sub25100-defpa,3,weighted-dpf+,block-composition-pa,poisson,equal-ncd,ml:SGD-PATE,sub25100,defpa,Unlocking,0.4,MLPateGaussianMechanism,{'Optimal': 40},3379,3400,3343,135,1736,3343,3244,1664,0,3379,3400,3343,135,1736,3343,3244,1664,0,poisson-block-composition-pa
1552,sp_workloads,1690805680,wl_small_mem,1156,ml:SGD-PATE-sub25100-defpa,4,weighted-dpf+,block-composition-pa,poisson,ncd,ml:SGD-PATE,sub25100,defpa,Unlocking,0.2,MLNoisySGDMechanism,{'Optimal': 40},9619476,680600,63408,1581722,75911,32464,8037754,604689,30944,3443,3381,3350,796,488,1900,2647,2893,1450,poisson-block-composition-pa
1553,sp_workloads,1690805680,wl_small_mem,1156,ml:SGD-PATE-sub25100-defpa,4,weighted-dpf+,block-composition-pa,poisson,ncd,ml:SGD-PATE,sub25100,defpa,Unlocking,0.2,MLPateGaussianMechanism,{'Optimal': 40},9087643,650021,64528,1076840,88050,32688,8010803,561971,31840,3245,3345,3408,531,662,1945,2714,2683,1463,poisson-block-composition-pa
1554,sp_workloads,1690805680,wl_small_mem,1157,ml:SGD-PATE-sub25100-defpa,4,weighted-dpf+,block-composition-pa,poisson,ncd,ml:SGD-PATE,sub25100,defpa,Unlocking,0.4,MLNoisySGDMechanism,{'Optimal': 40},9619476,680600,63408,1575439,91170,32080,8044037,589430,31328,3443,3381,3350,792,587,1876,2651,2794,1474,poisson-block-composition-pa
1555,sp_workloads,1690805680,wl_small_mem,1157,ml:SGD-PATE-sub25100-defpa,4,weighted-dpf+,block-composition-pa,poisson,ncd,ml:SGD-PATE,sub25100,defpa,Unlocking,0.4,MLPateGaussianMechanism,{'Optimal': 40},9087643,650021,64528,1039609,96784,31984,8048034,553237,32544,3245,3345,3408,536,759,1923,2709,2586,1485,poisson-block-composition-pa
1556,sp_workloads,1690805680,wl_small_mem,1158,ml:SGD-PATE-sub25100-defpa,4,weighted-dpf+,block-composition-pa,poisson,equal-ncd,ml:SGD-PATE,sub25100,defpa,Unlocking,0.2,MLNoisySGDMechanism,{'Optimal': 40},3443,3381,3350,922,1756,3350,2521,1625,0,3443,3381,3350,922,1756,3350,2521,1625,0,poisson-block-composition-pa
1557,sp_workloads,1690805680,wl_small_mem,1158,ml:SGD-PATE-sub25100-defpa,4,weighted-dpf+,block-composition-pa,poisson,equal-ncd,ml:SGD-PATE,sub25100,defpa,Unlocking,0.2,MLPateGaussianMechanism,{'Optimal': 40},3245,3345,3408,127,1675,3408,3118,1670,0,3245,3345,3408,127,1675,3408,3118,1670,0,poisson-block-composition-pa
1558,sp_workloads,1690805680,wl_small_mem,1159,ml:SGD-PATE-sub25100-defpa,4,weighted-dpf+,block-composition-pa,poisson,equal-ncd,ml:SGD-PATE,sub25100,defpa,Unlocking,0.4,MLNoisySGDMechanism,{'Optimal': 40},3443,3381,3350,905,1768,3350,2538,1613,0,3443,3381,3350,905,1768,3350,2538,1613,0,poisson-block-composition-pa
1559,sp_workloads,1690805680,wl_small_mem,1159,ml:SGD-PATE-sub25100-defpa,4,weighted-dpf+,block-composition-pa,poisson,equal-ncd,ml:SGD-PATE,sub25100,defpa,Unlocking,0.4,MLPateGaussianMechanism,{'Optimal': 40},3245,3345,3408,133,1679,3408,3112,1666,0,3245,3345,3408,133,1679,3408,3112,1666,0,poisson-block-composition-pa
1560,sp_workloads,1690805680,wl_small_mem,1160,mixed:GM-LM-RR-LSVT-SGD-PATE-sub25100-defpa,0,weighted-dpf+,block-composition-pa,poisson,ncd,mixed:GM-LM-RR-LSVT-SGD-PATE,sub25100,defpa,Unlocking,0.2,GaussianMechanism,{'Optimal': 40},3326864,216518,19768,375185,119690,15850,2951679,96828,3918,1098,1121,1112,248,611,902,850,510,210,poisson-block-composition-pa
1561,sp_workloads,1690805680,wl_small_mem,1160,mixed:GM-LM-RR-LSVT-SGD-PATE-sub25100-defpa,0,weighted-dpf+,block-composition-pa,poisson,ncd,mixed:GM-LM-RR-LSVT-SGD-PATE,sub25100,defpa,Unlocking,0.2,LaplaceMechanism,{'Optimal': 40},3160262,214484,19740,1168121,124661,18812,1992141,89823,928,1133,1141,1092,481,721,1044,652,420,48,poisson-block-composition-pa
1562,sp_workloads,1690805680,wl_small_mem,1160,mixed:GM-LM-RR-LSVT-SGD-PATE-sub25100-defpa,0,weighted-dpf+,block-composition-pa,poisson,ncd,mixed:GM-LM-RR-LSVT-SGD-PATE,sub25100,defpa,Unlocking,0.2,MLNoisySGDMechanism,{'Optimal': 40},3049683,202901,20644,25671,8236,2986,3024012,194665,17658,1124,1132,1148,18,56,182,1106,1076,966,poisson-block-composition-pa
1563,sp_workloads,1690805680,wl_small_mem,1160,mixed:GM-LM-RR-LSVT-SGD-PATE-sub25100-defpa,0,weighted-dpf+,block-composition-pa,poisson,ncd,mixed:GM-LM-RR-LSVT-SGD-PATE,sub25100,defpa,Unlocking,0.2,MLPateGaussianMechanism,{'Optimal': 40},3104776,219595,19804,27063,12647,4779,3077713,206948,15025,1159,1162,1108,23,91,293,1136,1071,815,poisson-block-composition-pa
1564,sp_workloads,1690805680,wl_small_mem,1160,mixed:GM-LM-RR-LSVT-SGD-PATE-sub25100-defpa,0,weighted-dpf+,block-composition-pa,poisson,ncd,mixed:GM-LM-RR-LSVT-SGD-PATE,sub25100,defpa,Unlocking,0.2,RandResponseMechanism,{'Optimal': 40},3027994,204361,19932,103383,13076,11394,2924611,191285,8538,1129,1138,1140,47,73,686,1082,1065,454,poisson-block-composition-pa
1565,sp_workloads,1690805680,wl_small_mem,1160,mixed:GM-LM-RR-LSVT-SGD-PATE-sub25100-defpa,0,weighted-dpf+,block-composition-pa,poisson,ncd,mixed:GM-LM-RR-LSVT-SGD-PATE,sub25100,defpa,Unlocking,0.2,SVTLaplaceMechanism,{'Optimal': 40},3254745,215442,20539,155740,14800,9702,3099005,200642,10837,1155,1111,1125,63,82,554,1092,1029,571,poisson-block-composition-pa
1566,sp_workloads,1690805680,wl_small_mem,1161,mixed:GM-LM-RR-LSVT-SGD-PATE-sub25100-defpa,0,weighted-dpf+,block-composition-pa,poisson,ncd,mixed:GM-LM-RR-LSVT-SGD-PATE,sub25100,defpa,Unlocking,0.4,GaussianMechanism,{'Optimal': 40},3326864,216518,19768,431863,114348,15414,2895001,102170,4354,1098,1121,1112,263,605,890,835,516,222,poisson-block-composition-pa
1567,sp_workloads,1690805680,wl_small_mem,1161,mixed:GM-LM-RR-LSVT-SGD-PATE-sub25100-defpa,0,weighted-dpf+,block-composition-pa,poisson,ncd,mixed:GM-LM-RR-LSVT-SGD-PATE,sub25100,defpa,Unlocking,0.4,LaplaceMechanism,{'Optimal': 40},3160262,214484,19740,1408310,117896,18859,1751952,96588,881,1133,1141,1092,551,695,1045,582,446,47,poisson-block-composition-pa
1568,sp_workloads,1690805680,wl_small_mem,1161,mixed:GM-LM-RR-LSVT-SGD-PATE-sub25100-defpa,0,weighted-dpf+,block-composition-pa,poisson,ncd,mixed:GM-LM-RR-LSVT-SGD-PATE,sub25100,defpa,Unlocking,0.4,MLNoisySGDMechanism,{'Optimal': 40},3049683,202901,20644,9002,7009,2727,3040681,195892,17917,1124,1132,1148,13,67,169,1111,1065,979,poisson-block-composition-pa
1569,sp_workloads,1690805680,wl_small_mem,1161,mixed:GM-LM-RR-LSVT-SGD-PATE-sub25100-defpa,0,weighted-dpf+,block-composition-pa,poisson,ncd,mixed:GM-LM-RR-LSVT-SGD-PATE,sub25100,defpa,Unlocking,0.4,MLPateGaussianMechanism,{'Optimal': 40},3104776,219595,19804,23119,11965,4865,3081657,207630,14939,1159,1162,1108,14,71,303,1145,1091,805,poisson-block-composition-pa
1570,sp_workloads,1690805680,wl_small_mem,1161,mixed:GM-LM-RR-LSVT-SGD-PATE-sub25100-defpa,0,weighted-dpf+,block-composition-pa,poisson,ncd,mixed:GM-LM-RR-LSVT-SGD-PATE,sub25100,defpa,Unlocking,0.4,RandResponseMechanism,{'Optimal': 40},3027994,204361,19932,161224,12337,11031,2866770,192024,8901,1129,1138,1140,59,83,665,1070,1055,475,poisson-block-composition-pa
1571,sp_workloads,1690805680,wl_small_mem,1161,mixed:GM-LM-RR-LSVT-SGD-PATE-sub25100-defpa,0,weighted-dpf+,block-composition-pa,poisson,ncd,mixed:GM-LM-RR-LSVT-SGD-PATE,sub25100,defpa,Unlocking,0.4,SVTLaplaceMechanism,{'Optimal': 40},3254745,215442,20539,201317,13030,9192,3053428,202412,11347,1155,1111,1125,66,74,536,1089,1037,589,poisson-block-composition-pa
1572,sp_workloads,1690805680,wl_small_mem,1162,mixed:GM-LM-RR-LSVT-SGD-PATE-sub25100-defpa,0,weighted-dpf+,block-composition-pa,poisson,equal-ncd,mixed:GM-LM-RR-LSVT-SGD-PATE,sub25100,defpa,Unlocking,0.2,GaussianMechanism,{'Optimal': 40},1098,1121,1112,262,713,998,836,408,114,1098,1121,1112,262,713,998,836,408,114,poisson-block-composition-pa
1573,sp_workloads,1690805680,wl_small_mem,1162,mixed:GM-LM-RR-LSVT-SGD-PATE-sub25100-defpa,0,weighted-dpf+,block-composition-pa,poisson,equal-ncd,mixed:GM-LM-RR-LSVT-SGD-PATE,sub25100,defpa,Unlocking,0.2,LaplaceMechanism,{'Optimal': 40},1133,1141,1092,493,874,1091,640,267,1,1133,1141,1092,493,874,1091,640,267,1,poisson-block-composition-pa
1574,sp_workloads,1690805680,wl_small_mem,1162,mixed:GM-LM-RR-LSVT-SGD-PATE-sub25100-defpa,0,weighted-dpf+,block-composition-pa,poisson,equal-ncd,mixed:GM-LM-RR-LSVT-SGD-PATE,sub25100,defpa,Unlocking,0.2,MLNoisySGDMechanism,{'Optimal': 40},1124,1132,1148,22,85,261,1102,1047,887,1124,1132,1148,22,85,261,1102,1047,887,poisson-block-composition-pa
1575,sp_workloads,1690805680,wl_small_mem,1162,mixed:GM-LM-RR-LSVT-SGD-PATE-sub25100-defpa,0,weighted-dpf+,block-composition-pa,poisson,equal-ncd,mixed:GM-LM-RR-LSVT-SGD-PATE,sub25100,defpa,Unlocking,0.2,MLPateGaussianMechanism,{'Optimal': 40},1159,1162,1108,25,162,536,1134,1000,572,1159,1162,1108,25,162,536,1134,1000,572,poisson-block-composition-pa
1576,sp_workloads,1690805680,wl_small_mem,1162,mixed:GM-LM-RR-LSVT-SGD-PATE-sub25100-defpa,0,weighted-dpf+,block-composition-pa,poisson,equal-ncd,mixed:GM-LM-RR-LSVT-SGD-PATE,sub25100,defpa,Unlocking,0.2,RandResponseMechanism,{'Optimal': 40},1129,1138,1140,38,172,930,1091,966,210,1129,1138,1140,38,172,930,1091,966,210,poisson-block-composition-pa
1577,sp_workloads,1690805680,wl_small_mem,1162,mixed:GM-LM-RR-LSVT-SGD-PATE-sub25100-defpa,0,weighted-dpf+,block-composition-pa,poisson,equal-ncd,mixed:GM-LM-RR-LSVT-SGD-PATE,sub25100,defpa,Unlocking,0.2,SVTLaplaceMechanism,{'Optimal': 40},1155,1111,1125,54,165,805,1101,946,320,1155,1111,1125,54,165,805,1101,946,320,poisson-block-composition-pa
1578,sp_workloads,1690805680,wl_small_mem,1163,mixed:GM-LM-RR-LSVT-SGD-PATE-sub25100-defpa,0,weighted-dpf+,block-composition-pa,poisson,equal-ncd,mixed:GM-LM-RR-LSVT-SGD-PATE,sub25100,defpa,Unlocking,0.4,GaussianMechanism,{'Optimal': 40},1098,1121,1112,290,755,1019,808,366,93,1098,1121,1112,290,755,1019,808,366,93,poisson-block-composition-pa
1579,sp_workloads,1690805680,wl_small_mem,1163,mixed:GM-LM-RR-LSVT-SGD-PATE-sub25100-defpa,0,weighted-dpf+,block-composition-pa,poisson,equal-ncd,mixed:GM-LM-RR-LSVT-SGD-PATE,sub25100,defpa,Unlocking,0.4,LaplaceMechanism,{'Optimal': 40},1133,1141,1092,523,903,1092,610,238,0,1133,1141,1092,523,903,1092,610,238,0,poisson-block-composition-pa
1580,sp_workloads,1690805680,wl_small_mem,1163,mixed:GM-LM-RR-LSVT-SGD-PATE-sub25100-defpa,0,weighted-dpf+,block-composition-pa,poisson,equal-ncd,mixed:GM-LM-RR-LSVT-SGD-PATE,sub25100,defpa,Unlocking,0.4,MLNoisySGDMechanism,{'Optimal': 40},1124,1132,1148,24,99,331,1100,1033,817,1124,1132,1148,24,99,331,1100,1033,817,poisson-block-composition-pa
1581,sp_workloads,1690805680,wl_small_mem,1163,mixed:GM-LM-RR-LSVT-SGD-PATE-sub25100-defpa,0,weighted-dpf+,block-composition-pa,poisson,equal-ncd,mixed:GM-LM-RR-LSVT-SGD-PATE,sub25100,defpa,Unlocking,0.4,MLPateGaussianMechanism,{'Optimal': 40},1159,1162,1108,22,189,609,1137,973,499,1159,1162,1108,22,189,609,1137,973,499,poisson-block-composition-pa
1582,sp_workloads,1690805680,wl_small_mem,1163,mixed:GM-LM-RR-LSVT-SGD-PATE-sub25100-defpa,0,weighted-dpf+,block-composition-pa,poisson,equal-ncd,mixed:GM-LM-RR-LSVT-SGD-PATE,sub25100,defpa,Unlocking,0.4,RandResponseMechanism,{'Optimal': 40},1129,1138,1140,41,174,1032,1088,964,108,1129,1138,1140,41,174,1032,1088,964,108,poisson-block-composition-pa
1583,sp_workloads,1690805680,wl_small_mem,1163,mixed:GM-LM-RR-LSVT-SGD-PATE-sub25100-defpa,0,weighted-dpf+,block-composition-pa,poisson,equal-ncd,mixed:GM-LM-RR-LSVT-SGD-PATE,sub25100,defpa,Unlocking,0.4,SVTLaplaceMechanism,{'Optimal': 40},1155,1111,1125,58,176,921,1097,935,204,1155,1111,1125,58,176,921,1097,935,204,poisson-block-composition-pa
1584,sp_workloads,1690805680,wl_small_mem,1164,mixed:GM-LM-RR-LSVT-SGD-PATE-sub25100-defpa,1,weighted-dpf+,block-composition-pa,poisson,ncd,mixed:GM-LM-RR-LSVT-SGD-PATE,sub25100,defpa,Unlocking,0.2,GaussianMechanism,{'Optimal': 40},3139319,215782,21216,378355,108863,17104,2760964,106919,4112,1075,1140,1126,227,613,917,848,527,209,poisson-block-composition-pa
1585,sp_workloads,1690805680,wl_small_mem,1164,mixed:GM-LM-RR-LSVT-SGD-PATE-sub25100-defpa,1,weighted-dpf+,block-composition-pa,poisson,ncd,mixed:GM-LM-RR-LSVT-SGD-PATE,sub25100,defpa,Unlocking,0.2,LaplaceMechanism,{'Optimal': 40},3080200,239601,21344,1229932,147184,20640,1850268,92417,704,1140,1163,1130,509,753,1096,631,410,34,poisson-block-composition-pa
1586,sp_workloads,1690805680,wl_small_mem,1164,mixed:GM-LM-RR-LSVT-SGD-PATE-sub25100-defpa,1,weighted-dpf+,block-composition-pa,poisson,ncd,mixed:GM-LM-RR-LSVT-SGD-PATE,sub25100,defpa,Unlocking,0.2,MLNoisySGDMechanism,{'Optimal': 40},3197047,217314,22128,17225,6560,3360,3179822,210754,18768,1145,1089,1161,11,51,197,1134,1038,964,poisson-block-composition-pa
1587,sp_workloads,1690805680,wl_small_mem,1164,mixed:GM-LM-RR-LSVT-SGD-PATE-sub25100-defpa,1,weighted-dpf+,block-composition-pa,poisson,ncd,mixed:GM-LM-RR-LSVT-SGD-PATE,sub25100,defpa,Unlocking,0.2,MLPateGaussianMechanism,{'Optimal': 40},3203621,231498,21632,23159,11956,5440,3180462,219542,16192,1163,1144,1138,18,76,308,1145,1068,830,poisson-block-composition-pa
1588,sp_workloads,1690805680,wl_small_mem,1164,mixed:GM-LM-RR-LSVT-SGD-PATE-sub25100-defpa,1,weighted-dpf+,block-composition-pa,poisson,ncd,mixed:GM-LM-RR-LSVT-SGD-PATE,sub25100,defpa,Unlocking,0.2,RandResponseMechanism,{'Optimal': 40},3122577,243521,22560,114046,20926,12576,3008531,222595,9984,1093,1164,1181,51,102,697,1042,1062,484,poisson-block-composition-pa
1589,sp_workloads,1690805680,wl_small_mem,1164,mixed:GM-LM-RR-LSVT-SGD-PATE-sub25100-defpa,1,weighted-dpf+,block-composition-pa,poisson,ncd,mixed:GM-LM-RR-LSVT-SGD-PATE,sub25100,defpa,Unlocking,0.2,SVTLaplaceMechanism,{'Optimal': 40},3189411,227364,20784,130994,14002,9952,3058417,213362,10832,1178,1127,1089,62,87,557,1116,1040,532,poisson-block-composition-pa
1590,sp_workloads,1690805680,wl_small_mem,1165,mixed:GM-LM-RR-LSVT-SGD-PATE-sub25100-defpa,1,weighted-dpf+,block-composition-pa,poisson,ncd,mixed:GM-LM-RR-LSVT-SGD-PATE,sub25100,defpa,Unlocking,0.4,GaussianMechanism,{'Optimal': 40},3139319,215782,21216,487564,122176,17440,2651755,93606,3776,1075,1140,1126,252,664,931,823,476,195,poisson-block-composition-pa
1591,sp_workloads,1690805680,wl_small_mem,1165,mixed:GM-LM-RR-LSVT-SGD-PATE-sub25100-defpa,1,weighted-dpf+,block-composition-pa,poisson,ncd,mixed:GM-LM-RR-LSVT-SGD-PATE,sub25100,defpa,Unlocking,0.4,LaplaceMechanism,{'Optimal': 40},3080200,239601,21344,1434887,140658,20608,1645313,98943,736,1140,1163,1130,575,737,1092,565,426,38,poisson-block-composition-pa
1592,sp_workloads,1690805680,wl_small_mem,1165,mixed:GM-LM-RR-LSVT-SGD-PATE-sub25100-defpa,1,weighted-dpf+,block-composition-pa,poisson,ncd,mixed:GM-LM-RR-LSVT-SGD-PATE,sub25100,defpa,Unlocking,0.4,MLNoisySGDMechanism,{'Optimal': 40},3197047,217314,22128,33934,7196,3728,3163113,210118,18400,1145,1089,1161,13,53,212,1132,1036,949,poisson-block-composition-pa
1593,sp_workloads,1690805680,wl_small_mem,1165,mixed:GM-LM-RR-LSVT-SGD-PATE-sub25100-defpa,1,weighted-dpf+,block-composition-pa,poisson,ncd,mixed:GM-LM-RR-LSVT-SGD-PATE,sub25100,defpa,Unlocking,0.4,MLPateGaussianMechanism,{'Optimal': 40},3203621,231498,21632,20974,7644,5936,3182647,223854,15696,1163,1144,1138,18,66,327,1145,1078,811,poisson-block-composition-pa
1594,sp_workloads,1690805680,wl_small_mem,1165,mixed:GM-LM-RR-LSVT-SGD-PATE-sub25100-defpa,1,weighted-dpf+,block-composition-pa,poisson,ncd,mixed:GM-LM-RR-LSVT-SGD-PATE,sub25100,defpa,Unlocking,0.4,RandResponseMechanism,{'Optimal': 40},3122577,243521,22560,120073,22239,12416,3002504,221282,10144,1093,1164,1181,61,111,676,1032,1053,505,poisson-block-composition-pa
1595,sp_workloads,1690805680,wl_small_mem,1165,mixed:GM-LM-RR-LSVT-SGD-PATE-sub25100-defpa,1,weighted-dpf+,block-composition-pa,poisson,ncd,mixed:GM-LM-RR-LSVT-SGD-PATE,sub25100,defpa,Unlocking,0.4,SVTLaplaceMechanism,{'Optimal': 40},3189411,227364,20784,140643,15331,10032,3048768,212033,10752,1178,1127,1089,62,103,558,1116,1024,531,poisson-block-composition-pa
1596,sp_workloads,1690805680,wl_small_mem,1166,mixed:GM-LM-RR-LSVT-SGD-PATE-sub25100-defpa,1,weighted-dpf+,block-composition-pa,poisson,equal-ncd,mixed:GM-LM-RR-LSVT-SGD-PATE,sub25100,defpa,Unlocking,0.2,GaussianMechanism,{'Optimal': 40},1075,1140,1126,228,750,1041,847,390,85,1075,1140,1126,228,750,1041,847,390,85,poisson-block-composition-pa
1597,sp_workloads,1690805680,wl_small_mem,1166,mixed:GM-LM-RR-LSVT-SGD-PATE-sub25100-defpa,1,weighted-dpf+,block-composition-pa,poisson,equal-ncd,mixed:GM-LM-RR-LSVT-SGD-PATE,sub25100,defpa,Unlocking,0.2,LaplaceMechanism,{'Optimal': 40},1140,1163,1130,517,886,1129,623,277,1,1140,1163,1130,517,886,1129,623,277,1,poisson-block-composition-pa
1598,sp_workloads,1690805680,wl_small_mem,1166,mixed:GM-LM-RR-LSVT-SGD-PATE-sub25100-defpa,1,weighted-dpf+,block-composition-pa,poisson,equal-ncd,mixed:GM-LM-RR-LSVT-SGD-PATE,sub25100,defpa,Unlocking,0.2,MLNoisySGDMechanism,{'Optimal': 40},1145,1089,1161,19,84,317,1126,1005,844,1145,1089,1161,19,84,317,1126,1005,844,poisson-block-composition-pa
1599,sp_workloads,1690805680,wl_small_mem,1166,mixed:GM-LM-RR-LSVT-SGD-PATE-sub25100-defpa,1,weighted-dpf+,block-composition-pa,poisson,equal-ncd,mixed:GM-LM-RR-LSVT-SGD-PATE,sub25100,defpa,Unlocking,0.2,MLPateGaussianMechanism,{'Optimal': 40},1163,1144,1138,29,187,649,1134,957,489,1163,1144,1138,29,187,649,1134,957,489,poisson-block-composition-pa
1600,sp_workloads,1690805680,wl_small_mem,1166,mixed:GM-LM-RR-LSVT-SGD-PATE-sub25100-defpa,1,weighted-dpf+,block-composition-pa,poisson,equal-ncd,mixed:GM-LM-RR-LSVT-SGD-PATE,sub25100,defpa,Unlocking,0.2,RandResponseMechanism,{'Optimal': 40},1093,1164,1181,46,196,990,1047,968,191,1093,1164,1181,46,196,990,1047,968,191,poisson-block-composition-pa
1601,sp_workloads,1690805680,wl_small_mem,1166,mixed:GM-LM-RR-LSVT-SGD-PATE-sub25100-defpa,1,weighted-dpf+,block-composition-pa,poisson,equal-ncd,mixed:GM-LM-RR-LSVT-SGD-PATE,sub25100,defpa,Unlocking,0.2,SVTLaplaceMechanism,{'Optimal': 40},1178,1127,1089,53,200,865,1125,927,224,1178,1127,1089,53,200,865,1125,927,224,poisson-block-composition-pa
1602,sp_workloads,1690805680,wl_small_mem,1167,mixed:GM-LM-RR-LSVT-SGD-PATE-sub25100-defpa,1,weighted-dpf+,block-composition-pa,poisson,equal-ncd,mixed:GM-LM-RR-LSVT-SGD-PATE,sub25100,defpa,Unlocking,0.4,GaussianMechanism,{'Optimal': 40},1075,1140,1126,261,761,1033,814,379,93,1075,1140,1126,261,761,1033,814,379,93,poisson-block-composition-pa
1603,sp_workloads,1690805680,wl_small_mem,1167,mixed:GM-LM-RR-LSVT-SGD-PATE-sub25100-defpa,1,weighted-dpf+,block-composition-pa,poisson,equal-ncd,mixed:GM-LM-RR-LSVT-SGD-PATE,sub25100,defpa,Unlocking,0.4,LaplaceMechanism,{'Optimal': 40},1140,1163,1130,543,903,1130,597,260,0,1140,1163,1130,543,903,1130,597,260,0,poisson-block-composition-pa
1604,sp_workloads,1690805680,wl_small_mem,1167,mixed:GM-LM-RR-LSVT-SGD-PATE-sub25100-defpa,1,weighted-dpf+,block-composition-pa,poisson,equal-ncd,mixed:GM-LM-RR-LSVT-SGD-PATE,sub25100,defpa,Unlocking,0.4,MLNoisySGDMechanism,{'Optimal': 40},1145,1089,1161,14,70,331,1131,1019,830,1145,1089,1161,14,70,331,1131,1019,830,poisson-block-composition-pa
1605,sp_workloads,1690805680,wl_small_mem,1167,mixed:GM-LM-RR-LSVT-SGD-PATE-sub25100-defpa,1,weighted-dpf+,block-composition-pa,poisson,equal-ncd,mixed:GM-LM-RR-LSVT-SGD-PATE,sub25100,defpa,Unlocking,0.4,MLPateGaussianMechanism,{'Optimal': 40},1163,1144,1138,30,161,631,1133,983,507,1163,1144,1138,30,161,631,1133,983,507,poisson-block-composition-pa
1606,sp_workloads,1690805680,wl_small_mem,1167,mixed:GM-LM-RR-LSVT-SGD-PATE-sub25100-defpa,1,weighted-dpf+,block-composition-pa,poisson,equal-ncd,mixed:GM-LM-RR-LSVT-SGD-PATE,sub25100,defpa,Unlocking,0.4,RandResponseMechanism,{'Optimal': 40},1093,1164,1181,49,193,1026,1044,971,155,1093,1164,1181,49,193,1026,1044,971,155,poisson-block-composition-pa
1607,sp_workloads,1690805680,wl_small_mem,1167,mixed:GM-LM-RR-LSVT-SGD-PATE-sub25100-defpa,1,weighted-dpf+,block-composition-pa,poisson,equal-ncd,mixed:GM-LM-RR-LSVT-SGD-PATE,sub25100,defpa,Unlocking,0.4,SVTLaplaceMechanism,{'Optimal': 40},1178,1127,1089,52,200,901,1126,927,188,1178,1127,1089,52,200,901,1126,927,188,poisson-block-composition-pa
1608,sp_workloads,1690805680,wl_small_mem,1168,mixed:GM-LM-RR-LSVT-SGD-PATE-sub25100-defpa,2,weighted-dpf+,block-composition-pa,poisson,ncd,mixed:GM-LM-RR-LSVT-SGD-PATE,sub25100,defpa,Unlocking,0.2,GaussianMechanism,{'Optimal': 40},3297557,222693,20889,425144,120888,16836,2872413,101805,4053,1107,1156,1159,269,656,940,838,500,219,poisson-block-composition-pa
1609,sp_workloads,1690805680,wl_small_mem,1168,mixed:GM-LM-RR-LSVT-SGD-PATE-sub25100-defpa,2,weighted-dpf+,block-composition-pa,poisson,ncd,mixed:GM-LM-RR-LSVT-SGD-PATE,sub25100,defpa,Unlocking,0.2,LaplaceMechanism,{'Optimal': 40},2847135,226653,20024,1226339,136498,19248,1620796,90155,776,1061,1136,1112,476,719,1072,585,417,40,poisson-block-composition-pa
1610,sp_workloads,1690805680,wl_small_mem,1168,mixed:GM-LM-RR-LSVT-SGD-PATE-sub25100-defpa,2,weighted-dpf+,block-composition-pa,poisson,ncd,mixed:GM-LM-RR-LSVT-SGD-PATE,sub25100,defpa,Unlocking,0.2,MLNoisySGDMechanism,{'Optimal': 40},3065470,217531,20600,12120,5587,3808,3053350,211944,16792,1088,1113,1144,15,40,224,1073,1073,920,poisson-block-composition-pa
1611,sp_workloads,1690805680,wl_small_mem,1168,mixed:GM-LM-RR-LSVT-SGD-PATE-sub25100-defpa,2,weighted-dpf+,block-composition-pa,poisson,ncd,mixed:GM-LM-RR-LSVT-SGD-PATE,sub25100,defpa,Unlocking,0.2,MLPateGaussianMechanism,{'Optimal': 40},3183074,228777,19443,20403,13489,5609,3162671,215288,13834,1123,1178,1085,15,81,343,1108,1097,742,poisson-block-composition-pa
1612,sp_workloads,1690805680,wl_small_mem,1168,mixed:GM-LM-RR-LSVT-SGD-PATE-sub25100-defpa,2,weighted-dpf+,block-composition-pa,poisson,ncd,mixed:GM-LM-RR-LSVT-SGD-PATE,sub25100,defpa,Unlocking,0.2,RandResponseMechanism,{'Optimal': 40},3253029,217115,19830,139328,16066,10597,3113701,201049,9233,1136,1135,1114,52,95,635,1084,1040,479,poisson-block-composition-pa
1613,sp_workloads,1690805680,wl_small_mem,1168,mixed:GM-LM-RR-LSVT-SGD-PATE-sub25100-defpa,2,weighted-dpf+,block-composition-pa,poisson,ncd,mixed:GM-LM-RR-LSVT-SGD-PATE,sub25100,defpa,Unlocking,0.2,SVTLaplaceMechanism,{'Optimal': 40},3041723,217557,19755,124725,16262,8605,2916998,201295,11150,1106,1092,1109,52,91,515,1054,1001,594,poisson-block-composition-pa
1614,sp_workloads,1690805680,wl_small_mem,1169,mixed:GM-LM-RR-LSVT-SGD-PATE-sub25100-defpa,2,weighted-dpf+,block-composition-pa,poisson,ncd,mixed:GM-LM-RR-LSVT-SGD-PATE,sub25100,defpa,Unlocking,0.4,GaussianMechanism,{'Optimal': 40},3297557,222693,20889,552684,114653,16848,2744873,108040,4041,1107,1156,1159,291,648,944,816,508,215,poisson-block-composition-pa
1615,sp_workloads,1690805680,wl_small_mem,1169,mixed:GM-LM-RR-LSVT-SGD-PATE-sub25100-defpa,2,weighted-dpf+,block-composition-pa,poisson,ncd,mixed:GM-LM-RR-LSVT-SGD-PATE,sub25100,defpa,Unlocking,0.4,LaplaceMechanism,{'Optimal': 40},2847135,226653,20024,1427866,124683,19326,1419269,101970,698,1061,1136,1112,539,693,1074,522,443,38,poisson-block-composition-pa
1616,sp_workloads,1690805680,wl_small_mem,1169,mixed:GM-LM-RR-LSVT-SGD-PATE-sub25100-defpa,2,weighted-dpf+,block-composition-pa,poisson,ncd,mixed:GM-LM-RR-LSVT-SGD-PATE,sub25100,defpa,Unlocking,0.4,MLNoisySGDMechanism,{'Optimal': 40},3065470,217531,20600,22077,6547,3351,3043393,210984,17249,1088,1113,1144,17,56,201,1071,1057,943,poisson-block-composition-pa
1617,sp_workloads,1690805680,wl_small_mem,1169,mixed:GM-LM-RR-LSVT-SGD-PATE-sub25100-defpa,2,weighted-dpf+,block-composition-pa,poisson,ncd,mixed:GM-LM-RR-LSVT-SGD-PATE,sub25100,defpa,Unlocking,0.4,MLPateGaussianMechanism,{'Optimal': 40},3183074,228777,19443,26115,11356,6000,3156959,217421,13443,1123,1178,1085,19,73,368,1104,1105,717,poisson-block-composition-pa
1618,sp_workloads,1690805680,wl_small_mem,1169,mixed:GM-LM-RR-LSVT-SGD-PATE-sub25100-defpa,2,weighted-dpf+,block-composition-pa,poisson,ncd,mixed:GM-LM-RR-LSVT-SGD-PATE,sub25100,defpa,Unlocking,0.4,RandResponseMechanism,{'Optimal': 40},3253029,217115,19830,172193,14703,9960,3080836,202412,9870,1136,1135,1114,66,84,600,1070,1051,514,poisson-block-composition-pa
1619,sp_workloads,1690805680,wl_small_mem,1169,mixed:GM-LM-RR-LSVT-SGD-PATE-sub25100-defpa,2,weighted-dpf+,block-composition-pa,poisson,ncd,mixed:GM-LM-RR-LSVT-SGD-PATE,sub25100,defpa,Unlocking,0.4,SVTLaplaceMechanism,{'Optimal': 40},3041723,217557,19755,126988,14776,8576,2914735,202781,11179,1106,1092,1109,58,91,512,1048,1001,597,poisson-block-composition-pa
1620,sp_workloads,1690805680,wl_small_mem,1170,mixed:GM-LM-RR-LSVT-SGD-PATE-sub25100-defpa,2,weighted-dpf+,block-composition-pa,poisson,equal-ncd,mixed:GM-LM-RR-LSVT-SGD-PATE,sub25100,defpa,Unlocking,0.2,GaussianMechanism,{'Optimal': 40},1107,1156,1159,298,765,1088,809,391,71,1107,1156,1159,298,765,1088,809,391,71,poisson-block-composition-pa
1621,sp_workloads,1690805680,wl_small_mem,1170,mixed:GM-LM-RR-LSVT-SGD-PATE-sub25100-defpa,2,weighted-dpf+,block-composition-pa,poisson,equal-ncd,mixed:GM-LM-RR-LSVT-SGD-PATE,sub25100,defpa,Unlocking,0.2,LaplaceMechanism,{'Optimal': 40},1061,1136,1112,466,865,1112,595,271,0,1061,1136,1112,466,865,1112,595,271,0,poisson-block-composition-pa
1622,sp_workloads,1690805680,wl_small_mem,1170,mixed:GM-LM-RR-LSVT-SGD-PATE-sub25100-defpa,2,weighted-dpf+,block-composition-pa,poisson,equal-ncd,mixed:GM-LM-RR-LSVT-SGD-PATE,sub25100,defpa,Unlocking,0.2,MLNoisySGDMechanism,{'Optimal': 40},1088,1113,1144,22,89,344,1066,1024,800,1088,1113,1144,22,89,344,1066,1024,800,poisson-block-composition-pa
1623,sp_workloads,1690805680,wl_small_mem,1170,mixed:GM-LM-RR-LSVT-SGD-PATE-sub25100-defpa,2,weighted-dpf+,block-composition-pa,poisson,equal-ncd,mixed:GM-LM-RR-LSVT-SGD-PATE,sub25100,defpa,Unlocking,0.2,MLPateGaussianMechanism,{'Optimal': 40},1123,1178,1085,18,170,645,1105,1008,440,1123,1178,1085,18,170,645,1105,1008,440,poisson-block-composition-pa
1624,sp_workloads,1690805680,wl_small_mem,1170,mixed:GM-LM-RR-LSVT-SGD-PATE-sub25100-defpa,2,weighted-dpf+,block-composition-pa,poisson,equal-ncd,mixed:GM-LM-RR-LSVT-SGD-PATE,sub25100,defpa,Unlocking,0.2,RandResponseMechanism,{'Optimal': 40},1136,1135,1114,48,170,923,1088,965,191,1136,1135,1114,48,170,923,1088,965,191,poisson-block-composition-pa
1625,sp_workloads,1690805680,wl_small_mem,1170,mixed:GM-LM-RR-LSVT-SGD-PATE-sub25100-defpa,2,weighted-dpf+,block-composition-pa,poisson,equal-ncd,mixed:GM-LM-RR-LSVT-SGD-PATE,sub25100,defpa,Unlocking,0.2,SVTLaplaceMechanism,{'Optimal': 40},1106,1092,1109,52,170,844,1054,922,265,1106,1092,1109,52,170,844,1054,922,265,poisson-block-composition-pa
1626,sp_workloads,1690805680,wl_small_mem,1171,mixed:GM-LM-RR-LSVT-SGD-PATE-sub25100-defpa,2,weighted-dpf+,block-composition-pa,poisson,equal-ncd,mixed:GM-LM-RR-LSVT-SGD-PATE,sub25100,defpa,Unlocking,0.4,GaussianMechanism,{'Optimal': 40},1107,1156,1159,306,784,1075,801,372,84,1107,1156,1159,306,784,1075,801,372,84,poisson-block-composition-pa
1627,sp_workloads,1690805680,wl_small_mem,1171,mixed:GM-LM-RR-LSVT-SGD-PATE-sub25100-defpa,2,weighted-dpf+,block-composition-pa,poisson,equal-ncd,mixed:GM-LM-RR-LSVT-SGD-PATE,sub25100,defpa,Unlocking,0.4,LaplaceMechanism,{'Optimal': 40},1061,1136,1112,500,882,1110,561,254,2,1061,1136,1112,500,882,1110,561,254,2,poisson-block-composition-pa
1628,sp_workloads,1690805680,wl_small_mem,1171,mixed:GM-LM-RR-LSVT-SGD-PATE-sub25100-defpa,2,weighted-dpf+,block-composition-pa,poisson,equal-ncd,mixed:GM-LM-RR-LSVT-SGD-PATE,sub25100,defpa,Unlocking,0.4,MLNoisySGDMechanism,{'Optimal': 40},1088,1113,1144,23,84,360,1065,1029,784,1088,1113,1144,23,84,360,1065,1029,784,poisson-block-composition-pa
1629,sp_workloads,1690805680,wl_small_mem,1171,mixed:GM-LM-RR-LSVT-SGD-PATE-sub25100-defpa,2,weighted-dpf+,block-composition-pa,poisson,equal-ncd,mixed:GM-LM-RR-LSVT-SGD-PATE,sub25100,defpa,Unlocking,0.4,MLPateGaussianMechanism,{'Optimal': 40},1123,1178,1085,31,184,652,1092,994,433,1123,1178,1085,31,184,652,1092,994,433,poisson-block-composition-pa
1630,sp_workloads,1690805680,wl_small_mem,1171,mixed:GM-LM-RR-LSVT-SGD-PATE-sub25100-defpa,2,weighted-dpf+,block-composition-pa,poisson,equal-ncd,mixed:GM-LM-RR-LSVT-SGD-PATE,sub25100,defpa,Unlocking,0.4,RandResponseMechanism,{'Optimal': 40},1136,1135,1114,56,184,937,1080,951,177,1136,1135,1114,56,184,937,1080,951,177,poisson-block-composition-pa
1631,sp_workloads,1690805680,wl_small_mem,1171,mixed:GM-LM-RR-LSVT-SGD-PATE-sub25100-defpa,2,weighted-dpf+,block-composition-pa,poisson,equal-ncd,mixed:GM-LM-RR-LSVT-SGD-PATE,sub25100,defpa,Unlocking,0.4,SVTLaplaceMechanism,{'Optimal': 40},1106,1092,1109,52,178,872,1054,914,237,1106,1092,1109,52,178,872,1054,914,237,poisson-block-composition-pa
1632,sp_workloads,1690805680,wl_small_mem,1172,mixed:GM-LM-RR-LSVT-SGD-PATE-sub25100-defpa,3,weighted-dpf+,block-composition-pa,poisson,ncd,mixed:GM-LM-RR-LSVT-SGD-PATE,sub25100,defpa,Unlocking,0.2,GaussianMechanism,{'Optimal': 40},3014106,221031,21056,434233,110540,16384,2579873,110491,4672,1094,1113,1104,279,597,871,815,516,233,poisson-block-composition-pa
1633,sp_workloads,1690805680,wl_small_mem,1172,mixed:GM-LM-RR-LSVT-SGD-PATE-sub25100-defpa,3,weighted-dpf+,block-composition-pa,poisson,ncd,mixed:GM-LM-RR-LSVT-SGD-PATE,sub25100,defpa,Unlocking,0.2,LaplaceMechanism,{'Optimal': 40},3356641,218178,20864,1270938,129025,20080,2085703,89153,784,1169,1154,1119,488,752,1083,681,402,36,poisson-block-composition-pa
1634,sp_workloads,1690805680,wl_small_mem,1172,mixed:GM-LM-RR-LSVT-SGD-PATE-sub25100-defpa,3,weighted-dpf+,block-composition-pa,poisson,ncd,mixed:GM-LM-RR-LSVT-SGD-PATE,sub25100,defpa,Unlocking,0.2,MLNoisySGDMechanism,{'Optimal': 40},2886113,212328,21728,11399,8712,3216,2874714,203616,18512,1057,1087,1124,12,47,185,1045,1040,939,poisson-block-composition-pa
1635,sp_workloads,1690805680,wl_small_mem,1172,mixed:GM-LM-RR-LSVT-SGD-PATE-sub25100-defpa,3,weighted-dpf+,block-composition-pa,poisson,ncd,mixed:GM-LM-RR-LSVT-SGD-PATE,sub25100,defpa,Unlocking,0.2,MLPateGaussianMechanism,{'Optimal': 40},3286989,218751,22304,25269,8857,5744,3261720,209894,16560,1114,1105,1168,19,64,330,1095,1041,838,poisson-block-composition-pa
1636,sp_workloads,1690805680,wl_small_mem,1172,mixed:GM-LM-RR-LSVT-SGD-PATE-sub25100-defpa,3,weighted-dpf+,block-composition-pa,poisson,ncd,mixed:GM-LM-RR-LSVT-SGD-PATE,sub25100,defpa,Unlocking,0.2,RandResponseMechanism,{'Optimal': 40},3304405,225397,21760,156400,9481,11696,3148005,215916,10064,1160,1175,1154,53,73,649,1107,1102,505,poisson-block-composition-pa
1637,sp_workloads,1690805680,wl_small_mem,1172,mixed:GM-LM-RR-LSVT-SGD-PATE-sub25100-defpa,3,weighted-dpf+,block-composition-pa,poisson,ncd,mixed:GM-LM-RR-LSVT-SGD-PATE,sub25100,defpa,Unlocking,0.2,SVTLaplaceMechanism,{'Optimal': 40},2975196,221951,22352,135763,15607,10176,2839433,206344,12176,1080,1132,1168,63,85,560,1017,1047,608,poisson-block-composition-pa
1638,sp_workloads,1690805680,wl_small_mem,1173,mixed:GM-LM-RR-LSVT-SGD-PATE-sub25100-defpa,3,weighted-dpf+,block-composition-pa,poisson,ncd,mixed:GM-LM-RR-LSVT-SGD-PATE,sub25100,defpa,Unlocking,0.4,GaussianMechanism,{'Optimal': 40},3014106,221031,21056,531047,122297,16656,2483059,98734,4400,1094,1113,1104,307,603,884,787,510,220,poisson-block-composition-pa
1639,sp_workloads,1690805680,wl_small_mem,1173,mixed:GM-LM-RR-LSVT-SGD-PATE-sub25100-defpa,3,weighted-dpf+,block-composition-pa,poisson,ncd,mixed:GM-LM-RR-LSVT-SGD-PATE,sub25100,defpa,Unlocking,0.4,LaplaceMechanism,{'Optimal': 40},3356641,218178,20864,1600878,122618,20288,1755763,95560,576,1169,1154,1119,577,708,1086,592,446,33,poisson-block-composition-pa
1640,sp_workloads,1690805680,wl_small_mem,1173,mixed:GM-LM-RR-LSVT-SGD-PATE-sub25100-defpa,3,weighted-dpf+,block-composition-pa,poisson,ncd,mixed:GM-LM-RR-LSVT-SGD-PATE,sub25100,defpa,Unlocking,0.4,MLNoisySGDMechanism,{'Optimal': 40},2886113,212328,21728,40596,7728,3808,2845517,204600,17920,1057,1087,1124,15,51,216,1042,1036,908,poisson-block-composition-pa
1641,sp_workloads,1690805680,wl_small_mem,1173,mixed:GM-LM-RR-LSVT-SGD-PATE-sub25100-defpa,3,weighted-dpf+,block-composition-pa,poisson,ncd,mixed:GM-LM-RR-LSVT-SGD-PATE,sub25100,defpa,Unlocking,0.4,MLPateGaussianMechanism,{'Optimal': 40},3286989,218751,22304,46077,10449,6160,3240912,208302,16144,1114,1105,1168,22,70,347,1092,1035,821,poisson-block-composition-pa
1642,sp_workloads,1690805680,wl_small_mem,1173,mixed:GM-LM-RR-LSVT-SGD-PATE-sub25100-defpa,3,weighted-dpf+,block-composition-pa,poisson,ncd,mixed:GM-LM-RR-LSVT-SGD-PATE,sub25100,defpa,Unlocking,0.4,RandResponseMechanism,{'Optimal': 40},3304405,225397,21760,199045,10029,12368,3105360,215368,9392,1160,1175,1154,66,72,691,1094,1103,463,poisson-block-composition-pa
1643,sp_workloads,1690805680,wl_small_mem,1173,mixed:GM-LM-RR-LSVT-SGD-PATE-sub25100-defpa,3,weighted-dpf+,block-composition-pa,poisson,ncd,mixed:GM-LM-RR-LSVT-SGD-PATE,sub25100,defpa,Unlocking,0.4,SVTLaplaceMechanism,{'Optimal': 40},2975196,221951,22352,151848,13107,10800,2823348,208844,11552,1080,1132,1168,59,82,603,1021,1050,565,poisson-block-composition-pa
1644,sp_workloads,1690805680,wl_small_mem,1174,mixed:GM-LM-RR-LSVT-SGD-PATE-sub25100-defpa,3,weighted-dpf+,block-composition-pa,poisson,equal-ncd,mixed:GM-LM-RR-LSVT-SGD-PATE,sub25100,defpa,Unlocking,0.2,GaussianMechanism,{'Optimal': 40},1094,1113,1104,269,736,1009,825,377,95,1094,1113,1104,269,736,1009,825,377,95,poisson-block-composition-pa
1645,sp_workloads,1690805680,wl_small_mem,1174,mixed:GM-LM-RR-LSVT-SGD-PATE-sub25100-defpa,3,weighted-dpf+,block-composition-pa,poisson,equal-ncd,mixed:GM-LM-RR-LSVT-SGD-PATE,sub25100,defpa,Unlocking,0.2,LaplaceMechanism,{'Optimal': 40},1169,1154,1119,492,905,1117,677,249,2,1169,1154,1119,492,905,1117,677,249,2,poisson-block-composition-pa
1646,sp_workloads,1690805680,wl_small_mem,1174,mixed:GM-LM-RR-LSVT-SGD-PATE-sub25100-defpa,3,weighted-dpf+,block-composition-pa,poisson,equal-ncd,mixed:GM-LM-RR-LSVT-SGD-PATE,sub25100,defpa,Unlocking,0.2,MLNoisySGDMechanism,{'Optimal': 40},1057,1087,1124,15,73,327,1042,1014,797,1057,1087,1124,15,73,327,1042,1014,797,poisson-block-composition-pa
1647,sp_workloads,1690805680,wl_small_mem,1174,mixed:GM-LM-RR-LSVT-SGD-PATE-sub25100-defpa,3,weighted-dpf+,block-composition-pa,poisson,equal-ncd,mixed:GM-LM-RR-LSVT-SGD-PATE,sub25100,defpa,Unlocking,0.2,MLPateGaussianMechanism,{'Optimal': 40},1114,1105,1168,33,153,643,1081,952,525,1114,1105,1168,33,153,643,1081,952,525,poisson-block-composition-pa
1648,sp_workloads,1690805680,wl_small_mem,1174,mixed:GM-LM-RR-LSVT-SGD-PATE-sub25100-defpa,3,weighted-dpf+,block-composition-pa,poisson,equal-ncd,mixed:GM-LM-RR-LSVT-SGD-PATE,sub25100,defpa,Unlocking,0.2,RandResponseMechanism,{'Optimal': 40},1160,1175,1154,45,175,952,1115,1000,202,1160,1175,1154,45,175,952,1115,1000,202,poisson-block-composition-pa
1649,sp_workloads,1690805680,wl_small_mem,1174,mixed:GM-LM-RR-LSVT-SGD-PATE-sub25100-defpa,3,weighted-dpf+,block-composition-pa,poisson,equal-ncd,mixed:GM-LM-RR-LSVT-SGD-PATE,sub25100,defpa,Unlocking,0.2,SVTLaplaceMechanism,{'Optimal': 40},1080,1132,1168,51,193,891,1029,939,277,1080,1132,1168,51,193,891,1029,939,277,poisson-block-composition-pa
1650,sp_workloads,1690805680,wl_small_mem,1175,mixed:GM-LM-RR-LSVT-SGD-PATE-sub25100-defpa,3,weighted-dpf+,block-composition-pa,poisson,equal-ncd,mixed:GM-LM-RR-LSVT-SGD-PATE,sub25100,defpa,Unlocking,0.4,GaussianMechanism,{'Optimal': 40},1094,1113,1104,318,730,1033,776,383,71,1094,1113,1104,318,730,1033,776,383,71,poisson-block-composition-pa
1651,sp_workloads,1690805680,wl_small_mem,1175,mixed:GM-LM-RR-LSVT-SGD-PATE-sub25100-defpa,3,weighted-dpf+,block-composition-pa,poisson,equal-ncd,mixed:GM-LM-RR-LSVT-SGD-PATE,sub25100,defpa,Unlocking,0.4,LaplaceMechanism,{'Optimal': 40},1169,1154,1119,516,914,1113,653,240,6,1169,1154,1119,516,914,1113,653,240,6,poisson-block-composition-pa
1652,sp_workloads,1690805680,wl_small_mem,1175,mixed:GM-LM-RR-LSVT-SGD-PATE-sub25100-defpa,3,weighted-dpf+,block-composition-pa,poisson,equal-ncd,mixed:GM-LM-RR-LSVT-SGD-PATE,sub25100,defpa,Unlocking,0.4,MLNoisySGDMechanism,{'Optimal': 40},1057,1087,1124,25,84,353,1032,1003,771,1057,1087,1124,25,84,353,1032,1003,771,poisson-block-composition-pa
1653,sp_workloads,1690805680,wl_small_mem,1175,mixed:GM-LM-RR-LSVT-SGD-PATE-sub25100-defpa,3,weighted-dpf+,block-composition-pa,poisson,equal-ncd,mixed:GM-LM-RR-LSVT-SGD-PATE,sub25100,defpa,Unlocking,0.4,MLPateGaussianMechanism,{'Optimal': 40},1114,1105,1168,34,169,678,1080,936,490,1114,1105,1168,34,169,678,1080,936,490,poisson-block-composition-pa
1654,sp_workloads,1690805680,wl_small_mem,1175,mixed:GM-LM-RR-LSVT-SGD-PATE-sub25100-defpa,3,weighted-dpf+,block-composition-pa,poisson,equal-ncd,mixed:GM-LM-RR-LSVT-SGD-PATE,sub25100,defpa,Unlocking,0.4,RandResponseMechanism,{'Optimal': 40},1160,1175,1154,57,174,995,1103,1001,159,1160,1175,1154,57,174,995,1103,1001,159,poisson-block-composition-pa
1655,sp_workloads,1690805680,wl_small_mem,1175,mixed:GM-LM-RR-LSVT-SGD-PATE-sub25100-defpa,3,weighted-dpf+,block-composition-pa,poisson,equal-ncd,mixed:GM-LM-RR-LSVT-SGD-PATE,sub25100,defpa,Unlocking,0.4,SVTLaplaceMechanism,{'Optimal': 40},1080,1132,1168,50,199,937,1030,933,231,1080,1132,1168,50,199,937,1030,933,231,poisson-block-composition-pa
1656,sp_workloads,1690805680,wl_small_mem,1176,mixed:GM-LM-RR-LSVT-SGD-PATE-sub25100-defpa,4,weighted-dpf+,block-composition-pa,poisson,ncd,mixed:GM-LM-RR-LSVT-SGD-PATE,sub25100,defpa,Unlocking,0.2,GaussianMechanism,{'Optimal': 40},3164159,212016,19356,409537,104469,15236,2754622,107547,4120,1113,1088,1060,274,571,844,839,517,216,poisson-block-composition-pa
1657,sp_workloads,1690805680,wl_small_mem,1176,mixed:GM-LM-RR-LSVT-SGD-PATE-sub25100-defpa,4,weighted-dpf+,block-composition-pa,poisson,ncd,mixed:GM-LM-RR-LSVT-SGD-PATE,sub25100,defpa,Unlocking,0.2,LaplaceMechanism,{'Optimal': 40},2854575,215653,19585,1210727,135134,18752,1643848,80519,833,1062,1115,1087,471,706,1040,591,409,47,poisson-block-composition-pa
1658,sp_workloads,1690805680,wl_small_mem,1176,mixed:GM-LM-RR-LSVT-SGD-PATE-sub25100-defpa,4,weighted-dpf+,block-composition-pa,poisson,ncd,mixed:GM-LM-RR-LSVT-SGD-PATE,sub25100,defpa,Unlocking,0.2,MLNoisySGDMechanism,{'Optimal': 40},3215801,221736,20277,10002,6114,3293,3205799,215622,16984,1144,1128,1131,9,46,195,1135,1082,936,poisson-block-composition-pa
1659,sp_workloads,1690805680,wl_small_mem,1176,mixed:GM-LM-RR-LSVT-SGD-PATE-sub25100-defpa,4,weighted-dpf+,block-composition-pa,poisson,ncd,mixed:GM-LM-RR-LSVT-SGD-PATE,sub25100,defpa,Unlocking,0.2,MLPateGaussianMechanism,{'Optimal': 40},3246364,219077,18914,16443,10653,5752,3229921,208424,13162,1154,1099,1070,14,67,344,1140,1032,726,poisson-block-composition-pa
1660,sp_workloads,1690805680,wl_small_mem,1176,mixed:GM-LM-RR-LSVT-SGD-PATE-sub25100-defpa,4,weighted-dpf+,block-composition-pa,poisson,ncd,mixed:GM-LM-RR-LSVT-SGD-PATE,sub25100,defpa,Unlocking,0.2,RandResponseMechanism,{'Optimal': 40},3086084,218125,20774,136048,13479,10841,2950036,204646,9933,1149,1123,1162,65,89,647,1084,1034,515,poisson-block-composition-pa
1661,sp_workloads,1690805680,wl_small_mem,1176,mixed:GM-LM-RR-LSVT-SGD-PATE-sub25100-defpa,4,weighted-dpf+,block-composition-pa,poisson,ncd,mixed:GM-LM-RR-LSVT-SGD-PATE,sub25100,defpa,Unlocking,0.2,SVTLaplaceMechanism,{'Optimal': 40},3076541,223346,21123,142363,16457,9314,2934178,206889,11809,1073,1134,1197,61,103,558,1012,1031,639,poisson-block-composition-pa
1662,sp_workloads,1690805680,wl_small_mem,1177,mixed:GM-LM-RR-LSVT-SGD-PATE-sub25100-defpa,4,weighted-dpf+,block-composition-pa,poisson,ncd,mixed:GM-LM-RR-LSVT-SGD-PATE,sub25100,defpa,Unlocking,0.4,GaussianMechanism,{'Optimal': 40},3164159,212016,19356,502262,109887,15895,2661897,102129,3461,1113,1088,1060,289,609,873,824,479,187,poisson-block-composition-pa
1663,sp_workloads,1690805680,wl_small_mem,1177,mixed:GM-LM-RR-LSVT-SGD-PATE-sub25100-defpa,4,weighted-dpf+,block-composition-pa,poisson,ncd,mixed:GM-LM-RR-LSVT-SGD-PATE,sub25100,defpa,Unlocking,0.4,LaplaceMechanism,{'Optimal': 40},2854575,215653,19585,1432166,120326,19161,1422409,95327,424,1062,1115,1087,536,682,1063,526,433,24,poisson-block-composition-pa
1664,sp_workloads,1690805680,wl_small_mem,1177,mixed:GM-LM-RR-LSVT-SGD-PATE-sub25100-defpa,4,weighted-dpf+,block-composition-pa,poisson,ncd,mixed:GM-LM-RR-LSVT-SGD-PATE,sub25100,defpa,Unlocking,0.4,MLNoisySGDMechanism,{'Optimal': 40},3215801,221736,20277,18012,6795,3135,3197789,214941,17142,1144,1128,1131,9,53,193,1135,1075,938,poisson-block-composition-pa
1665,sp_workloads,1690805680,wl_small_mem,1177,mixed:GM-LM-RR-LSVT-SGD-PATE-sub25100-defpa,4,weighted-dpf+,block-composition-pa,poisson,ncd,mixed:GM-LM-RR-LSVT-SGD-PATE,sub25100,defpa,Unlocking,0.4,MLPateGaussianMechanism,{'Optimal': 40},3246364,219077,18914,24577,14762,5794,3221787,204315,13120,1154,1099,1070,17,86,350,1137,1013,720,poisson-block-composition-pa
1666,sp_workloads,1690805680,wl_small_mem,1177,mixed:GM-LM-RR-LSVT-SGD-PATE-sub25100-defpa,4,weighted-dpf+,block-composition-pa,poisson,ncd,mixed:GM-LM-RR-LSVT-SGD-PATE,sub25100,defpa,Unlocking,0.4,RandResponseMechanism,{'Optimal': 40},3086084,218125,20774,175132,16995,11776,2910952,201130,8998,1149,1123,1162,73,93,704,1076,1030,458,poisson-block-composition-pa
1667,sp_workloads,1690805680,wl_small_mem,1177,mixed:GM-LM-RR-LSVT-SGD-PATE-sub25100-defpa,4,weighted-dpf+,block-composition-pa,poisson,ncd,mixed:GM-LM-RR-LSVT-SGD-PATE,sub25100,defpa,Unlocking,0.4,SVTLaplaceMechanism,{'Optimal': 40},3076541,223346,21123,175516,15964,10624,2901025,207382,10499,1073,1134,1197,64,100,640,1009,1034,557,poisson-block-composition-pa
1668,sp_workloads,1690805680,wl_small_mem,1178,mixed:GM-LM-RR-LSVT-SGD-PATE-sub25100-defpa,4,weighted-dpf+,block-composition-pa,poisson,equal-ncd,mixed:GM-LM-RR-LSVT-SGD-PATE,sub25100,defpa,Unlocking,0.2,GaussianMechanism,{'Optimal': 40},1113,1088,1060,287,699,992,826,389,68,1113,1088,1060,287,699,992,826,389,68,poisson-block-composition-pa
1669,sp_workloads,1690805680,wl_small_mem,1178,mixed:GM-LM-RR-LSVT-SGD-PATE-sub25100-defpa,4,weighted-dpf+,block-composition-pa,poisson,equal-ncd,mixed:GM-LM-RR-LSVT-SGD-PATE,sub25100,defpa,Unlocking,0.2,LaplaceMechanism,{'Optimal': 40},1062,1115,1087,471,874,1086,591,241,1,1062,1115,1087,471,874,1086,591,241,1,poisson-block-composition-pa
1670,sp_workloads,1690805680,wl_small_mem,1178,mixed:GM-LM-RR-LSVT-SGD-PATE-sub25100-defpa,4,weighted-dpf+,block-composition-pa,poisson,equal-ncd,mixed:GM-LM-RR-LSVT-SGD-PATE,sub25100,defpa,Unlocking,0.2,MLNoisySGDMechanism,{'Optimal': 40},1144,1128,1131,20,64,302,1124,1064,829,1144,1128,1131,20,64,302,1124,1064,829,poisson-block-composition-pa
1671,sp_workloads,1690805680,wl_small_mem,1178,mixed:GM-LM-RR-LSVT-SGD-PATE-sub25100-defpa,4,weighted-dpf+,block-composition-pa,poisson,equal-ncd,mixed:GM-LM-RR-LSVT-SGD-PATE,sub25100,defpa,Unlocking,0.2,MLPateGaussianMechanism,{'Optimal': 40},1154,1099,1070,25,171,604,1129,928,466,1154,1099,1070,25,171,604,1129,928,466,poisson-block-composition-pa
1672,sp_workloads,1690805680,wl_small_mem,1178,mixed:GM-LM-RR-LSVT-SGD-PATE-sub25100-defpa,4,weighted-dpf+,block-composition-pa,poisson,equal-ncd,mixed:GM-LM-RR-LSVT-SGD-PATE,sub25100,defpa,Unlocking,0.2,RandResponseMechanism,{'Optimal': 40},1149,1123,1162,55,157,989,1094,966,173,1149,1123,1162,55,157,989,1094,966,173,poisson-block-composition-pa
1673,sp_workloads,1690805680,wl_small_mem,1178,mixed:GM-LM-RR-LSVT-SGD-PATE-sub25100-defpa,4,weighted-dpf+,block-composition-pa,poisson,equal-ncd,mixed:GM-LM-RR-LSVT-SGD-PATE,sub25100,defpa,Unlocking,0.2,SVTLaplaceMechanism,{'Optimal': 40},1073,1134,1197,61,199,943,1012,935,254,1073,1134,1197,61,199,943,1012,935,254,poisson-block-composition-pa
1674,sp_workloads,1690805680,wl_small_mem,1179,mixed:GM-LM-RR-LSVT-SGD-PATE-sub25100-defpa,4,weighted-dpf+,block-composition-pa,poisson,equal-ncd,mixed:GM-LM-RR-LSVT-SGD-PATE,sub25100,defpa,Unlocking,0.4,GaussianMechanism,{'Optimal': 40},1113,1088,1060,327,730,974,786,358,86,1113,1088,1060,327,730,974,786,358,86,poisson-block-composition-pa
1675,sp_workloads,1690805680,wl_small_mem,1179,mixed:GM-LM-RR-LSVT-SGD-PATE-sub25100-defpa,4,weighted-dpf+,block-composition-pa,poisson,equal-ncd,mixed:GM-LM-RR-LSVT-SGD-PATE,sub25100,defpa,Unlocking,0.4,LaplaceMechanism,{'Optimal': 40},1062,1115,1087,505,895,1086,557,220,1,1062,1115,1087,505,895,1086,557,220,1,poisson-block-composition-pa
1676,sp_workloads,1690805680,wl_small_mem,1179,mixed:GM-LM-RR-LSVT-SGD-PATE-sub25100-defpa,4,weighted-dpf+,block-composition-pa,poisson,equal-ncd,mixed:GM-LM-RR-LSVT-SGD-PATE,sub25100,defpa,Unlocking,0.4,MLNoisySGDMechanism,{'Optimal': 40},1144,1128,1131,16,85,322,1128,1043,809,1144,1128,1131,16,85,322,1128,1043,809,poisson-block-composition-pa
1677,sp_workloads,1690805680,wl_small_mem,1179,mixed:GM-LM-RR-LSVT-SGD-PATE-sub25100-defpa,4,weighted-dpf+,block-composition-pa,poisson,equal-ncd,mixed:GM-LM-RR-LSVT-SGD-PATE,sub25100,defpa,Unlocking,0.4,MLPateGaussianMechanism,{'Optimal': 40},1154,1099,1070,26,184,620,1128,915,450,1154,1099,1070,26,184,620,1128,915,450,poisson-block-composition-pa
1678,sp_workloads,1690805680,wl_small_mem,1179,mixed:GM-LM-RR-LSVT-SGD-PATE-sub25100-defpa,4,weighted-dpf+,block-composition-pa,poisson,equal-ncd,mixed:GM-LM-RR-LSVT-SGD-PATE,sub25100,defpa,Unlocking,0.4,RandResponseMechanism,{'Optimal': 40},1149,1123,1162,53,162,964,1096,961,198,1149,1123,1162,53,162,964,1096,961,198,poisson-block-composition-pa
1679,sp_workloads,1690805680,wl_small_mem,1179,mixed:GM-LM-RR-LSVT-SGD-PATE-sub25100-defpa,4,weighted-dpf+,block-composition-pa,poisson,equal-ncd,mixed:GM-LM-RR-LSVT-SGD-PATE,sub25100,defpa,Unlocking,0.4,SVTLaplaceMechanism,{'Optimal': 40},1073,1134,1197,64,198,960,1009,936,237,1073,1134,1197,64,198,960,1009,936,237,poisson-block-composition-pa
1680,sp_workloads,1690805680,wl_small_mem,1180,basic:GM-LM-RR-LSVT-sub25100-defpa,0,weighted-dpf+,block-composition-pa,poisson,ncd,basic:GM-LM-RR-LSVT,sub25100,defpa,Unlocking,0.2,GaussianMechanism,{'Optimal': 40},4847751,317174,28905,533265,140774,21651,4314486,176400,7254,1760,1618,1607,372,783,1229,1388,835,378,poisson-block-composition-pa
1681,sp_workloads,1690805680,wl_small_mem,1180,basic:GM-LM-RR-LSVT-sub25100-defpa,0,weighted-dpf+,block-composition-pa,poisson,ncd,basic:GM-LM-RR-LSVT,sub25100,defpa,Unlocking,0.2,LaplaceMechanism,{'Optimal': 40},4580618,310999,29482,1677272,151875,27949,2903346,159124,1533,1690,1679,1654,677,932,1571,1013,747,83,poisson-block-composition-pa
1682,sp_workloads,1690805680,wl_small_mem,1180,basic:GM-LM-RR-LSVT-sub25100-defpa,0,weighted-dpf+,block-composition-pa,poisson,ncd,basic:GM-LM-RR-LSVT,sub25100,defpa,Unlocking,0.2,RandResponseMechanism,{'Optimal': 40},4834309,320190,30099,168279,13725,12049,4666030,306465,18050,1752,1677,1693,75,95,735,1677,1582,958,poisson-block-composition-pa
1683,sp_workloads,1690805680,wl_small_mem,1180,basic:GM-LM-RR-LSVT-sub25100-defpa,0,weighted-dpf+,block-composition-pa,poisson,ncd,basic:GM-LM-RR-LSVT,sub25100,defpa,Unlocking,0.2,SVTLaplaceMechanism,{'Optimal': 40},4502539,307841,30348,123030,17136,10564,4379509,290705,19784,1685,1652,1684,53,96,620,1632,1556,1064,poisson-block-composition-pa
1684,sp_workloads,1690805680,wl_small_mem,1181,basic:GM-LM-RR-LSVT-sub25100-defpa,0,weighted-dpf+,block-composition-pa,poisson,ncd,basic:GM-LM-RR-LSVT,sub25100,defpa,Unlocking,0.4,GaussianMechanism,{'Optimal': 40},4847751,317174,28905,648724,146924,21871,4199027,170250,7034,1760,1618,1607,397,816,1249,1363,802,358,poisson-block-composition-pa
1685,sp_workloads,1690805680,wl_small_mem,1181,basic:GM-LM-RR-LSVT-sub25100-defpa,0,weighted-dpf+,block-composition-pa,poisson,ncd,basic:GM-LM-RR-LSVT,sub25100,defpa,Unlocking,0.4,LaplaceMechanism,{'Optimal': 40},4580618,310999,29482,2092147,148176,27430,2488471,162823,2052,1690,1679,1654,763,918,1546,927,761,108,poisson-block-composition-pa
1686,sp_workloads,1690805680,wl_small_mem,1181,basic:GM-LM-RR-LSVT-sub25100-defpa,0,weighted-dpf+,block-composition-pa,poisson,ncd,basic:GM-LM-RR-LSVT,sub25100,defpa,Unlocking,0.4,RandResponseMechanism,{'Optimal': 40},4834309,320190,30099,190112,14964,13443,4644197,305226,16656,1752,1677,1693,84,102,829,1668,1575,864,poisson-block-composition-pa
1687,sp_workloads,1690805680,wl_small_mem,1181,basic:GM-LM-RR-LSVT-sub25100-defpa,0,weighted-dpf+,block-composition-pa,poisson,ncd,basic:GM-LM-RR-LSVT,sub25100,defpa,Unlocking,0.4,SVTLaplaceMechanism,{'Optimal': 40},4502539,307841,30348,150570,14191,11136,4351969,293650,19212,1685,1652,1684,60,87,672,1625,1565,1012,poisson-block-composition-pa
1688,sp_workloads,1690805680,wl_small_mem,1182,basic:GM-LM-RR-LSVT-sub25100-defpa,0,weighted-dpf+,block-composition-pa,poisson,equal-ncd,basic:GM-LM-RR-LSVT,sub25100,defpa,Unlocking,0.2,GaussianMechanism,{'Optimal': 40},1760,1618,1607,425,994,1452,1335,624,155,1760,1618,1607,425,994,1452,1335,624,155,poisson-block-composition-pa
1689,sp_workloads,1690805680,wl_small_mem,1182,basic:GM-LM-RR-LSVT-sub25100-defpa,0,weighted-dpf+,block-composition-pa,poisson,equal-ncd,basic:GM-LM-RR-LSVT,sub25100,defpa,Unlocking,0.2,LaplaceMechanism,{'Optimal': 40},1690,1679,1654,650,1217,1649,1040,462,5,1690,1679,1654,650,1217,1649,1040,462,5,poisson-block-composition-pa
1690,sp_workloads,1690805680,wl_small_mem,1182,basic:GM-LM-RR-LSVT-sub25100-defpa,0,weighted-dpf+,block-composition-pa,poisson,equal-ncd,basic:GM-LM-RR-LSVT,sub25100,defpa,Unlocking,0.2,RandResponseMechanism,{'Optimal': 40},1752,1677,1693,58,189,1339,1694,1488,354,1752,1677,1693,58,189,1339,1694,1488,354,poisson-block-composition-pa
1691,sp_workloads,1690805680,wl_small_mem,1182,basic:GM-LM-RR-LSVT-sub25100-defpa,0,weighted-dpf+,block-composition-pa,poisson,equal-ncd,basic:GM-LM-RR-LSVT,sub25100,defpa,Unlocking,0.2,SVTLaplaceMechanism,{'Optimal': 40},1685,1652,1684,60,214,1251,1625,1438,433,1685,1652,1684,60,214,1251,1625,1438,433,poisson-block-composition-pa
1692,sp_workloads,1690805680,wl_small_mem,1183,basic:GM-LM-RR-LSVT-sub25100-defpa,0,weighted-dpf+,block-composition-pa,poisson,equal-ncd,basic:GM-LM-RR-LSVT,sub25100,defpa,Unlocking,0.4,GaussianMechanism,{'Optimal': 40},1760,1618,1607,445,1085,1455,1315,533,152,1760,1618,1607,445,1085,1455,1315,533,152,poisson-block-composition-pa
1693,sp_workloads,1690805680,wl_small_mem,1183,basic:GM-LM-RR-LSVT-sub25100-defpa,0,weighted-dpf+,block-composition-pa,poisson,equal-ncd,basic:GM-LM-RR-LSVT,sub25100,defpa,Unlocking,0.4,LaplaceMechanism,{'Optimal': 40},1690,1679,1654,702,1221,1648,988,458,6,1690,1679,1654,702,1221,1648,988,458,6,poisson-block-composition-pa
1694,sp_workloads,1690805680,wl_small_mem,1183,basic:GM-LM-RR-LSVT-sub25100-defpa,0,weighted-dpf+,block-composition-pa,poisson,equal-ncd,basic:GM-LM-RR-LSVT,sub25100,defpa,Unlocking,0.4,RandResponseMechanism,{'Optimal': 40},1752,1677,1693,60,201,1392,1692,1476,301,1752,1677,1693,60,201,1392,1692,1476,301,poisson-block-composition-pa
1695,sp_workloads,1690805680,wl_small_mem,1183,basic:GM-LM-RR-LSVT-sub25100-defpa,0,weighted-dpf+,block-composition-pa,poisson,equal-ncd,basic:GM-LM-RR-LSVT,sub25100,defpa,Unlocking,0.4,SVTLaplaceMechanism,{'Optimal': 40},1685,1652,1684,63,222,1248,1622,1430,436,1685,1652,1684,63,222,1248,1622,1430,436,poisson-block-composition-pa
1696,sp_workloads,1690805680,wl_small_mem,1184,basic:GM-LM-RR-LSVT-sub25100-defpa,1,weighted-dpf+,block-composition-pa,poisson,ncd,basic:GM-LM-RR-LSVT,sub25100,defpa,Unlocking,0.2,GaussianMechanism,{'Optimal': 40},4674135,351804,29818,517320,159754,21398,4156815,192050,8420,1725,1745,1670,355,846,1226,1370,899,444,poisson-block-composition-pa
1697,sp_workloads,1690805680,wl_small_mem,1184,basic:GM-LM-RR-LSVT-sub25100-defpa,1,weighted-dpf+,block-composition-pa,poisson,ncd,basic:GM-LM-RR-LSVT,sub25100,defpa,Unlocking,0.2,LaplaceMechanism,{'Optimal': 40},4701336,316959,30901,1637396,157978,28942,3063940,158981,1959,1705,1659,1707,617,917,1602,1088,742,105,poisson-block-composition-pa
1698,sp_workloads,1690805680,wl_small_mem,1184,basic:GM-LM-RR-LSVT-sub25100-defpa,1,weighted-dpf+,block-composition-pa,poisson,ncd,basic:GM-LM-RR-LSVT,sub25100,defpa,Unlocking,0.2,RandResponseMechanism,{'Optimal': 40},4751311,334074,30363,143387,18898,12370,4607924,315176,17993,1634,1678,1701,70,114,750,1564,1564,951,poisson-block-composition-pa
1699,sp_workloads,1690805680,wl_small_mem,1184,basic:GM-LM-RR-LSVT-sub25100-defpa,1,weighted-dpf+,block-composition-pa,poisson,ncd,basic:GM-LM-RR-LSVT,sub25100,defpa,Unlocking,0.2,SVTLaplaceMechanism,{'Optimal': 40},4658717,301226,29963,132682,15623,9767,4526035,285603,20196,1700,1628,1669,55,108,585,1645,1520,1084,poisson-block-composition-pa
1700,sp_workloads,1690805680,wl_small_mem,1185,basic:GM-LM-RR-LSVT-sub25100-defpa,1,weighted-dpf+,block-composition-pa,poisson,ncd,basic:GM-LM-RR-LSVT,sub25100,defpa,Unlocking,0.4,GaussianMechanism,{'Optimal': 40},4674135,351804,29818,565812,167361,22178,4108323,184443,7640,1725,1745,1670,392,886,1278,1333,859,392,poisson-block-composition-pa
1701,sp_workloads,1690805680,wl_small_mem,1185,basic:GM-LM-RR-LSVT-sub25100-defpa,1,weighted-dpf+,block-composition-pa,poisson,ncd,basic:GM-LM-RR-LSVT,sub25100,defpa,Unlocking,0.4,LaplaceMechanism,{'Optimal': 40},4701336,316959,30901,1974276,149796,29094,2727060,167163,1807,1705,1659,1707,708,897,1610,997,762,97,poisson-block-composition-pa
1702,sp_workloads,1690805680,wl_small_mem,1185,basic:GM-LM-RR-LSVT-sub25100-defpa,1,weighted-dpf+,block-composition-pa,poisson,ncd,basic:GM-LM-RR-LSVT,sub25100,defpa,Unlocking,0.4,RandResponseMechanism,{'Optimal': 40},4751311,334074,30363,175443,15398,13779,4575868,318676,16584,1634,1678,1701,78,91,845,1556,1587,856,poisson-block-composition-pa
1703,sp_workloads,1690805680,wl_small_mem,1185,basic:GM-LM-RR-LSVT-sub25100-defpa,1,weighted-dpf+,block-composition-pa,poisson,ncd,basic:GM-LM-RR-LSVT,sub25100,defpa,Unlocking,0.4,SVTLaplaceMechanism,{'Optimal': 40},4658717,301226,29963,173605,16434,12427,4485112,284792,17536,1700,1628,1669,69,109,741,1631,1519,928,poisson-block-composition-pa
1704,sp_workloads,1690805680,wl_small_mem,1186,basic:GM-LM-RR-LSVT-sub25100-defpa,1,weighted-dpf+,block-composition-pa,poisson,equal-ncd,basic:GM-LM-RR-LSVT,sub25100,defpa,Unlocking,0.2,GaussianMechanism,{'Optimal': 40},1725,1745,1670,418,1118,1524,1307,627,146,1725,1745,1670,418,1118,1524,1307,627,146,poisson-block-composition-pa
1705,sp_workloads,1690805680,wl_small_mem,1186,basic:GM-LM-RR-LSVT-sub25100-defpa,1,weighted-dpf+,block-composition-pa,poisson,equal-ncd,basic:GM-LM-RR-LSVT,sub25100,defpa,Unlocking,0.2,LaplaceMechanism,{'Optimal': 40},1705,1659,1707,625,1186,1704,1080,473,3,1705,1659,1707,625,1186,1704,1080,473,3,poisson-block-composition-pa
1706,sp_workloads,1690805680,wl_small_mem,1186,basic:GM-LM-RR-LSVT-sub25100-defpa,1,weighted-dpf+,block-composition-pa,poisson,equal-ncd,basic:GM-LM-RR-LSVT,sub25100,defpa,Unlocking,0.2,RandResponseMechanism,{'Optimal': 40},1634,1678,1701,52,190,1330,1582,1488,371,1634,1678,1701,52,190,1330,1582,1488,371,poisson-block-composition-pa
1707,sp_workloads,1690805680,wl_small_mem,1186,basic:GM-LM-RR-LSVT-sub25100-defpa,1,weighted-dpf+,block-composition-pa,poisson,equal-ncd,basic:GM-LM-RR-LSVT,sub25100,defpa,Unlocking,0.2,SVTLaplaceMechanism,{'Optimal': 40},1700,1628,1669,71,241,1250,1629,1387,419,1700,1628,1669,71,241,1250,1629,1387,419,poisson-block-composition-pa
1708,sp_workloads,1690805680,wl_small_mem,1187,basic:GM-LM-RR-LSVT-sub25100-defpa,1,weighted-dpf+,block-composition-pa,poisson,equal-ncd,basic:GM-LM-RR-LSVT,sub25100,defpa,Unlocking,0.4,GaussianMechanism,{'Optimal': 40},1725,1745,1670,422,1150,1526,1303,595,144,1725,1745,1670,422,1150,1526,1303,595,144,poisson-block-composition-pa
1709,sp_workloads,1690805680,wl_small_mem,1187,basic:GM-LM-RR-LSVT-sub25100-defpa,1,weighted-dpf+,block-composition-pa,poisson,equal-ncd,basic:GM-LM-RR-LSVT,sub25100,defpa,Unlocking,0.4,LaplaceMechanism,{'Optimal': 40},1705,1659,1707,654,1228,1704,1051,431,3,1705,1659,1707,654,1228,1704,1051,431,3,poisson-block-composition-pa
1710,sp_workloads,1690805680,wl_small_mem,1187,basic:GM-LM-RR-LSVT-sub25100-defpa,1,weighted-dpf+,block-composition-pa,poisson,equal-ncd,basic:GM-LM-RR-LSVT,sub25100,defpa,Unlocking,0.4,RandResponseMechanism,{'Optimal': 40},1634,1678,1701,52,215,1462,1582,1463,239,1634,1678,1701,52,215,1462,1582,1463,239,poisson-block-composition-pa
1711,sp_workloads,1690805680,wl_small_mem,1187,basic:GM-LM-RR-LSVT-sub25100-defpa,1,weighted-dpf+,block-composition-pa,poisson,equal-ncd,basic:GM-LM-RR-LSVT,sub25100,defpa,Unlocking,0.4,SVTLaplaceMechanism,{'Optimal': 40},1700,1628,1669,68,244,1304,1632,1384,365,1700,1628,1669,68,244,1304,1632,1384,365,poisson-block-composition-pa
1712,sp_workloads,1690805680,wl_small_mem,1188,basic:GM-LM-RR-LSVT-sub25100-defpa,2,weighted-dpf+,block-composition-pa,poisson,ncd,basic:GM-LM-RR-LSVT,sub25100,defpa,Unlocking,0.2,GaussianMechanism,{'Optimal': 40},4344073,336565,33248,551046,167315,23856,3793027,169250,9392,1647,1671,1731,340,864,1269,1307,807,462,poisson-block-composition-pa
1713,sp_workloads,1690805680,wl_small_mem,1188,basic:GM-LM-RR-LSVT-sub25100-defpa,2,weighted-dpf+,block-composition-pa,poisson,ncd,basic:GM-LM-RR-LSVT,sub25100,defpa,Unlocking,0.2,LaplaceMechanism,{'Optimal': 40},4548967,333299,30800,1630112,183477,29200,2918855,149822,1600,1660,1661,1646,649,954,1558,1011,707,88,poisson-block-composition-pa
1714,sp_workloads,1690805680,wl_small_mem,1188,basic:GM-LM-RR-LSVT-sub25100-defpa,2,weighted-dpf+,block-composition-pa,poisson,ncd,basic:GM-LM-RR-LSVT,sub25100,defpa,Unlocking,0.2,RandResponseMechanism,{'Optimal': 40},5016525,328891,32448,140156,19730,13840,4876369,309161,18608,1714,1690,1723,61,118,786,1653,1572,937,poisson-block-composition-pa
1715,sp_workloads,1690805680,wl_small_mem,1188,basic:GM-LM-RR-LSVT-sub25100-defpa,2,weighted-dpf+,block-composition-pa,poisson,ncd,basic:GM-LM-RR-LSVT,sub25100,defpa,Unlocking,0.2,SVTLaplaceMechanism,{'Optimal': 40},4781610,327880,32576,154766,22986,11808,4626844,304894,20768,1631,1679,1700,49,119,661,1582,1560,1039,poisson-block-composition-pa
1716,sp_workloads,1690805680,wl_small_mem,1189,basic:GM-LM-RR-LSVT-sub25100-defpa,2,weighted-dpf+,block-composition-pa,poisson,ncd,basic:GM-LM-RR-LSVT,sub25100,defpa,Unlocking,0.4,GaussianMechanism,{'Optimal': 40},4344073,336565,33248,570988,170588,24096,3773085,165977,9152,1647,1671,1731,350,905,1292,1297,766,439,poisson-block-composition-pa
1717,sp_workloads,1690805680,wl_small_mem,1189,basic:GM-LM-RR-LSVT-sub25100-defpa,2,weighted-dpf+,block-composition-pa,poisson,ncd,basic:GM-LM-RR-LSVT,sub25100,defpa,Unlocking,0.4,LaplaceMechanism,{'Optimal': 40},4548967,333299,30800,1994517,173871,28688,2554450,159428,2112,1660,1661,1646,753,933,1532,907,728,114,poisson-block-composition-pa
1718,sp_workloads,1690805680,wl_small_mem,1189,basic:GM-LM-RR-LSVT-sub25100-defpa,2,weighted-dpf+,block-composition-pa,poisson,ncd,basic:GM-LM-RR-LSVT,sub25100,defpa,Unlocking,0.4,RandResponseMechanism,{'Optimal': 40},5016525,328891,32448,197749,19194,14784,4818776,309697,17664,1714,1690,1723,76,120,850,1638,1570,873,poisson-block-composition-pa
1719,sp_workloads,1690805680,wl_small_mem,1189,basic:GM-LM-RR-LSVT-sub25100-defpa,2,weighted-dpf+,block-composition-pa,poisson,ncd,basic:GM-LM-RR-LSVT,sub25100,defpa,Unlocking,0.4,SVTLaplaceMechanism,{'Optimal': 40},4781610,327880,32576,188515,17083,12432,4593095,310797,20144,1631,1679,1700,57,112,700,1574,1567,1000,poisson-block-composition-pa
1720,sp_workloads,1690805680,wl_small_mem,1190,basic:GM-LM-RR-LSVT-sub25100-defpa,2,weighted-dpf+,block-composition-pa,poisson,equal-ncd,basic:GM-LM-RR-LSVT,sub25100,defpa,Unlocking,0.2,GaussianMechanism,{'Optimal': 40},1647,1671,1731,378,1086,1534,1269,585,197,1647,1671,1731,378,1086,1534,1269,585,197,poisson-block-composition-pa
1721,sp_workloads,1690805680,wl_small_mem,1190,basic:GM-LM-RR-LSVT-sub25100-defpa,2,weighted-dpf+,block-composition-pa,poisson,equal-ncd,basic:GM-LM-RR-LSVT,sub25100,defpa,Unlocking,0.2,LaplaceMechanism,{'Optimal': 40},1660,1661,1646,662,1180,1638,998,481,8,1660,1661,1646,662,1180,1638,998,481,8,poisson-block-composition-pa
1722,sp_workloads,1690805680,wl_small_mem,1190,basic:GM-LM-RR-LSVT-sub25100-defpa,2,weighted-dpf+,block-composition-pa,poisson,equal-ncd,basic:GM-LM-RR-LSVT,sub25100,defpa,Unlocking,0.2,RandResponseMechanism,{'Optimal': 40},1714,1690,1723,51,217,1321,1663,1473,402,1714,1690,1723,51,217,1321,1663,1473,402,poisson-block-composition-pa
1723,sp_workloads,1690805680,wl_small_mem,1190,basic:GM-LM-RR-LSVT-sub25100-defpa,2,weighted-dpf+,block-composition-pa,poisson,equal-ncd,basic:GM-LM-RR-LSVT,sub25100,defpa,Unlocking,0.2,SVTLaplaceMechanism,{'Optimal': 40},1631,1679,1700,51,231,1194,1580,1448,506,1631,1679,1700,51,231,1194,1580,1448,506,poisson-block-composition-pa
1724,sp_workloads,1690805680,wl_small_mem,1191,basic:GM-LM-RR-LSVT-sub25100-defpa,2,weighted-dpf+,block-composition-pa,poisson,equal-ncd,basic:GM-LM-RR-LSVT,sub25100,defpa,Unlocking,0.4,GaussianMechanism,{'Optimal': 40},1647,1671,1731,377,1142,1572,1270,529,159,1647,1671,1731,377,1142,1572,1270,529,159,poisson-block-composition-pa
1725,sp_workloads,1690805680,wl_small_mem,1191,basic:GM-LM-RR-LSVT-sub25100-defpa,2,weighted-dpf+,block-composition-pa,poisson,equal-ncd,basic:GM-LM-RR-LSVT,sub25100,defpa,Unlocking,0.4,LaplaceMechanism,{'Optimal': 40},1660,1661,1646,652,1202,1643,1008,459,3,1660,1661,1646,652,1202,1643,1008,459,3,poisson-block-composition-pa
1726,sp_workloads,1690805680,wl_small_mem,1191,basic:GM-LM-RR-LSVT-sub25100-defpa,2,weighted-dpf+,block-composition-pa,poisson,equal-ncd,basic:GM-LM-RR-LSVT,sub25100,defpa,Unlocking,0.4,RandResponseMechanism,{'Optimal': 40},1714,1690,1723,47,223,1483,1667,1467,240,1714,1690,1723,47,223,1483,1667,1467,240,poisson-block-composition-pa
1727,sp_workloads,1690805680,wl_small_mem,1191,basic:GM-LM-RR-LSVT-sub25100-defpa,2,weighted-dpf+,block-composition-pa,poisson,equal-ncd,basic:GM-LM-RR-LSVT,sub25100,defpa,Unlocking,0.4,SVTLaplaceMechanism,{'Optimal': 40},1631,1679,1700,48,272,1343,1583,1407,357,1631,1679,1700,48,272,1343,1583,1407,357,poisson-block-composition-pa
1728,sp_workloads,1690805680,wl_small_mem,1192,basic:GM-LM-RR-LSVT-sub25100-defpa,3,weighted-dpf+,block-composition-pa,poisson,ncd,basic:GM-LM-RR-LSVT,sub25100,defpa,Unlocking,0.2,GaussianMechanism,{'Optimal': 40},4431438,335185,30243,537009,152527,22734,3894429,182658,7509,1636,1707,1661,375,862,1282,1261,845,379,poisson-block-composition-pa
1729,sp_workloads,1690805680,wl_small_mem,1192,basic:GM-LM-RR-LSVT-sub25100-defpa,3,weighted-dpf+,block-composition-pa,poisson,ncd,basic:GM-LM-RR-LSVT,sub25100,defpa,Unlocking,0.2,LaplaceMechanism,{'Optimal': 40},4614241,302136,30909,1608706,165889,29027,3005535,136247,1882,1669,1590,1731,634,924,1629,1035,666,102,poisson-block-composition-pa
1730,sp_workloads,1690805680,wl_small_mem,1192,basic:GM-LM-RR-LSVT-sub25100-defpa,3,weighted-dpf+,block-composition-pa,poisson,ncd,basic:GM-LM-RR-LSVT,sub25100,defpa,Unlocking,0.2,RandResponseMechanism,{'Optimal': 40},4710432,347409,29228,161360,17406,13611,4549072,330003,15617,1691,1685,1636,64,95,821,1627,1590,815,poisson-block-composition-pa
1731,sp_workloads,1690805680,wl_small_mem,1192,basic:GM-LM-RR-LSVT-sub25100-defpa,3,weighted-dpf+,block-composition-pa,poisson,ncd,basic:GM-LM-RR-LSVT,sub25100,defpa,Unlocking,0.2,SVTLaplaceMechanism,{'Optimal': 40},4781445,315437,29779,138278,19520,11928,4643167,295917,17851,1697,1624,1645,60,103,712,1637,1521,933,poisson-block-composition-pa
1732,sp_workloads,1690805680,wl_small_mem,1193,basic:GM-LM-RR-LSVT-sub25100-defpa,3,weighted-dpf+,block-composition-pa,poisson,ncd,basic:GM-LM-RR-LSVT,sub25100,defpa,Unlocking,0.4,GaussianMechanism,{'Optimal': 40},4431438,335185,30243,653818,156801,23604,3777620,178384,6639,1636,1707,1661,397,860,1324,1239,847,337,poisson-block-composition-pa
1733,sp_workloads,1690805680,wl_small_mem,1193,basic:GM-LM-RR-LSVT-sub25100-defpa,3,weighted-dpf+,block-composition-pa,poisson,ncd,basic:GM-LM-RR-LSVT,sub25100,defpa,Unlocking,0.4,LaplaceMechanism,{'Optimal': 40},4614241,302136,30909,1837917,154182,29300,2776324,147954,1609,1669,1590,1731,707,868,1644,962,722,87,poisson-block-composition-pa
1734,sp_workloads,1690805680,wl_small_mem,1193,basic:GM-LM-RR-LSVT-sub25100-defpa,3,weighted-dpf+,block-composition-pa,poisson,ncd,basic:GM-LM-RR-LSVT,sub25100,defpa,Unlocking,0.4,RandResponseMechanism,{'Optimal': 40},4710432,347409,29228,173975,16129,13947,4536457,331280,15281,1691,1685,1636,70,96,853,1621,1589,783,poisson-block-composition-pa
1735,sp_workloads,1690805680,wl_small_mem,1193,basic:GM-LM-RR-LSVT-sub25100-defpa,3,weighted-dpf+,block-composition-pa,poisson,ncd,basic:GM-LM-RR-LSVT,sub25100,defpa,Unlocking,0.4,SVTLaplaceMechanism,{'Optimal': 40},4781445,315437,29779,236174,19044,11123,4545271,296393,18656,1697,1624,1645,83,101,685,1614,1523,960,poisson-block-composition-pa
1736,sp_workloads,1690805680,wl_small_mem,1194,basic:GM-LM-RR-LSVT-sub25100-defpa,3,weighted-dpf+,block-composition-pa,poisson,equal-ncd,basic:GM-LM-RR-LSVT,sub25100,defpa,Unlocking,0.2,GaussianMechanism,{'Optimal': 40},1636,1707,1661,414,1123,1487,1222,584,174,1636,1707,1661,414,1123,1487,1222,584,174,poisson-block-composition-pa
1737,sp_workloads,1690805680,wl_small_mem,1194,basic:GM-LM-RR-LSVT-sub25100-defpa,3,weighted-dpf+,block-composition-pa,poisson,equal-ncd,basic:GM-LM-RR-LSVT,sub25100,defpa,Unlocking,0.2,LaplaceMechanism,{'Optimal': 40},1669,1590,1731,660,1115,1723,1009,475,8,1669,1590,1731,660,1115,1723,1009,475,8,poisson-block-composition-pa
1738,sp_workloads,1690805680,wl_small_mem,1194,basic:GM-LM-RR-LSVT-sub25100-defpa,3,weighted-dpf+,block-composition-pa,poisson,equal-ncd,basic:GM-LM-RR-LSVT,sub25100,defpa,Unlocking,0.2,RandResponseMechanism,{'Optimal': 40},1691,1685,1636,52,173,1200,1639,1512,436,1691,1685,1636,52,173,1200,1639,1512,436,poisson-block-composition-pa
1739,sp_workloads,1690805680,wl_small_mem,1194,basic:GM-LM-RR-LSVT-sub25100-defpa,3,weighted-dpf+,block-composition-pa,poisson,equal-ncd,basic:GM-LM-RR-LSVT,sub25100,defpa,Unlocking,0.2,SVTLaplaceMechanism,{'Optimal': 40},1697,1624,1645,54,206,1089,1643,1418,556,1697,1624,1645,54,206,1089,1643,1418,556,poisson-block-composition-pa
1740,sp_workloads,1690805680,wl_small_mem,1195,basic:GM-LM-RR-LSVT-sub25100-defpa,3,weighted-dpf+,block-composition-pa,poisson,equal-ncd,basic:GM-LM-RR-LSVT,sub25100,defpa,Unlocking,0.4,GaussianMechanism,{'Optimal': 40},1636,1707,1661,409,1134,1508,1227,573,153,1636,1707,1661,409,1134,1508,1227,573,153,poisson-block-composition-pa
1741,sp_workloads,1690805680,wl_small_mem,1195,basic:GM-LM-RR-LSVT-sub25100-defpa,3,weighted-dpf+,block-composition-pa,poisson,equal-ncd,basic:GM-LM-RR-LSVT,sub25100,defpa,Unlocking,0.4,LaplaceMechanism,{'Optimal': 40},1669,1590,1731,665,1177,1727,1004,413,4,1669,1590,1731,665,1177,1727,1004,413,4,poisson-block-composition-pa
1742,sp_workloads,1690805680,wl_small_mem,1195,basic:GM-LM-RR-LSVT-sub25100-defpa,3,weighted-dpf+,block-composition-pa,poisson,equal-ncd,basic:GM-LM-RR-LSVT,sub25100,defpa,Unlocking,0.4,RandResponseMechanism,{'Optimal': 40},1691,1685,1636,61,205,1440,1630,1480,196,1691,1685,1636,61,205,1440,1630,1480,196,poisson-block-composition-pa
1743,sp_workloads,1690805680,wl_small_mem,1195,basic:GM-LM-RR-LSVT-sub25100-defpa,3,weighted-dpf+,block-composition-pa,poisson,equal-ncd,basic:GM-LM-RR-LSVT,sub25100,defpa,Unlocking,0.4,SVTLaplaceMechanism,{'Optimal': 40},1697,1624,1645,62,219,1300,1635,1405,345,1697,1624,1645,62,219,1300,1635,1405,345,poisson-block-composition-pa
1744,sp_workloads,1690805680,wl_small_mem,1196,basic:GM-LM-RR-LSVT-sub25100-defpa,4,weighted-dpf+,block-composition-pa,poisson,ncd,basic:GM-LM-RR-LSVT,sub25100,defpa,Unlocking,0.2,GaussianMechanism,{'Optimal': 40},4571824,341651,31424,584775,160109,24288,3987049,181542,7136,1667,1683,1652,361,849,1291,1306,834,361,poisson-block-composition-pa
1745,sp_workloads,1690805680,wl_small_mem,1196,basic:GM-LM-RR-LSVT-sub25100-defpa,4,weighted-dpf+,block-composition-pa,poisson,ncd,basic:GM-LM-RR-LSVT,sub25100,defpa,Unlocking,0.2,LaplaceMechanism,{'Optimal': 40},4559498,310728,31904,1638624,165115,30368,2920874,145613,1536,1705,1675,1674,640,931,1597,1065,744,77,poisson-block-composition-pa
1746,sp_workloads,1690805680,wl_small_mem,1196,basic:GM-LM-RR-LSVT-sub25100-defpa,4,weighted-dpf+,block-composition-pa,poisson,ncd,basic:GM-LM-RR-LSVT,sub25100,defpa,Unlocking,0.2,RandResponseMechanism,{'Optimal': 40},4915555,321907,33248,174881,12875,14208,4740674,309032,19040,1732,1682,1739,68,85,806,1664,1597,933,poisson-block-composition-pa
1747,sp_workloads,1690805680,wl_small_mem,1196,basic:GM-LM-RR-LSVT-sub25100-defpa,4,weighted-dpf+,block-composition-pa,poisson,ncd,basic:GM-LM-RR-LSVT,sub25100,defpa,Unlocking,0.2,SVTLaplaceMechanism,{'Optimal': 40},4827443,310825,33008,182950,18882,12304,4644493,291943,20704,1701,1631,1753,73,103,708,1628,1528,1045,poisson-block-composition-pa
1748,sp_workloads,1690805680,wl_small_mem,1197,basic:GM-LM-RR-LSVT-sub25100-defpa,4,weighted-dpf+,block-composition-pa,poisson,ncd,basic:GM-LM-RR-LSVT,sub25100,defpa,Unlocking,0.4,GaussianMechanism,{'Optimal': 40},4571824,341651,31424,653324,168041,24608,3918500,173610,6816,1667,1683,1652,375,868,1313,1292,815,339,poisson-block-composition-pa
1749,sp_workloads,1690805680,wl_small_mem,1197,basic:GM-LM-RR-LSVT-sub25100-defpa,4,weighted-dpf+,block-composition-pa,poisson,ncd,basic:GM-LM-RR-LSVT,sub25100,defpa,Unlocking,0.4,LaplaceMechanism,{'Optimal': 40},4559498,310728,31904,1947254,156703,30160,2612244,154025,1744,1705,1675,1674,735,914,1586,970,761,88,poisson-block-composition-pa
1750,sp_workloads,1690805680,wl_small_mem,1197,basic:GM-LM-RR-LSVT-sub25100-defpa,4,weighted-dpf+,block-composition-pa,poisson,ncd,basic:GM-LM-RR-LSVT,sub25100,defpa,Unlocking,0.4,RandResponseMechanism,{'Optimal': 40},4915555,321907,33248,194608,15101,15088,4720947,306806,18160,1732,1682,1739,75,98,859,1657,1584,880,poisson-block-composition-pa
1751,sp_workloads,1690805680,wl_small_mem,1197,basic:GM-LM-RR-LSVT-sub25100-defpa,4,weighted-dpf+,block-composition-pa,poisson,ncd,basic:GM-LM-RR-LSVT,sub25100,defpa,Unlocking,0.4,SVTLaplaceMechanism,{'Optimal': 40},4827443,310825,33008,195178,14173,12240,4632265,296652,20768,1701,1631,1753,73,89,712,1628,1542,1041,poisson-block-composition-pa
1752,sp_workloads,1690805680,wl_small_mem,1198,basic:GM-LM-RR-LSVT-sub25100-defpa,4,weighted-dpf+,block-composition-pa,poisson,equal-ncd,basic:GM-LM-RR-LSVT,sub25100,defpa,Unlocking,0.2,GaussianMechanism,{'Optimal': 40},1667,1683,1652,385,1079,1495,1282,604,157,1667,1683,1652,385,1079,1495,1282,604,157,poisson-block-composition-pa
1753,sp_workloads,1690805680,wl_small_mem,1198,basic:GM-LM-RR-LSVT-sub25100-defpa,4,weighted-dpf+,block-composition-pa,poisson,equal-ncd,basic:GM-LM-RR-LSVT,sub25100,defpa,Unlocking,0.2,LaplaceMechanism,{'Optimal': 40},1705,1675,1674,689,1126,1670,1016,549,4,1705,1675,1674,689,1126,1670,1016,549,4,poisson-block-composition-pa
1754,sp_workloads,1690805680,wl_small_mem,1198,basic:GM-LM-RR-LSVT-sub25100-defpa,4,weighted-dpf+,block-composition-pa,poisson,equal-ncd,basic:GM-LM-RR-LSVT,sub25100,defpa,Unlocking,0.2,RandResponseMechanism,{'Optimal': 40},1732,1682,1739,52,188,1381,1680,1494,358,1732,1682,1739,52,188,1381,1680,1494,358,poisson-block-composition-pa
1755,sp_workloads,1690805680,wl_small_mem,1198,basic:GM-LM-RR-LSVT-sub25100-defpa,4,weighted-dpf+,block-composition-pa,poisson,equal-ncd,basic:GM-LM-RR-LSVT,sub25100,defpa,Unlocking,0.2,SVTLaplaceMechanism,{'Optimal': 40},1701,1631,1753,55,217,1304,1646,1414,449,1701,1631,1753,55,217,1304,1646,1414,449,poisson-block-composition-pa
1756,sp_workloads,1690805680,wl_small_mem,1199,basic:GM-LM-RR-LSVT-sub25100-defpa,4,weighted-dpf+,block-composition-pa,poisson,equal-ncd,basic:GM-LM-RR-LSVT,sub25100,defpa,Unlocking,0.4,GaussianMechanism,{'Optimal': 40},1667,1683,1652,430,1116,1516,1237,567,136,1667,1683,1652,430,1116,1516,1237,567,136,poisson-block-composition-pa
1757,sp_workloads,1690805680,wl_small_mem,1199,basic:GM-LM-RR-LSVT-sub25100-defpa,4,weighted-dpf+,block-composition-pa,poisson,equal-ncd,basic:GM-LM-RR-LSVT,sub25100,defpa,Unlocking,0.4,LaplaceMechanism,{'Optimal': 40},1705,1675,1674,718,1183,1673,987,492,1,1705,1675,1674,718,1183,1673,987,492,1,poisson-block-composition-pa
1758,sp_workloads,1690805680,wl_small_mem,1199,basic:GM-LM-RR-LSVT-sub25100-defpa,4,weighted-dpf+,block-composition-pa,poisson,equal-ncd,basic:GM-LM-RR-LSVT,sub25100,defpa,Unlocking,0.4,RandResponseMechanism,{'Optimal': 40},1732,1682,1739,65,186,1473,1667,1496,266,1732,1682,1739,65,186,1473,1667,1496,266,poisson-block-composition-pa
1759,sp_workloads,1690805680,wl_small_mem,1199,basic:GM-LM-RR-LSVT-sub25100-defpa,4,weighted-dpf+,block-composition-pa,poisson,equal-ncd,basic:GM-LM-RR-LSVT,sub25100,defpa,Unlocking,0.4,SVTLaplaceMechanism,{'Optimal': 40},1701,1631,1753,47,225,1383,1654,1406,370,1701,1631,1753,47,225,1383,1654,1406,370,poisson-block-composition-pa
1760,sp_workloads,1690805680,wl_small_mem,1200,gm:GM-sub25100-defpa,0,dpk-gurobi,block-composition,poisson,ncd,gm:GM,sub25100,nopa,Unlocking,0.2,GaussianMechanism,{'Optimal': 40},18864461,1345041,130912,1391541,28812,54624,17472920,1316229,76288,6716,6728,6904,612,196,3414,6104,6532,3490,poisson-block-composition
1761,sp_workloads,1690805680,wl_small_mem,1201,gm:GM-sub25100-defpa,0,dpk-gurobi,block-composition,poisson,ncd,gm:GM,sub25100,nopa,Unlocking,0.4,GaussianMechanism,{'Optimal': 40},18864461,1345041,130912,1404050,37693,54624,17460411,1307348,76288,6716,6728,6904,620,258,3414,6096,6470,3490,poisson-block-composition
1762,sp_workloads,1690805680,wl_small_mem,1202,gm:GM-sub25100-defpa,0,dpk-gurobi,block-composition,upc,ncd,gm:GM,sub25100,nopa,Unlocking,0.2,GaussianMechanism,{'Optimal': 40},18893588,1315647,124584,142340,85477,53443,18751248,1230170,71141,6716,6728,6904,65,797,3485,6651,5931,3419,upc-block-composition
1763,sp_workloads,1690805680,wl_small_mem,1203,gm:GM-sub25100-defpa,0,dpk-gurobi,block-composition,upc,ncd,gm:GM,sub25100,nopa,Unlocking,0.4,GaussianMechanism,{'Optimal': 40},18893588,1315647,124584,128170,124576,54514,18765418,1191071,70070,6716,6728,6904,59,872,3518,6657,5856,3386,upc-block-composition
1764,sp_workloads,1690805680,wl_small_mem,1204,gm:GM-sub25100-defpa,0,dpk-gurobi,block-composition,poisson,equal-ncd,gm:GM,sub25100,nopa,Unlocking,0.2,GaussianMechanism,{'Optimal': 40},6716,6728,6904,95,3327,6802,6621,3401,102,6716,6728,6904,95,3327,6802,6621,3401,102,poisson-block-composition
1765,sp_workloads,1690805680,wl_small_mem,1205,gm:GM-sub25100-defpa,0,dpk-gurobi,block-composition,poisson,equal-ncd,gm:GM,sub25100,nopa,Unlocking,0.4,GaussianMechanism,{'Optimal': 40},6716,6728,6904,161,3327,6174,6555,3401,730,6716,6728,6904,161,3327,6174,6555,3401,730,poisson-block-composition
1766,sp_workloads,1690805680,wl_small_mem,1206,gm:GM-sub25100-defpa,0,dpk-gurobi,block-composition,upc,equal-ncd,gm:GM,sub25100,nopa,Unlocking,0.2,GaussianMechanism,{'Optimal': 40},6716,6728,6904,1,965,6904,6715,5763,0,6716,6728,6904,1,965,6904,6715,5763,0,upc-block-composition
1767,sp_workloads,1690805680,wl_small_mem,1207,gm:GM-sub25100-defpa,0,dpk-gurobi,block-composition,upc,equal-ncd,gm:GM,sub25100,nopa,Unlocking,0.4,GaussianMechanism,{'Optimal': 40},6716,6728,6904,0,1000,6896,6716,5728,8,6716,6728,6904,0,1000,6896,6716,5728,8,upc-block-composition
1768,sp_workloads,1690805680,wl_small_mem,1208,gm:GM-sub25100-defpa,1,dpk-gurobi,block-composition,poisson,ncd,gm:GM,sub25100,nopa,Unlocking,0.2,GaussianMechanism,{'Optimal': 40},18715267,1320958,128176,1365419,31040,53056,17349848,1289918,75120,6673,6765,6731,611,216,3316,6062,6549,3415,poisson-block-composition
1769,sp_workloads,1690805680,wl_small_mem,1209,gm:GM-sub25100-defpa,1,dpk-gurobi,block-composition,poisson,ncd,gm:GM,sub25100,nopa,Unlocking,0.4,GaussianMechanism,{'Optimal': 40},18715267,1320958,128176,1383289,36000,53056,17331978,1284958,75120,6673,6765,6731,621,252,3316,6052,6513,3415,poisson-block-composition
1770,sp_workloads,1690805680,wl_small_mem,1210,gm:GM-sub25100-defpa,1,dpk-gurobi,block-composition,upc,ncd,gm:GM,sub25100,nopa,Unlocking,0.2,GaussianMechanism,{'Optimal': 40},18728783,1307738,120469,151445,80468,52752,18577338,1227270,67717,6673,6765,6731,70,732,3408,6603,6033,3323,upc-block-composition
1771,sp_workloads,1690805680,wl_small_mem,1211,gm:GM-sub25100-defpa,1,dpk-gurobi,block-composition,upc,ncd,gm:GM,sub25100,nopa,Unlocking,0.4,GaussianMechanism,{'Optimal': 40},18728783,1307738,120469,113322,143572,53032,18615461,1164166,67437,6673,6765,6731,53,900,3416,6620,5865,3315,upc-block-composition
1772,sp_workloads,1690805680,wl_small_mem,1212,gm:GM-sub25100-defpa,1,dpk-gurobi,block-composition,poisson,equal-ncd,gm:GM,sub25100,nopa,Unlocking,0.2,GaussianMechanism,{'Optimal': 40},6673,6765,6731,111,3375,6494,6562,3390,237,6673,6765,6731,111,3375,6494,6562,3390,237,poisson-block-composition
1773,sp_workloads,1690805680,wl_small_mem,1213,gm:GM-sub25100-defpa,1,dpk-gurobi,block-composition,poisson,equal-ncd,gm:GM,sub25100,nopa,Unlocking,0.4,GaussianMechanism,{'Optimal': 40},6673,6765,6731,175,3375,5873,6498,3390,858,6673,6765,6731,175,3375,5873,6498,3390,858,poisson-block-composition
1774,sp_workloads,1690805680,wl_small_mem,1214,gm:GM-sub25100-defpa,1,dpk-gurobi,block-composition,upc,equal-ncd,gm:GM,sub25100,nopa,Unlocking,0.2,GaussianMechanism,{'Optimal': 40},6673,6765,6731,0,990,6731,6673,5775,0,6673,6765,6731,0,990,6731,6673,5775,0,upc-block-composition
1775,sp_workloads,1690805680,wl_small_mem,1215,gm:GM-sub25100-defpa,1,dpk-gurobi,block-composition,upc,equal-ncd,gm:GM,sub25100,nopa,Unlocking,0.4,GaussianMechanism,{'Optimal': 40},6673,6765,6731,0,1023,6723,6673,5742,8,6673,6765,6731,0,1023,6723,6673,5742,8,upc-block-composition
1776,sp_workloads,1690805680,wl_small_mem,1216,gm:GM-sub25100-defpa,2,dpk-gurobi,block-composition,poisson,ncd,gm:GM,sub25100,nopa,Unlocking,0.2,GaussianMechanism,{'Optimal': 40},18806374,1355979,126784,1367748,29104,53232,17438626,1326875,73552,6783,6833,6678,612,202,3327,6171,6631,3351,poisson-block-composition
1777,sp_workloads,1690805680,wl_small_mem,1217,gm:GM-sub25100-defpa,2,dpk-gurobi,block-composition,poisson,ncd,gm:GM,sub25100,nopa,Unlocking,0.4,GaussianMechanism,{'Optimal': 40},18806374,1355979,126784,1389952,30256,53232,17416422,1325723,73552,6783,6833,6678,624,210,3327,6159,6623,3351,poisson-block-composition
1778,sp_workloads,1690805680,wl_small_mem,1218,gm:GM-sub25100-defpa,2,dpk-gurobi,block-composition,upc,ncd,gm:GM,sub25100,nopa,Unlocking,0.2,GaussianMechanism,{'Optimal': 40},18840947,1320526,120650,143495,82154,52943,18697452,1238372,67707,6783,6833,6678,67,788,3425,6716,6045,3253,upc-block-composition
1779,sp_workloads,1690805680,wl_small_mem,1219,gm:GM-sub25100-defpa,2,dpk-gurobi,block-composition,upc,ncd,gm:GM,sub25100,nopa,Unlocking,0.4,GaussianMechanism,{'Optimal': 40},18840947,1320526,120650,118318,127601,52006,18722629,1192925,68644,6783,6833,6678,56,938,3386,6727,5895,3292,upc-block-composition
1780,sp_workloads,1690805680,wl_small_mem,1220,gm:GM-sub25100-defpa,2,dpk-gurobi,block-composition,poisson,equal-ncd,gm:GM,sub25100,nopa,Unlocking,0.2,GaussianMechanism,{'Optimal': 40},6783,6833,6678,105,3377,6560,6678,3456,118,6783,6833,6678,105,3377,6560,6678,3456,118,poisson-block-composition
1781,sp_workloads,1690805680,wl_small_mem,1221,gm:GM-sub25100-defpa,2,dpk-gurobi,block-composition,poisson,equal-ncd,gm:GM,sub25100,nopa,Unlocking,0.4,GaussianMechanism,{'Optimal': 40},6783,6833,6678,172,3377,5905,6611,3456,773,6783,6833,6678,172,3377,5905,6611,3456,773,poisson-block-composition
1782,sp_workloads,1690805680,wl_small_mem,1222,gm:GM-sub25100-defpa,2,dpk-gurobi,block-composition,upc,equal-ncd,gm:GM,sub25100,nopa,Unlocking,0.2,GaussianMechanism,{'Optimal': 40},6783,6833,6678,1,1004,6678,6782,5829,0,6783,6833,6678,1,1004,6678,6782,5829,0,upc-block-composition
1783,sp_workloads,1690805680,wl_small_mem,1223,gm:GM-sub25100-defpa,2,dpk-gurobi,block-composition,upc,equal-ncd,gm:GM,sub25100,nopa,Unlocking,0.4,GaussianMechanism,{'Optimal': 40},6783,6833,6678,2,1030,6678,6781,5803,0,6783,6833,6678,2,1030,6678,6781,5803,0,upc-block-composition
1784,sp_workloads,1690805680,wl_small_mem,1224,gm:GM-sub25100-defpa,3,dpk-gurobi,block-composition,poisson,ncd,gm:GM,sub25100,nopa,Unlocking,0.2,GaussianMechanism,{'Optimal': 40},18672541,1292482,118587,1321847,27661,50745,17350694,1264821,67842,6771,6693,6629,612,199,3383,6159,6494,3246,poisson-block-composition
1785,sp_workloads,1690805680,wl_small_mem,1225,gm:GM-sub25100-defpa,3,dpk-gurobi,block-composition,poisson,ncd,gm:GM,sub25100,nopa,Unlocking,0.4,GaussianMechanism,{'Optimal': 40},18672541,1292482,118587,1338565,32250,50745,17333976,1260232,67842,6771,6693,6629,622,234,3383,6149,6459,3246,poisson-block-composition
1786,sp_workloads,1690805680,wl_small_mem,1226,gm:GM-sub25100-defpa,3,dpk-gurobi,block-composition,upc,ncd,gm:GM,sub25100,nopa,Unlocking,0.2,GaussianMechanism,{'Optimal': 40},18653277,1308064,119435,136401,89439,53365,18516876,1218625,66070,6771,6693,6629,63,798,3467,6708,5895,3162,upc-block-composition
1787,sp_workloads,1690805680,wl_small_mem,1227,gm:GM-sub25100-defpa,3,dpk-gurobi,block-composition,upc,ncd,gm:GM,sub25100,nopa,Unlocking,0.4,GaussianMechanism,{'Optimal': 40},18653277,1308064,119435,119045,130278,52661,18534232,1177786,66774,6771,6693,6629,55,905,3435,6716,5788,3194,upc-block-composition
1788,sp_workloads,1690805680,wl_small_mem,1228,gm:GM-sub25100-defpa,3,dpk-gurobi,block-composition,poisson,equal-ncd,gm:GM,sub25100,nopa,Unlocking,0.2,GaussianMechanism,{'Optimal': 40},6771,6693,6629,114,3319,6545,6657,3374,84,6771,6693,6629,114,3319,6545,6657,3374,84,poisson-block-composition
1789,sp_workloads,1690805680,wl_small_mem,1229,gm:GM-sub25100-defpa,3,dpk-gurobi,block-composition,poisson,equal-ncd,gm:GM,sub25100,nopa,Unlocking,0.4,GaussianMechanism,{'Optimal': 40},6771,6693,6629,181,3319,5913,6590,3374,716,6771,6693,6629,181,3319,5913,6590,3374,716,poisson-block-composition
1790,sp_workloads,1690805680,wl_small_mem,1230,gm:GM-sub25100-defpa,3,dpk-gurobi,block-composition,upc,equal-ncd,gm:GM,sub25100,nopa,Unlocking,0.2,GaussianMechanism,{'Optimal': 40},6771,6693,6629,1,1025,6629,6770,5668,0,6771,6693,6629,1,1025,6629,6770,5668,0,upc-block-composition
1791,sp_workloads,1690805680,wl_small_mem,1231,gm:GM-sub25100-defpa,3,dpk-gurobi,block-composition,upc,equal-ncd,gm:GM,sub25100,nopa,Unlocking,0.4,GaussianMechanism,{'Optimal': 40},6771,6693,6629,1,1065,6620,6770,5628,9,6771,6693,6629,1,1065,6620,6770,5628,9,upc-block-composition
1792,sp_workloads,1690805680,wl_small_mem,1232,gm:GM-sub25100-defpa,4,dpk-gurobi,block-composition,poisson,ncd,gm:GM,sub25100,nopa,Unlocking,0.2,GaussianMechanism,{'Optimal': 40},18857452,1277663,120343,1330630,28420,49770,17526822,1249243,70573,6862,6691,6713,612,203,3318,6250,6488,3395,poisson-block-composition
1793,sp_workloads,1690805680,wl_small_mem,1233,gm:GM-sub25100-defpa,4,dpk-gurobi,block-composition,poisson,ncd,gm:GM,sub25100,nopa,Unlocking,0.4,GaussianMechanism,{'Optimal': 40},18857452,1277663,120343,1349038,31360,49770,17508414,1246303,70573,6862,6691,6713,623,224,3318,6239,6467,3395,poisson-block-composition
1794,sp_workloads,1690805680,wl_small_mem,1234,gm:GM-sub25100-defpa,4,dpk-gurobi,block-composition,upc,ncd,gm:GM,sub25100,nopa,Unlocking,0.2,GaussianMechanism,{'Optimal': 40},18854676,1280656,121591,152906,73777,51435,18701770,1206879,70156,6862,6691,6713,72,709,3365,6790,5982,3348,upc-block-composition
1795,sp_workloads,1690805680,wl_small_mem,1235,gm:GM-sub25100-defpa,4,dpk-gurobi,block-composition,upc,ncd,gm:GM,sub25100,nopa,Unlocking,0.4,GaussianMechanism,{'Optimal': 40},18854676,1280656,121591,124669,119982,52003,18730007,1160674,69588,6862,6691,6713,59,828,3389,6803,5863,3324,upc-block-composition
1796,sp_workloads,1690805680,wl_small_mem,1236,gm:GM-sub25100-defpa,4,dpk-gurobi,block-composition,poisson,equal-ncd,gm:GM,sub25100,nopa,Unlocking,0.2,GaussianMechanism,{'Optimal': 40},6862,6691,6713,105,3325,6610,6757,3366,103,6862,6691,6713,105,3325,6610,6757,3366,103,poisson-block-composition
1797,sp_workloads,1690805680,wl_small_mem,1237,gm:GM-sub25100-defpa,4,dpk-gurobi,block-composition,poisson,equal-ncd,gm:GM,sub25100,nopa,Unlocking,0.4,GaussianMechanism,{'Optimal': 40},6862,6691,6713,173,3325,5942,6689,3366,771,6862,6691,6713,173,3325,5942,6689,3366,771,poisson-block-composition
1798,sp_workloads,1690805680,wl_small_mem,1238,gm:GM-sub25100-defpa,4,dpk-gurobi,block-composition,upc,equal-ncd,gm:GM,sub25100,nopa,Unlocking,0.2,GaussianMechanism,{'Optimal': 40},6862,6691,6713,1,988,6713,6861,5703,0,6862,6691,6713,1,988,6713,6861,5703,0,upc-block-composition
1799,sp_workloads,1690805680,wl_small_mem,1239,gm:GM-sub25100-defpa,4,dpk-gurobi,block-composition,upc,equal-ncd,gm:GM,sub25100,nopa,Unlocking,0.4,GaussianMechanism,{'Optimal': 40},6862,6691,6713,0,1028,6708,6862,5663,5,6862,6691,6713,0,1028,6708,6862,5663,5,upc-block-composition
1800,sp_workloads,1690805680,wl_small_mem,1240,ml:SGD-PATE-sub25100-defpa,0,dpk-gurobi,block-composition,poisson,ncd,ml:SGD-PATE,sub25100,nopa,Unlocking,0.2,MLNoisySGDMechanism,{'Optimal': 40},9320337,647144,60780,1251557,139,22815,8068780,647005,37965,3347,3348,3392,598,1,1520,2749,3347,1872,poisson-block-composition
1801,sp_workloads,1690805680,wl_small_mem,1240,ml:SGD-PATE-sub25100-defpa,0,dpk-gurobi,block-composition,poisson,ncd,ml:SGD-PATE,sub25100,nopa,Unlocking,0.2,MLPateGaussianMechanism,{'Optimal': 40},9560711,630849,59490,278741,18316,24885,9281970,612533,34605,3488,3389,3328,129,132,1659,3359,3257,1669,poisson-block-composition
1802,sp_workloads,1690805680,wl_small_mem,1241,ml:SGD-PATE-sub25100-defpa,0,dpk-gurobi,block-composition,poisson,ncd,ml:SGD-PATE,sub25100,nopa,Unlocking,0.4,MLNoisySGDMechanism,{'Optimal': 40},9320337,647144,60780,1151695,0,24435,8168642,647144,36345,3347,3348,3392,550,0,1629,2797,3348,1763,poisson-block-composition
1803,sp_workloads,1690805680,wl_small_mem,1241,ml:SGD-PATE-sub25100-defpa,0,dpk-gurobi,block-composition,poisson,ncd,ml:SGD-PATE,sub25100,nopa,Unlocking,0.4,MLPateGaussianMechanism,{'Optimal': 40},9560711,630849,59490,382845,22240,24885,9177866,608609,34605,3488,3389,3328,178,160,1659,3310,3229,1669,poisson-block-composition
1804,sp_workloads,1690805680,wl_small_mem,1242,ml:SGD-PATE-sub25100-defpa,0,dpk-gurobi,block-composition,upc,ncd,ml:SGD-PATE,sub25100,nopa,Unlocking,0.2,MLNoisySGDMechanism,{'Optimal': 40},9083039,636185,61248,364605,27202,24368,8718434,608983,36880,3347,3348,3392,171,260,1600,3176,3088,1792,upc-block-composition
1805,sp_workloads,1690805680,wl_small_mem,1242,ml:SGD-PATE-sub25100-defpa,0,dpk-gurobi,block-composition,upc,ncd,ml:SGD-PATE,sub25100,nopa,Unlocking,0.2,MLPateGaussianMechanism,{'Optimal': 40},9794725,645631,60352,2197,20302,21240,9792528,625329,39112,3488,3389,3328,1,224,1416,3487,3165,1912,upc-block-composition
1806,sp_workloads,1690805680,wl_small_mem,1243,ml:SGD-PATE-sub25100-defpa,0,dpk-gurobi,block-composition,upc,ncd,ml:SGD-PATE,sub25100,nopa,Unlocking,0.4,MLNoisySGDMechanism,{'Optimal': 40},9083039,636185,61248,363170,40021,23231,8719869,596164,38017,3347,3348,3392,170,359,1537,3177,2989,1855,upc-block-composition
1807,sp_workloads,1690805680,wl_small_mem,1243,ml:SGD-PATE-sub25100-defpa,0,dpk-gurobi,block-composition,upc,ncd,ml:SGD-PATE,sub25100,nopa,Unlocking,0.4,MLPateGaussianMechanism,{'Optimal': 40},9794725,645631,60352,2197,24875,20175,9792528,620756,40177,3488,3389,3328,1,257,1345,3487,3132,1983,upc-block-composition
1808,sp_workloads,1690805680,wl_small_mem,1244,ml:SGD-PATE-sub25100-defpa,0,dpk-gurobi,block-composition,poisson,equal-ncd,ml:SGD-PATE,sub25100,nopa,Unlocking,0.2,MLNoisySGDMechanism,{'Optimal': 40},3347,3348,3392,113,1454,3392,3234,1894,0,3347,3348,3392,113,1454,3392,3234,1894,0,poisson-block-composition
1809,sp_workloads,1690805680,wl_small_mem,1244,ml:SGD-PATE-sub25100-defpa,0,dpk-gurobi,block-composition,poisson,equal-ncd,ml:SGD-PATE,sub25100,nopa,Unlocking,0.2,MLPateGaussianMechanism,{'Optimal': 40},3488,3389,3328,0,1697,3328,3488,1692,0,3488,3389,3328,0,1697,3328,3488,1692,0,poisson-block-composition
1810,sp_workloads,1690805680,wl_small_mem,1245,ml:SGD-PATE-sub25100-defpa,0,dpk-gurobi,block-composition,poisson,equal-ncd,ml:SGD-PATE,sub25100,nopa,Unlocking,0.4,MLNoisySGDMechanism,{'Optimal': 40},3347,3348,3392,193,1023,3392,3154,2325,0,3347,3348,3392,193,1023,3392,3154,2325,0,poisson-block-composition
1811,sp_workloads,1690805680,wl_small_mem,1245,ml:SGD-PATE-sub25100-defpa,0,dpk-gurobi,block-composition,poisson,equal-ncd,ml:SGD-PATE,sub25100,nopa,Unlocking,0.4,MLPateGaussianMechanism,{'Optimal': 40},3488,3389,3328,0,1697,3187,3488,1692,141,3488,3389,3328,0,1697,3187,3488,1692,141,poisson-block-composition
1812,sp_workloads,1690805680,wl_small_mem,1246,ml:SGD-PATE-sub25100-defpa,0,dpk-gurobi,block-composition,upc,equal-ncd,ml:SGD-PATE,sub25100,nopa,Unlocking,0.2,MLNoisySGDMechanism,{'Optimal': 40},3347,3348,3392,1,976,3392,3346,2372,0,3347,3348,3392,1,976,3392,3346,2372,0,upc-block-composition
1813,sp_workloads,1690805680,wl_small_mem,1246,ml:SGD-PATE-sub25100-defpa,0,dpk-gurobi,block-composition,upc,equal-ncd,ml:SGD-PATE,sub25100,nopa,Unlocking,0.2,MLPateGaussianMechanism,{'Optimal': 40},3488,3389,3328,0,201,3328,3488,3188,0,3488,3389,3328,0,201,3328,3488,3188,0,upc-block-composition
1814,sp_workloads,1690805680,wl_small_mem,1247,ml:SGD-PATE-sub25100-defpa,0,dpk-gurobi,block-composition,upc,equal-ncd,ml:SGD-PATE,sub25100,nopa,Unlocking,0.4,MLNoisySGDMechanism,{'Optimal': 40},3347,3348,3392,2,858,3392,3345,2490,0,3347,3348,3392,2,858,3392,3345,2490,0,upc-block-composition
1815,sp_workloads,1690805680,wl_small_mem,1247,ml:SGD-PATE-sub25100-defpa,0,dpk-gurobi,block-composition,upc,equal-ncd,ml:SGD-PATE,sub25100,nopa,Unlocking,0.4,MLPateGaussianMechanism,{'Optimal': 40},3488,3389,3328,0,326,3326,3488,3063,2,3488,3389,3328,0,326,3326,3488,3063,2,upc-block-composition
1816,sp_workloads,1690805680,wl_small_mem,1248,ml:SGD-PATE-sub25100-defpa,1,dpk-gurobi,block-composition,poisson,ncd,ml:SGD-PATE,sub25100,nopa,Unlocking,0.2,MLNoisySGDMechanism,{'Optimal': 40},9612014,638642,60437,1309842,0,24465,8302172,638642,35972,3436,3336,3371,623,0,1631,2813,3336,1740,poisson-block-composition
1817,sp_workloads,1690805680,wl_small_mem,1248,ml:SGD-PATE-sub25100-defpa,1,dpk-gurobi,block-composition,poisson,ncd,ml:SGD-PATE,sub25100,nopa,Unlocking,0.2,MLPateGaussianMechanism,{'Optimal': 40},9101816,660711,61026,232470,20252,25035,8869346,640459,35991,3337,3307,3358,107,145,1669,3230,3162,1689,poisson-block-composition
1818,sp_workloads,1690805680,wl_small_mem,1249,ml:SGD-PATE-sub25100-defpa,1,dpk-gurobi,block-composition,poisson,ncd,ml:SGD-PATE,sub25100,nopa,Unlocking,0.4,MLNoisySGDMechanism,{'Optimal': 40},9612014,638642,60437,1225834,2876,25546,8386180,635766,34891,3436,3336,3371,583,21,1702,2853,3315,1669,poisson-block-composition
1819,sp_workloads,1690805680,wl_small_mem,1249,ml:SGD-PATE-sub25100-defpa,1,dpk-gurobi,block-composition,poisson,ncd,ml:SGD-PATE,sub25100,nopa,Unlocking,0.4,MLPateGaussianMechanism,{'Optimal': 40},9101816,660711,61026,320107,23331,25035,8781709,637380,35991,3337,3307,3358,148,168,1669,3189,3139,1689,poisson-block-composition
1820,sp_workloads,1690805680,wl_small_mem,1250,ml:SGD-PATE-sub25100-defpa,1,dpk-gurobi,block-composition,upc,ncd,ml:SGD-PATE,sub25100,nopa,Unlocking,0.2,MLNoisySGDMechanism,{'Optimal': 40},9248526,647648,60469,377878,24795,25514,8870648,622853,34955,3436,3336,3371,175,260,1686,3261,3076,1685,upc-block-composition
1821,sp_workloads,1690805680,wl_small_mem,1250,ml:SGD-PATE-sub25100-defpa,1,dpk-gurobi,block-composition,upc,ncd,ml:SGD-PATE,sub25100,nopa,Unlocking,0.2,MLPateGaussianMechanism,{'Optimal': 40},9470335,646016,60114,0,19948,21435,9470335,626068,38679,3337,3307,3358,0,214,1429,3337,3093,1929,upc-block-composition
1822,sp_workloads,1690805680,wl_small_mem,1251,ml:SGD-PATE-sub25100-defpa,1,dpk-gurobi,block-composition,upc,ncd,ml:SGD-PATE,sub25100,nopa,Unlocking,0.4,MLNoisySGDMechanism,{'Optimal': 40},9248526,647648,60469,373956,37394,24670,8874570,610254,35799,3436,3336,3371,179,344,1634,3257,2992,1737,upc-block-composition
1823,sp_workloads,1690805680,wl_small_mem,1251,ml:SGD-PATE-sub25100-defpa,1,dpk-gurobi,block-composition,upc,ncd,ml:SGD-PATE,sub25100,nopa,Unlocking,0.4,MLPateGaussianMechanism,{'Optimal': 40},9470335,646016,60114,0,24783,20445,9470335,621233,39669,3337,3307,3358,0,245,1363,3337,3062,1995,upc-block-composition
1824,sp_workloads,1690805680,wl_small_mem,1252,ml:SGD-PATE-sub25100-defpa,1,dpk-gurobi,block-composition,poisson,equal-ncd,ml:SGD-PATE,sub25100,nopa,Unlocking,0.2,MLNoisySGDMechanism,{'Optimal': 40},3436,3336,3371,136,1373,3371,3300,1963,0,3436,3336,3371,136,1373,3371,3300,1963,0,poisson-block-composition
1825,sp_workloads,1690805680,wl_small_mem,1252,ml:SGD-PATE-sub25100-defpa,1,dpk-gurobi,block-composition,poisson,equal-ncd,ml:SGD-PATE,sub25100,nopa,Unlocking,0.2,MLPateGaussianMechanism,{'Optimal': 40},3337,3307,3358,0,1606,3358,3337,1701,0,3337,3307,3358,0,1606,3358,3337,1701,0,poisson-block-composition
1826,sp_workloads,1690805680,wl_small_mem,1253,ml:SGD-PATE-sub25100-defpa,1,dpk-gurobi,block-composition,poisson,equal-ncd,ml:SGD-PATE,sub25100,nopa,Unlocking,0.4,MLNoisySGDMechanism,{'Optimal': 40},3436,3336,3371,219,938,3371,3217,2398,0,3436,3336,3371,219,938,3371,3217,2398,0,poisson-block-composition
1827,sp_workloads,1690805680,wl_small_mem,1253,ml:SGD-PATE-sub25100-defpa,1,dpk-gurobi,block-composition,poisson,equal-ncd,ml:SGD-PATE,sub25100,nopa,Unlocking,0.4,MLPateGaussianMechanism,{'Optimal': 40},3337,3307,3358,0,1606,3202,3337,1701,156,3337,3307,3358,0,1606,3202,3337,1701,156,poisson-block-composition
1828,sp_workloads,1690805680,wl_small_mem,1254,ml:SGD-PATE-sub25100-defpa,1,dpk-gurobi,block-composition,upc,equal-ncd,ml:SGD-PATE,sub25100,nopa,Unlocking,0.2,MLNoisySGDMechanism,{'Optimal': 40},3436,3336,3371,2,956,3371,3434,2380,0,3436,3336,3371,2,956,3371,3434,2380,0,upc-block-composition
1829,sp_workloads,1690805680,wl_small_mem,1254,ml:SGD-PATE-sub25100-defpa,1,dpk-gurobi,block-composition,upc,equal-ncd,ml:SGD-PATE,sub25100,nopa,Unlocking,0.2,MLPateGaussianMechanism,{'Optimal': 40},3337,3307,3358,0,223,3358,3337,3084,0,3337,3307,3358,0,223,3358,3337,3084,0,upc-block-composition
1830,sp_workloads,1690805680,wl_small_mem,1255,ml:SGD-PATE-sub25100-defpa,1,dpk-gurobi,block-composition,upc,equal-ncd,ml:SGD-PATE,sub25100,nopa,Unlocking,0.4,MLNoisySGDMechanism,{'Optimal': 40},3436,3336,3371,4,844,3371,3432,2492,0,3436,3336,3371,4,844,3371,3432,2492,0,upc-block-composition
1831,sp_workloads,1690805680,wl_small_mem,1255,ml:SGD-PATE-sub25100-defpa,1,dpk-gurobi,block-composition,upc,equal-ncd,ml:SGD-PATE,sub25100,nopa,Unlocking,0.4,MLPateGaussianMechanism,{'Optimal': 40},3337,3307,3358,0,344,3340,3337,2963,18,3337,3307,3358,0,344,3340,3337,2963,18,upc-block-composition
1832,sp_workloads,1690805680,wl_small_mem,1256,ml:SGD-PATE-sub25100-defpa,2,dpk-gurobi,block-composition,poisson,ncd,ml:SGD-PATE,sub25100,nopa,Unlocking,0.2,MLNoisySGDMechanism,{'Optimal': 40},9102086,650387,61289,1253776,286,22590,7848310,650101,38699,3387,3344,3399,585,2,1506,2802,3342,1893,poisson-block-composition
1833,sp_workloads,1690805680,wl_small_mem,1256,ml:SGD-PATE-sub25100-defpa,2,dpk-gurobi,block-composition,poisson,ncd,ml:SGD-PATE,sub25100,nopa,Unlocking,0.2,MLPateGaussianMechanism,{'Optimal': 40},9667159,651460,60587,310466,17477,25710,9356693,633983,34877,3356,3340,3381,140,123,1714,3216,3217,1667,poisson-block-composition
1834,sp_workloads,1690805680,wl_small_mem,1257,ml:SGD-PATE-sub25100-defpa,2,dpk-gurobi,block-composition,poisson,ncd,ml:SGD-PATE,sub25100,nopa,Unlocking,0.4,MLNoisySGDMechanism,{'Optimal': 40},9102086,650387,61289,1182061,1144,24811,7920025,649243,36478,3387,3344,3399,553,8,1653,2834,3336,1746,poisson-block-composition
1835,sp_workloads,1690805680,wl_small_mem,1257,ml:SGD-PATE-sub25100-defpa,2,dpk-gurobi,block-composition,poisson,ncd,ml:SGD-PATE,sub25100,nopa,Unlocking,0.4,MLPateGaussianMechanism,{'Optimal': 40},9667159,651460,60587,388456,19527,25710,9278703,631933,34877,3356,3340,3381,176,137,1714,3180,3203,1667,poisson-block-composition
1836,sp_workloads,1690805680,wl_small_mem,1258,ml:SGD-PATE-sub25100-defpa,2,dpk-gurobi,block-composition,upc,ncd,ml:SGD-PATE,sub25100,nopa,Unlocking,0.2,MLNoisySGDMechanism,{'Optimal': 40},9360300,635145,61577,368922,27282,24748,8991378,607863,36829,3387,3344,3399,177,280,1636,3210,3064,1763,upc-block-composition
1837,sp_workloads,1690805680,wl_small_mem,1258,ml:SGD-PATE-sub25100-defpa,2,dpk-gurobi,block-composition,upc,ncd,ml:SGD-PATE,sub25100,nopa,Unlocking,0.2,MLPateGaussianMechanism,{'Optimal': 40},9448947,628519,60475,2170,17455,22320,9446777,611064,38155,3356,3340,3381,1,191,1488,3355,3149,1893,upc-block-composition
1838,sp_workloads,1690805680,wl_small_mem,1259,ml:SGD-PATE-sub25100-defpa,2,dpk-gurobi,block-composition,upc,ncd,ml:SGD-PATE,sub25100,nopa,Unlocking,0.4,MLNoisySGDMechanism,{'Optimal': 40},9360300,635145,61577,350947,46670,25203,9009353,588475,36374,3387,3344,3399,169,399,1661,3218,2945,1738,upc-block-composition
1839,sp_workloads,1690805680,wl_small_mem,1259,ml:SGD-PATE-sub25100-defpa,2,dpk-gurobi,block-composition,upc,ncd,ml:SGD-PATE,sub25100,nopa,Unlocking,0.4,MLPateGaussianMechanism,{'Optimal': 40},9448947,628519,60475,1352,24528,21720,9447595,603991,38755,3356,3340,3381,1,254,1448,3355,3086,1933,upc-block-composition
1840,sp_workloads,1690805680,wl_small_mem,1260,ml:SGD-PATE-sub25100-defpa,2,dpk-gurobi,block-composition,poisson,equal-ncd,ml:SGD-PATE,sub25100,nopa,Unlocking,0.2,MLNoisySGDMechanism,{'Optimal': 40},3387,3344,3399,108,1526,3399,3279,1818,0,3387,3344,3399,108,1526,3399,3279,1818,0,poisson-block-composition
1841,sp_workloads,1690805680,wl_small_mem,1260,ml:SGD-PATE-sub25100-defpa,2,dpk-gurobi,block-composition,poisson,equal-ncd,ml:SGD-PATE,sub25100,nopa,Unlocking,0.2,MLPateGaussianMechanism,{'Optimal': 40},3356,3340,3381,0,1706,3381,3356,1634,0,3356,3340,3381,0,1706,3381,3356,1634,0,poisson-block-composition
1842,sp_workloads,1690805680,wl_small_mem,1261,ml:SGD-PATE-sub25100-defpa,2,dpk-gurobi,block-composition,poisson,equal-ncd,ml:SGD-PATE,sub25100,nopa,Unlocking,0.4,MLNoisySGDMechanism,{'Optimal': 40},3387,3344,3399,192,1010,3399,3195,2334,0,3387,3344,3399,192,1010,3399,3195,2334,0,poisson-block-composition
1843,sp_workloads,1690805680,wl_small_mem,1261,ml:SGD-PATE-sub25100-defpa,2,dpk-gurobi,block-composition,poisson,equal-ncd,ml:SGD-PATE,sub25100,nopa,Unlocking,0.4,MLPateGaussianMechanism,{'Optimal': 40},3356,3340,3381,0,1706,3299,3356,1634,82,3356,3340,3381,0,1706,3299,3356,1634,82,poisson-block-composition
1844,sp_workloads,1690805680,wl_small_mem,1262,ml:SGD-PATE-sub25100-defpa,2,dpk-gurobi,block-composition,upc,equal-ncd,ml:SGD-PATE,sub25100,nopa,Unlocking,0.2,MLNoisySGDMechanism,{'Optimal': 40},3387,3344,3399,1,977,3399,3386,2367,0,3387,3344,3399,1,977,3399,3386,2367,0,upc-block-composition
1845,sp_workloads,1690805680,wl_small_mem,1262,ml:SGD-PATE-sub25100-defpa,2,dpk-gurobi,block-composition,upc,equal-ncd,ml:SGD-PATE,sub25100,nopa,Unlocking,0.2,MLPateGaussianMechanism,{'Optimal': 40},3356,3340,3381,0,202,3381,3356,3138,0,3356,3340,3381,0,202,3381,3356,3138,0,upc-block-composition
1846,sp_workloads,1690805680,wl_small_mem,1263,ml:SGD-PATE-sub25100-defpa,2,dpk-gurobi,block-composition,upc,equal-ncd,ml:SGD-PATE,sub25100,nopa,Unlocking,0.4,MLNoisySGDMechanism,{'Optimal': 40},3387,3344,3399,4,841,3399,3383,2503,0,3387,3344,3399,4,841,3399,3383,2503,0,upc-block-composition
1847,sp_workloads,1690805680,wl_small_mem,1263,ml:SGD-PATE-sub25100-defpa,2,dpk-gurobi,block-composition,upc,equal-ncd,ml:SGD-PATE,sub25100,nopa,Unlocking,0.4,MLPateGaussianMechanism,{'Optimal': 40},3356,3340,3381,1,325,3381,3355,3015,0,3356,3340,3381,1,325,3381,3355,3015,0,upc-block-composition
1848,sp_workloads,1690805680,wl_small_mem,1264,ml:SGD-PATE-sub25100-defpa,3,dpk-gurobi,block-composition,poisson,ncd,ml:SGD-PATE,sub25100,nopa,Unlocking,0.2,MLNoisySGDMechanism,{'Optimal': 40},9538338,661542,60462,1207911,564,24902,8330427,660978,35560,3432,3504,3362,571,4,1658,2861,3500,1704,poisson-block-composition
1849,sp_workloads,1690805680,wl_small_mem,1264,ml:SGD-PATE-sub25100-defpa,3,dpk-gurobi,block-composition,poisson,ncd,ml:SGD-PATE,sub25100,nopa,Unlocking,0.2,MLPateGaussianMechanism,{'Optimal': 40},9431567,656376,60193,323950,21571,25035,9107617,634805,35158,3379,3400,3343,148,154,1669,3231,3246,1674,poisson-block-composition
1850,sp_workloads,1690805680,wl_small_mem,1265,ml:SGD-PATE-sub25100-defpa,3,dpk-gurobi,block-composition,poisson,ncd,ml:SGD-PATE,sub25100,nopa,Unlocking,0.4,MLNoisySGDMechanism,{'Optimal': 40},9538338,661542,60462,1136075,282,25591,8402263,661260,34871,3432,3504,3362,537,2,1705,2895,3502,1657,poisson-block-composition
1851,sp_workloads,1690805680,wl_small_mem,1265,ml:SGD-PATE-sub25100-defpa,3,dpk-gurobi,block-composition,poisson,ncd,ml:SGD-PATE,sub25100,nopa,Unlocking,0.4,MLPateGaussianMechanism,{'Optimal': 40},9431567,656376,60193,412946,18282,25035,9018621,638094,35158,3379,3400,3343,190,130,1669,3189,3270,1674,poisson-block-composition
1852,sp_workloads,1690805680,wl_small_mem,1266,ml:SGD-PATE-sub25100-defpa,3,dpk-gurobi,block-composition,upc,ncd,ml:SGD-PATE,sub25100,nopa,Unlocking,0.2,MLNoisySGDMechanism,{'Optimal': 40},9534421,712160,60142,376848,26145,24924,9157573,686015,35218,3432,3504,3362,176,271,1652,3256,3233,1710,upc-block-composition
1853,sp_workloads,1690805680,wl_small_mem,1266,ml:SGD-PATE-sub25100-defpa,3,dpk-gurobi,block-composition,upc,ncd,ml:SGD-PATE,sub25100,nopa,Unlocking,0.2,MLPateGaussianMechanism,{'Optimal': 40},9371673,665112,59809,0,19490,21420,9371673,645622,38389,3379,3400,3343,0,206,1428,3379,3194,1915,upc-block-composition
1854,sp_workloads,1690805680,wl_small_mem,1267,ml:SGD-PATE-sub25100-defpa,3,dpk-gurobi,block-composition,upc,ncd,ml:SGD-PATE,sub25100,nopa,Unlocking,0.4,MLNoisySGDMechanism,{'Optimal': 40},9534421,712160,60142,368227,42915,24401,9166194,669245,35741,3432,3504,3362,170,381,1615,3262,3123,1747,upc-block-composition
1855,sp_workloads,1690805680,wl_small_mem,1267,ml:SGD-PATE-sub25100-defpa,3,dpk-gurobi,block-composition,upc,ncd,ml:SGD-PATE,sub25100,nopa,Unlocking,0.4,MLPateGaussianMechanism,{'Optimal': 40},9371673,665112,59809,1935,25893,19830,9369738,639219,39979,3379,3400,3343,1,251,1322,3378,3149,2021,upc-block-composition
1856,sp_workloads,1690805680,wl_small_mem,1268,ml:SGD-PATE-sub25100-defpa,3,dpk-gurobi,block-composition,poisson,equal-ncd,ml:SGD-PATE,sub25100,nopa,Unlocking,0.2,MLNoisySGDMechanism,{'Optimal': 40},3432,3504,3362,115,1499,3362,3317,2005,0,3432,3504,3362,115,1499,3362,3317,2005,0,poisson-block-composition
1857,sp_workloads,1690805680,wl_small_mem,1268,ml:SGD-PATE-sub25100-defpa,3,dpk-gurobi,block-composition,poisson,equal-ncd,ml:SGD-PATE,sub25100,nopa,Unlocking,0.2,MLPateGaussianMechanism,{'Optimal': 40},3379,3400,3343,0,1699,3343,3379,1701,0,3379,3400,3343,0,1699,3343,3379,1701,0,poisson-block-composition
1858,sp_workloads,1690805680,wl_small_mem,1269,ml:SGD-PATE-sub25100-defpa,3,dpk-gurobi,block-composition,poisson,equal-ncd,ml:SGD-PATE,sub25100,nopa,Unlocking,0.4,MLNoisySGDMechanism,{'Optimal': 40},3432,3504,3362,198,1083,3362,3234,2421,0,3432,3504,3362,198,1083,3362,3234,2421,0,poisson-block-composition
1859,sp_workloads,1690805680,wl_small_mem,1269,ml:SGD-PATE-sub25100-defpa,3,dpk-gurobi,block-composition,poisson,equal-ncd,ml:SGD-PATE,sub25100,nopa,Unlocking,0.4,MLPateGaussianMechanism,{'Optimal': 40},3379,3400,3343,0,1699,3164,3379,1701,179,3379,3400,3343,0,1699,3164,3379,1701,179,poisson-block-composition
1860,sp_workloads,1690805680,wl_small_mem,1270,ml:SGD-PATE-sub25100-defpa,3,dpk-gurobi,block-composition,upc,equal-ncd,ml:SGD-PATE,sub25100,nopa,Unlocking,0.2,MLNoisySGDMechanism,{'Optimal': 40},3432,3504,3362,1,1012,3362,3431,2492,0,3432,3504,3362,1,1012,3362,3431,2492,0,upc-block-composition
1861,sp_workloads,1690805680,wl_small_mem,1270,ml:SGD-PATE-sub25100-defpa,3,dpk-gurobi,block-composition,upc,equal-ncd,ml:SGD-PATE,sub25100,nopa,Unlocking,0.2,MLPateGaussianMechanism,{'Optimal': 40},3379,3400,3343,0,195,3343,3379,3205,0,3379,3400,3343,0,195,3343,3379,3205,0,upc-block-composition
1862,sp_workloads,1690805680,wl_small_mem,1271,ml:SGD-PATE-sub25100-defpa,3,dpk-gurobi,block-composition,upc,equal-ncd,ml:SGD-PATE,sub25100,nopa,Unlocking,0.4,MLNoisySGDMechanism,{'Optimal': 40},3432,3504,3362,1,902,3362,3431,2602,0,3432,3504,3362,1,902,3362,3431,2602,0,upc-block-composition
1863,sp_workloads,1690805680,wl_small_mem,1271,ml:SGD-PATE-sub25100-defpa,3,dpk-gurobi,block-composition,upc,equal-ncd,ml:SGD-PATE,sub25100,nopa,Unlocking,0.4,MLPateGaussianMechanism,{'Optimal': 40},3379,3400,3343,1,308,3340,3378,3092,3,3379,3400,3343,1,308,3340,3378,3092,3,upc-block-composition
1864,sp_workloads,1690805680,wl_small_mem,1272,ml:SGD-PATE-sub25100-defpa,4,dpk-gurobi,block-composition,poisson,ncd,ml:SGD-PATE,sub25100,nopa,Unlocking,0.2,MLNoisySGDMechanism,{'Optimal': 40},9619476,680600,63408,1318335,0,25280,8301141,680600,38128,3443,3381,3350,604,0,1577,2839,3381,1773,poisson-block-composition
1865,sp_workloads,1690805680,wl_small_mem,1272,ml:SGD-PATE-sub25100-defpa,4,dpk-gurobi,block-composition,poisson,ncd,ml:SGD-PATE,sub25100,nopa,Unlocking,0.2,MLPateGaussianMechanism,{'Optimal': 40},9087643,650021,64528,275505,19440,28000,8812138,630581,36528,3245,3345,3408,123,135,1750,3122,3210,1658,poisson-block-composition
1866,sp_workloads,1690805680,wl_small_mem,1273,ml:SGD-PATE-sub25100-defpa,4,dpk-gurobi,block-composition,poisson,ncd,ml:SGD-PATE,sub25100,nopa,Unlocking,0.4,MLNoisySGDMechanism,{'Optimal': 40},9619476,680600,63408,1211885,288,26240,8407591,680312,37168,3443,3381,3350,555,2,1640,2888,3379,1710,poisson-block-composition
1867,sp_workloads,1690805680,wl_small_mem,1273,ml:SGD-PATE-sub25100-defpa,4,dpk-gurobi,block-composition,poisson,ncd,ml:SGD-PATE,sub25100,nopa,Unlocking,0.4,MLPateGaussianMechanism,{'Optimal': 40},9087643,650021,64528,384920,23280,28000,8702723,626741,36528,3245,3345,3408,173,162,1750,3072,3183,1658,poisson-block-composition
1868,sp_workloads,1690805680,wl_small_mem,1274,ml:SGD-PATE-sub25100-defpa,4,dpk-gurobi,block-composition,upc,ncd,ml:SGD-PATE,sub25100,nopa,Unlocking,0.2,MLNoisySGDMechanism,{'Optimal': 40},9753693,680301,63744,371146,31552,25248,9382547,648749,38496,3443,3381,3350,169,316,1572,3274,3065,1778,upc-block-composition
1869,sp_workloads,1690805680,wl_small_mem,1274,ml:SGD-PATE-sub25100-defpa,4,dpk-gurobi,block-composition,upc,ncd,ml:SGD-PATE,sub25100,nopa,Unlocking,0.2,MLPateGaussianMechanism,{'Optimal': 40},8922612,681243,64896,0,20800,23504,8922612,660443,41392,3245,3345,3408,0,198,1469,3245,3147,1939,upc-block-composition
1870,sp_workloads,1690805680,wl_small_mem,1275,ml:SGD-PATE-sub25100-defpa,4,dpk-gurobi,block-composition,upc,ncd,ml:SGD-PATE,sub25100,nopa,Unlocking,0.4,MLNoisySGDMechanism,{'Optimal': 40},9753693,680301,63744,368199,39554,25104,9385494,640747,38640,3443,3381,3350,177,348,1560,3266,3033,1790,upc-block-composition
1871,sp_workloads,1690805680,wl_small_mem,1275,ml:SGD-PATE-sub25100-defpa,4,dpk-gurobi,block-composition,upc,ncd,ml:SGD-PATE,sub25100,nopa,Unlocking,0.4,MLPateGaussianMechanism,{'Optimal': 40},8922612,681243,64896,4273,23312,22080,8918339,657931,42816,3245,3345,3408,2,231,1380,3243,3114,2028,upc-block-composition
1872,sp_workloads,1690805680,wl_small_mem,1276,ml:SGD-PATE-sub25100-defpa,4,dpk-gurobi,block-composition,poisson,equal-ncd,ml:SGD-PATE,sub25100,nopa,Unlocking,0.2,MLNoisySGDMechanism,{'Optimal': 40},3443,3381,3350,125,1435,3350,3318,1946,0,3443,3381,3350,125,1435,3350,3318,1946,0,poisson-block-composition
1873,sp_workloads,1690805680,wl_small_mem,1276,ml:SGD-PATE-sub25100-defpa,4,dpk-gurobi,block-composition,poisson,equal-ncd,ml:SGD-PATE,sub25100,nopa,Unlocking,0.2,MLPateGaussianMechanism,{'Optimal': 40},3245,3345,3408,0,1648,3408,3245,1697,0,3245,3345,3408,0,1648,3408,3245,1697,0,poisson-block-composition
1874,sp_workloads,1690805680,wl_small_mem,1277,ml:SGD-PATE-sub25100-defpa,4,dpk-gurobi,block-composition,poisson,equal-ncd,ml:SGD-PATE,sub25100,nopa,Unlocking,0.4,MLNoisySGDMechanism,{'Optimal': 40},3443,3381,3350,202,1029,3350,3241,2352,0,3443,3381,3350,202,1029,3350,3241,2352,0,poisson-block-composition
1875,sp_workloads,1690805680,wl_small_mem,1277,ml:SGD-PATE-sub25100-defpa,4,dpk-gurobi,block-composition,poisson,equal-ncd,ml:SGD-PATE,sub25100,nopa,Unlocking,0.4,MLPateGaussianMechanism,{'Optimal': 40},3245,3345,3408,0,1648,3267,3245,1697,141,3245,3345,3408,0,1648,3267,3245,1697,141,poisson-block-composition
1876,sp_workloads,1690805680,wl_small_mem,1278,ml:SGD-PATE-sub25100-defpa,4,dpk-gurobi,block-composition,upc,equal-ncd,ml:SGD-PATE,sub25100,nopa,Unlocking,0.2,MLNoisySGDMechanism,{'Optimal': 40},3443,3381,3350,0,969,3350,3443,2412,0,3443,3381,3350,0,969,3350,3443,2412,0,upc-block-composition
1877,sp_workloads,1690805680,wl_small_mem,1278,ml:SGD-PATE-sub25100-defpa,4,dpk-gurobi,block-composition,upc,equal-ncd,ml:SGD-PATE,sub25100,nopa,Unlocking,0.2,MLPateGaussianMechanism,{'Optimal': 40},3245,3345,3408,1,211,3408,3244,3134,0,3245,3345,3408,1,211,3408,3244,3134,0,upc-block-composition
1878,sp_workloads,1690805680,wl_small_mem,1279,ml:SGD-PATE-sub25100-defpa,4,dpk-gurobi,block-composition,upc,equal-ncd,ml:SGD-PATE,sub25100,nopa,Unlocking,0.4,MLNoisySGDMechanism,{'Optimal': 40},3443,3381,3350,0,854,3350,3443,2527,0,3443,3381,3350,0,854,3350,3443,2527,0,upc-block-composition
1879,sp_workloads,1690805680,wl_small_mem,1279,ml:SGD-PATE-sub25100-defpa,4,dpk-gurobi,block-composition,upc,equal-ncd,ml:SGD-PATE,sub25100,nopa,Unlocking,0.4,MLPateGaussianMechanism,{'Optimal': 40},3245,3345,3408,1,326,3408,3244,3019,0,3245,3345,3408,1,326,3408,3244,3019,0,upc-block-composition
1880,sp_workloads,1690805680,wl_small_mem,1280,mixed:GM-LM-RR-LSVT-SGD-PATE-sub25100-defpa,0,dpk-gurobi,block-composition,poisson,ncd,mixed:GM-LM-RR-LSVT-SGD-PATE,sub25100,nopa,Unlocking,0.2,GaussianMechanism,{'Optimal': 40},3326864,216518,19768,393650,22228,8280,2933214,194290,11488,1098,1121,1112,188,171,552,910,950,560,poisson-block-composition
1881,sp_workloads,1690805680,wl_small_mem,1280,mixed:GM-LM-RR-LSVT-SGD-PATE-sub25100-defpa,0,dpk-gurobi,block-composition,poisson,ncd,mixed:GM-LM-RR-LSVT-SGD-PATE,sub25100,nopa,Unlocking,0.2,LaplaceMechanism,{'Optimal': 40},3160262,214484,19740,0,0,8310,3160262,214484,11430,1133,1141,1092,0,0,554,1133,1141,538,poisson-block-composition
1882,sp_workloads,1690805680,wl_small_mem,1280,mixed:GM-LM-RR-LSVT-SGD-PATE-sub25100-defpa,0,dpk-gurobi,block-composition,poisson,ncd,mixed:GM-LM-RR-LSVT-SGD-PATE,sub25100,nopa,Unlocking,0.2,MLNoisySGDMechanism,{'Optimal': 40},3049683,202901,20644,517996,14465,8767,2531687,188436,11877,1124,1132,1148,262,105,577,862,1027,571,poisson-block-composition
1883,sp_workloads,1690805680,wl_small_mem,1280,mixed:GM-LM-RR-LSVT-SGD-PATE-sub25100-defpa,0,dpk-gurobi,block-composition,poisson,ncd,mixed:GM-LM-RR-LSVT-SGD-PATE,sub25100,nopa,Unlocking,0.2,MLPateGaussianMechanism,{'Optimal': 40},3104776,219595,19804,373745,27849,8520,2731031,191746,11284,1159,1162,1108,183,210,568,976,952,540,poisson-block-composition
1884,sp_workloads,1690805680,wl_small_mem,1280,mixed:GM-LM-RR-LSVT-SGD-PATE-sub25100-defpa,0,dpk-gurobi,block-composition,poisson,ncd,mixed:GM-LM-RR-LSVT-SGD-PATE,sub25100,nopa,Unlocking,0.2,RandResponseMechanism,{'Optimal': 40},3027994,204361,19932,0,0,8880,3027994,204361,11052,1129,1138,1140,0,0,592,1129,1138,548,poisson-block-composition
1885,sp_workloads,1690805680,wl_small_mem,1280,mixed:GM-LM-RR-LSVT-SGD-PATE-sub25100-defpa,0,dpk-gurobi,block-composition,poisson,ncd,mixed:GM-LM-RR-LSVT-SGD-PATE,sub25100,nopa,Unlocking,0.2,SVTLaplaceMechanism,{'Optimal': 40},3254745,215442,20539,0,0,7305,3254745,215442,13234,1155,1111,1125,0,0,487,1155,1111,638,poisson-block-composition
1886,sp_workloads,1690805680,wl_small_mem,1281,mixed:GM-LM-RR-LSVT-SGD-PATE-sub25100-defpa,0,dpk-gurobi,block-composition,poisson,ncd,mixed:GM-LM-RR-LSVT-SGD-PATE,sub25100,nopa,Unlocking,0.4,GaussianMechanism,{'Optimal': 40},3326864,216518,19768,367773,23881,8280,2959091,192637,11488,1098,1121,1112,181,196,552,917,925,560,poisson-block-composition
1887,sp_workloads,1690805680,wl_small_mem,1281,mixed:GM-LM-RR-LSVT-SGD-PATE-sub25100-defpa,0,dpk-gurobi,block-composition,poisson,ncd,mixed:GM-LM-RR-LSVT-SGD-PATE,sub25100,nopa,Unlocking,0.4,LaplaceMechanism,{'Optimal': 40},3160262,214484,19740,4386,0,8341,3155876,214484,11399,1133,1141,1092,2,0,555,1131,1141,537,poisson-block-composition
1888,sp_workloads,1690805680,wl_small_mem,1281,mixed:GM-LM-RR-LSVT-SGD-PATE-sub25100-defpa,0,dpk-gurobi,block-composition,poisson,ncd,mixed:GM-LM-RR-LSVT-SGD-PATE,sub25100,nopa,Unlocking,0.4,MLNoisySGDMechanism,{'Optimal': 40},3049683,202901,20644,528206,17291,9077,2521477,185610,11567,1124,1132,1148,277,139,587,847,993,561,poisson-block-composition
1889,sp_workloads,1690805680,wl_small_mem,1281,mixed:GM-LM-RR-LSVT-SGD-PATE-sub25100-defpa,0,dpk-gurobi,block-composition,poisson,ncd,mixed:GM-LM-RR-LSVT-SGD-PATE,sub25100,nopa,Unlocking,0.4,MLPateGaussianMechanism,{'Optimal': 40},3104776,219595,19804,352613,28800,8520,2752163,190795,11284,1159,1162,1108,179,226,568,980,936,540,poisson-block-composition
1890,sp_workloads,1690805680,wl_small_mem,1281,mixed:GM-LM-RR-LSVT-SGD-PATE-sub25100-defpa,0,dpk-gurobi,block-composition,poisson,ncd,mixed:GM-LM-RR-LSVT-SGD-PATE,sub25100,nopa,Unlocking,0.4,RandResponseMechanism,{'Optimal': 40},3027994,204361,19932,0,0,8925,3027994,204361,11007,1129,1138,1140,0,0,595,1129,1138,545,poisson-block-composition
1891,sp_workloads,1690805680,wl_small_mem,1281,mixed:GM-LM-RR-LSVT-SGD-PATE-sub25100-defpa,0,dpk-gurobi,block-composition,poisson,ncd,mixed:GM-LM-RR-LSVT-SGD-PATE,sub25100,nopa,Unlocking,0.4,SVTLaplaceMechanism,{'Optimal': 40},3254745,215442,20539,0,0,7110,3254745,215442,13429,1155,1111,1125,0,0,474,1155,1111,651,poisson-block-composition
1892,sp_workloads,1690805680,wl_small_mem,1282,mixed:GM-LM-RR-LSVT-SGD-PATE-sub25100-defpa,0,dpk-gurobi,block-composition,upc,ncd,mixed:GM-LM-RR-LSVT-SGD-PATE,sub25100,nopa,Unlocking,0.2,GaussianMechanism,{'Optimal': 40},2981730,214916,19928,0,13335,7695,2981730,201581,12233,1098,1121,1112,0,137,513,1098,984,599,upc-block-composition
1893,sp_workloads,1690805680,wl_small_mem,1282,mixed:GM-LM-RR-LSVT-SGD-PATE-sub25100-defpa,0,dpk-gurobi,block-composition,upc,ncd,mixed:GM-LM-RR-LSVT-SGD-PATE,sub25100,nopa,Unlocking,0.2,LaplaceMechanism,{'Optimal': 40},3131295,232349,19708,0,1394,8238,3131295,230955,11470,1133,1141,1092,0,14,546,1133,1127,546,upc-block-composition
1894,sp_workloads,1690805680,wl_small_mem,1282,mixed:GM-LM-RR-LSVT-SGD-PATE-sub25100-defpa,0,dpk-gurobi,block-composition,upc,ncd,mixed:GM-LM-RR-LSVT-SGD-PATE,sub25100,nopa,Unlocking,0.2,MLNoisySGDMechanism,{'Optimal': 40},3118726,223010,20660,304035,24335,9790,2814691,198675,10870,1124,1132,1148,111,183,610,1013,949,538,upc-block-composition
1895,sp_workloads,1690805680,wl_small_mem,1282,mixed:GM-LM-RR-LSVT-SGD-PATE-sub25100-defpa,0,dpk-gurobi,block-composition,upc,ncd,mixed:GM-LM-RR-LSVT-SGD-PATE,sub25100,nopa,Unlocking,0.2,MLPateGaussianMechanism,{'Optimal': 40},3293821,219087,19708,1993,14280,7950,3291828,204807,11758,1159,1162,1108,1,152,530,1158,1010,578,upc-block-composition
1896,sp_workloads,1690805680,wl_small_mem,1282,mixed:GM-LM-RR-LSVT-SGD-PATE-sub25100-defpa,0,dpk-gurobi,block-composition,upc,ncd,mixed:GM-LM-RR-LSVT-SGD-PATE,sub25100,nopa,Unlocking,0.2,RandResponseMechanism,{'Optimal': 40},3089004,211671,20540,0,1331,8640,3089004,210340,11900,1129,1138,1140,0,13,576,1129,1125,564,upc-block-composition
1897,sp_workloads,1690805680,wl_small_mem,1282,mixed:GM-LM-RR-LSVT-SGD-PATE-sub25100-defpa,0,dpk-gurobi,block-composition,upc,ncd,mixed:GM-LM-RR-LSVT-SGD-PATE,sub25100,nopa,Unlocking,0.2,SVTLaplaceMechanism,{'Optimal': 40},3249651,226516,20283,0,808,7740,3249651,225708,12543,1155,1111,1125,0,8,516,1155,1103,609,upc-block-composition
1898,sp_workloads,1690805680,wl_small_mem,1283,mixed:GM-LM-RR-LSVT-SGD-PATE-sub25100-defpa,0,dpk-gurobi,block-composition,upc,ncd,mixed:GM-LM-RR-LSVT-SGD-PATE,sub25100,nopa,Unlocking,0.4,GaussianMechanism,{'Optimal': 40},2981730,214916,19928,2200,14450,7170,2979530,200466,12758,1098,1121,1112,1,142,478,1097,979,634,upc-block-composition
1899,sp_workloads,1690805680,wl_small_mem,1283,mixed:GM-LM-RR-LSVT-SGD-PATE-sub25100-defpa,0,dpk-gurobi,block-composition,upc,ncd,mixed:GM-LM-RR-LSVT-SGD-PATE,sub25100,nopa,Unlocking,0.4,LaplaceMechanism,{'Optimal': 40},3131295,232349,19708,0,1221,7786,3131295,231128,11922,1133,1141,1092,0,11,518,1133,1130,574,upc-block-composition
1900,sp_workloads,1690805680,wl_small_mem,1283,mixed:GM-LM-RR-LSVT-SGD-PATE-sub25100-defpa,0,dpk-gurobi,block-composition,upc,ncd,mixed:GM-LM-RR-LSVT-SGD-PATE,sub25100,nopa,Unlocking,0.4,MLNoisySGDMechanism,{'Optimal': 40},3118726,223010,20660,307433,34449,9376,2811293,188561,11284,1124,1132,1148,102,217,592,1022,915,556,upc-block-composition
1901,sp_workloads,1690805680,wl_small_mem,1283,mixed:GM-LM-RR-LSVT-SGD-PATE-sub25100-defpa,0,dpk-gurobi,block-composition,upc,ncd,mixed:GM-LM-RR-LSVT-SGD-PATE,sub25100,nopa,Unlocking,0.4,MLPateGaussianMechanism,{'Optimal': 40},3293821,219087,19708,4400,11481,7440,3289421,207606,12268,1159,1162,1108,2,135,496,1157,1027,612,upc-block-composition
1902,sp_workloads,1690805680,wl_small_mem,1283,mixed:GM-LM-RR-LSVT-SGD-PATE-sub25100-defpa,0,dpk-gurobi,block-composition,upc,ncd,mixed:GM-LM-RR-LSVT-SGD-PATE,sub25100,nopa,Unlocking,0.4,RandResponseMechanism,{'Optimal': 40},3089004,211671,20540,2232,1886,8430,3086772,209785,12110,1129,1138,1140,1,18,562,1128,1120,578,upc-block-composition
1903,sp_workloads,1690805680,wl_small_mem,1283,mixed:GM-LM-RR-LSVT-SGD-PATE-sub25100-defpa,0,dpk-gurobi,block-composition,upc,ncd,mixed:GM-LM-RR-LSVT-SGD-PATE,sub25100,nopa,Unlocking,0.4,SVTLaplaceMechanism,{'Optimal': 40},3249651,226516,20283,2200,968,7260,3247451,225548,13023,1155,1111,1125,1,8,484,1154,1103,641,upc-block-composition
1904,sp_workloads,1690805680,wl_small_mem,1284,mixed:GM-LM-RR-LSVT-SGD-PATE-sub25100-defpa,0,dpk-gurobi,block-composition,poisson,equal-ncd,mixed:GM-LM-RR-LSVT-SGD-PATE,sub25100,nopa,Unlocking,0.2,GaussianMechanism,{'Optimal': 40},1098,1121,1112,0,577,1112,1098,544,0,1098,1121,1112,0,577,1112,1098,544,0,poisson-block-composition
1905,sp_workloads,1690805680,wl_small_mem,1284,mixed:GM-LM-RR-LSVT-SGD-PATE-sub25100-defpa,0,dpk-gurobi,block-composition,poisson,equal-ncd,mixed:GM-LM-RR-LSVT-SGD-PATE,sub25100,nopa,Unlocking,0.2,LaplaceMechanism,{'Optimal': 40},1133,1141,1092,0,378,1092,1133,763,0,1133,1141,1092,0,378,1092,1133,763,0,poisson-block-composition
1906,sp_workloads,1690805680,wl_small_mem,1284,mixed:GM-LM-RR-LSVT-SGD-PATE-sub25100-defpa,0,dpk-gurobi,block-composition,poisson,equal-ncd,mixed:GM-LM-RR-LSVT-SGD-PATE,sub25100,nopa,Unlocking,0.2,MLNoisySGDMechanism,{'Optimal': 40},1124,1132,1148,0,591,1148,1124,541,0,1124,1132,1148,0,591,1148,1124,541,0,poisson-block-composition
1907,sp_workloads,1690805680,wl_small_mem,1284,mixed:GM-LM-RR-LSVT-SGD-PATE-sub25100-defpa,0,dpk-gurobi,block-composition,poisson,equal-ncd,mixed:GM-LM-RR-LSVT-SGD-PATE,sub25100,nopa,Unlocking,0.2,MLPateGaussianMechanism,{'Optimal': 40},1159,1162,1108,0,604,1108,1159,558,0,1159,1162,1108,0,604,1108,1159,558,0,poisson-block-composition
1908,sp_workloads,1690805680,wl_small_mem,1284,mixed:GM-LM-RR-LSVT-SGD-PATE-sub25100-defpa,0,dpk-gurobi,block-composition,poisson,equal-ncd,mixed:GM-LM-RR-LSVT-SGD-PATE,sub25100,nopa,Unlocking,0.2,RandResponseMechanism,{'Optimal': 40},1129,1138,1140,0,0,1140,1129,1138,0,1129,1138,1140,0,0,1140,1129,1138,0,poisson-block-composition
1909,sp_workloads,1690805680,wl_small_mem,1284,mixed:GM-LM-RR-LSVT-SGD-PATE-sub25100-defpa,0,dpk-gurobi,block-composition,poisson,equal-ncd,mixed:GM-LM-RR-LSVT-SGD-PATE,sub25100,nopa,Unlocking,0.2,SVTLaplaceMechanism,{'Optimal': 40},1155,1111,1125,0,49,1125,1155,1062,0,1155,1111,1125,0,49,1125,1155,1062,0,poisson-block-composition
1910,sp_workloads,1690805680,wl_small_mem,1285,mixed:GM-LM-RR-LSVT-SGD-PATE-sub25100-defpa,0,dpk-gurobi,block-composition,poisson,equal-ncd,mixed:GM-LM-RR-LSVT-SGD-PATE,sub25100,nopa,Unlocking,0.4,GaussianMechanism,{'Optimal': 40},1098,1121,1112,0,577,1108,1098,544,4,1098,1121,1112,0,577,1108,1098,544,4,poisson-block-composition
1911,sp_workloads,1690805680,wl_small_mem,1285,mixed:GM-LM-RR-LSVT-SGD-PATE-sub25100-defpa,0,dpk-gurobi,block-composition,poisson,equal-ncd,mixed:GM-LM-RR-LSVT-SGD-PATE,sub25100,nopa,Unlocking,0.4,LaplaceMechanism,{'Optimal': 40},1133,1141,1092,0,309,1092,1133,832,0,1133,1141,1092,0,309,1092,1133,832,0,poisson-block-composition
1912,sp_workloads,1690805680,wl_small_mem,1285,mixed:GM-LM-RR-LSVT-SGD-PATE-sub25100-defpa,0,dpk-gurobi,block-composition,poisson,equal-ncd,mixed:GM-LM-RR-LSVT-SGD-PATE,sub25100,nopa,Unlocking,0.4,MLNoisySGDMechanism,{'Optimal': 40},1124,1132,1148,0,415,1148,1124,717,0,1124,1132,1148,0,415,1148,1124,717,0,poisson-block-composition
1913,sp_workloads,1690805680,wl_small_mem,1285,mixed:GM-LM-RR-LSVT-SGD-PATE-sub25100-defpa,0,dpk-gurobi,block-composition,poisson,equal-ncd,mixed:GM-LM-RR-LSVT-SGD-PATE,sub25100,nopa,Unlocking,0.4,MLPateGaussianMechanism,{'Optimal': 40},1159,1162,1108,0,604,1069,1159,558,39,1159,1162,1108,0,604,1069,1159,558,39,poisson-block-composition
1914,sp_workloads,1690805680,wl_small_mem,1285,mixed:GM-LM-RR-LSVT-SGD-PATE-sub25100-defpa,0,dpk-gurobi,block-composition,poisson,equal-ncd,mixed:GM-LM-RR-LSVT-SGD-PATE,sub25100,nopa,Unlocking,0.4,RandResponseMechanism,{'Optimal': 40},1129,1138,1140,0,0,1140,1129,1138,0,1129,1138,1140,0,0,1140,1129,1138,0,poisson-block-composition
1915,sp_workloads,1690805680,wl_small_mem,1285,mixed:GM-LM-RR-LSVT-SGD-PATE-sub25100-defpa,0,dpk-gurobi,block-composition,poisson,equal-ncd,mixed:GM-LM-RR-LSVT-SGD-PATE,sub25100,nopa,Unlocking,0.4,SVTLaplaceMechanism,{'Optimal': 40},1155,1111,1125,0,140,1125,1155,971,0,1155,1111,1125,0,140,1125,1155,971,0,poisson-block-composition
1916,sp_workloads,1690805680,wl_small_mem,1286,mixed:GM-LM-RR-LSVT-SGD-PATE-sub25100-defpa,0,dpk-gurobi,block-composition,upc,equal-ncd,mixed:GM-LM-RR-LSVT-SGD-PATE,sub25100,nopa,Unlocking,0.2,GaussianMechanism,{'Optimal': 40},1098,1121,1112,0,256,1112,1098,865,0,1098,1121,1112,0,256,1112,1098,865,0,upc-block-composition
1917,sp_workloads,1690805680,wl_small_mem,1286,mixed:GM-LM-RR-LSVT-SGD-PATE-sub25100-defpa,0,dpk-gurobi,block-composition,upc,equal-ncd,mixed:GM-LM-RR-LSVT-SGD-PATE,sub25100,nopa,Unlocking,0.2,LaplaceMechanism,{'Optimal': 40},1133,1141,1092,0,0,1092,1133,1141,0,1133,1141,1092,0,0,1092,1133,1141,0,upc-block-composition
1918,sp_workloads,1690805680,wl_small_mem,1286,mixed:GM-LM-RR-LSVT-SGD-PATE-sub25100-defpa,0,dpk-gurobi,block-composition,upc,equal-ncd,mixed:GM-LM-RR-LSVT-SGD-PATE,sub25100,nopa,Unlocking,0.2,MLNoisySGDMechanism,{'Optimal': 40},1124,1132,1148,1,540,1148,1123,592,0,1124,1132,1148,1,540,1148,1123,592,0,upc-block-composition
1919,sp_workloads,1690805680,wl_small_mem,1286,mixed:GM-LM-RR-LSVT-SGD-PATE-sub25100-defpa,0,dpk-gurobi,block-composition,upc,equal-ncd,mixed:GM-LM-RR-LSVT-SGD-PATE,sub25100,nopa,Unlocking,0.2,MLPateGaussianMechanism,{'Optimal': 40},1159,1162,1108,0,248,1108,1159,914,0,1159,1162,1108,0,248,1108,1159,914,0,upc-block-composition
1920,sp_workloads,1690805680,wl_small_mem,1286,mixed:GM-LM-RR-LSVT-SGD-PATE-sub25100-defpa,0,dpk-gurobi,block-composition,upc,equal-ncd,mixed:GM-LM-RR-LSVT-SGD-PATE,sub25100,nopa,Unlocking,0.2,RandResponseMechanism,{'Optimal': 40},1129,1138,1140,0,2,1140,1129,1136,0,1129,1138,1140,0,2,1140,1129,1136,0,upc-block-composition
1921,sp_workloads,1690805680,wl_small_mem,1286,mixed:GM-LM-RR-LSVT-SGD-PATE-sub25100-defpa,0,dpk-gurobi,block-composition,upc,equal-ncd,mixed:GM-LM-RR-LSVT-SGD-PATE,sub25100,nopa,Unlocking,0.2,SVTLaplaceMechanism,{'Optimal': 40},1155,1111,1125,0,2,1125,1155,1109,0,1155,1111,1125,0,2,1125,1155,1109,0,upc-block-composition
1922,sp_workloads,1690805680,wl_small_mem,1287,mixed:GM-LM-RR-LSVT-SGD-PATE-sub25100-defpa,0,dpk-gurobi,block-composition,upc,equal-ncd,mixed:GM-LM-RR-LSVT-SGD-PATE,sub25100,nopa,Unlocking,0.4,GaussianMechanism,{'Optimal': 40},1098,1121,1112,0,232,1112,1098,889,0,1098,1121,1112,0,232,1112,1098,889,0,upc-block-composition
1923,sp_workloads,1690805680,wl_small_mem,1287,mixed:GM-LM-RR-LSVT-SGD-PATE-sub25100-defpa,0,dpk-gurobi,block-composition,upc,equal-ncd,mixed:GM-LM-RR-LSVT-SGD-PATE,sub25100,nopa,Unlocking,0.4,LaplaceMechanism,{'Optimal': 40},1133,1141,1092,0,19,1092,1133,1122,0,1133,1141,1092,0,19,1092,1133,1122,0,upc-block-composition
1924,sp_workloads,1690805680,wl_small_mem,1287,mixed:GM-LM-RR-LSVT-SGD-PATE-sub25100-defpa,0,dpk-gurobi,block-composition,upc,equal-ncd,mixed:GM-LM-RR-LSVT-SGD-PATE,sub25100,nopa,Unlocking,0.4,MLNoisySGDMechanism,{'Optimal': 40},1124,1132,1148,1,370,1148,1123,762,0,1124,1132,1148,1,370,1148,1123,762,0,upc-block-composition
1925,sp_workloads,1690805680,wl_small_mem,1287,mixed:GM-LM-RR-LSVT-SGD-PATE-sub25100-defpa,0,dpk-gurobi,block-composition,upc,equal-ncd,mixed:GM-LM-RR-LSVT-SGD-PATE,sub25100,nopa,Unlocking,0.4,MLPateGaussianMechanism,{'Optimal': 40},1159,1162,1108,0,243,1103,1159,919,5,1159,1162,1108,0,243,1103,1159,919,5,upc-block-composition
1926,sp_workloads,1690805680,wl_small_mem,1287,mixed:GM-LM-RR-LSVT-SGD-PATE-sub25100-defpa,0,dpk-gurobi,block-composition,upc,equal-ncd,mixed:GM-LM-RR-LSVT-SGD-PATE,sub25100,nopa,Unlocking,0.4,RandResponseMechanism,{'Optimal': 40},1129,1138,1140,0,15,1140,1129,1123,0,1129,1138,1140,0,15,1140,1129,1123,0,upc-block-composition
1927,sp_workloads,1690805680,wl_small_mem,1287,mixed:GM-LM-RR-LSVT-SGD-PATE-sub25100-defpa,0,dpk-gurobi,block-composition,upc,equal-ncd,mixed:GM-LM-RR-LSVT-SGD-PATE,sub25100,nopa,Unlocking,0.4,SVTLaplaceMechanism,{'Optimal': 40},1155,1111,1125,0,10,1125,1155,1101,0,1155,1111,1125,0,10,1125,1155,1101,0,upc-block-composition
1928,sp_workloads,1690805680,wl_small_mem,1288,mixed:GM-LM-RR-LSVT-SGD-PATE-sub25100-defpa,1,dpk-gurobi,block-composition,poisson,ncd,mixed:GM-LM-RR-LSVT-SGD-PATE,sub25100,nopa,Unlocking,0.2,GaussianMechanism,{'Optimal': 40},3139319,215782,21216,381761,27036,9200,2757558,188746,12016,1075,1140,1126,177,202,575,898,938,551,poisson-block-composition
1929,sp_workloads,1690805680,wl_small_mem,1288,mixed:GM-LM-RR-LSVT-SGD-PATE-sub25100-defpa,1,dpk-gurobi,block-composition,poisson,ncd,mixed:GM-LM-RR-LSVT-SGD-PATE,sub25100,nopa,Unlocking,0.2,LaplaceMechanism,{'Optimal': 40},3080200,239601,21344,4564,0,9200,3075636,239601,12144,1140,1163,1130,2,0,574,1138,1163,556,poisson-block-composition
1930,sp_workloads,1690805680,wl_small_mem,1288,mixed:GM-LM-RR-LSVT-SGD-PATE-sub25100-defpa,1,dpk-gurobi,block-composition,poisson,ncd,mixed:GM-LM-RR-LSVT-SGD-PATE,sub25100,nopa,Unlocking,0.2,MLNoisySGDMechanism,{'Optimal': 40},3197047,217314,22128,539128,8615,9600,2657919,208699,12528,1145,1089,1161,260,61,587,885,1028,574,poisson-block-composition
1931,sp_workloads,1690805680,wl_small_mem,1288,mixed:GM-LM-RR-LSVT-SGD-PATE-sub25100-defpa,1,dpk-gurobi,block-composition,poisson,ncd,mixed:GM-LM-RR-LSVT-SGD-PATE,sub25100,nopa,Unlocking,0.2,MLPateGaussianMechanism,{'Optimal': 40},3203621,231498,21632,408118,31049,9136,2795503,200449,12496,1163,1144,1138,190,230,571,973,914,567,poisson-block-composition
1932,sp_workloads,1690805680,wl_small_mem,1288,mixed:GM-LM-RR-LSVT-SGD-PATE-sub25100-defpa,1,dpk-gurobi,block-composition,poisson,ncd,mixed:GM-LM-RR-LSVT-SGD-PATE,sub25100,nopa,Unlocking,0.2,RandResponseMechanism,{'Optimal': 40},3122577,243521,22560,0,0,8720,3122577,243521,13840,1093,1164,1181,0,0,545,1093,1164,636,poisson-block-composition
1933,sp_workloads,1690805680,wl_small_mem,1288,mixed:GM-LM-RR-LSVT-SGD-PATE-sub25100-defpa,1,dpk-gurobi,block-composition,poisson,ncd,mixed:GM-LM-RR-LSVT-SGD-PATE,sub25100,nopa,Unlocking,0.2,SVTLaplaceMechanism,{'Optimal': 40},3189411,227364,20784,0,0,8256,3189411,227364,12528,1178,1127,1089,0,0,516,1178,1127,573,poisson-block-composition
1934,sp_workloads,1690805680,wl_small_mem,1289,mixed:GM-LM-RR-LSVT-SGD-PATE-sub25100-defpa,1,dpk-gurobi,block-composition,poisson,ncd,mixed:GM-LM-RR-LSVT-SGD-PATE,sub25100,nopa,Unlocking,0.4,GaussianMechanism,{'Optimal': 40},3139319,215782,21216,336950,27070,9200,2802369,188712,12016,1075,1140,1126,159,201,575,916,939,551,poisson-block-composition
1935,sp_workloads,1690805680,wl_small_mem,1289,mixed:GM-LM-RR-LSVT-SGD-PATE-sub25100-defpa,1,dpk-gurobi,block-composition,poisson,ncd,mixed:GM-LM-RR-LSVT-SGD-PATE,sub25100,nopa,Unlocking,0.4,LaplaceMechanism,{'Optimal': 40},3080200,239601,21344,13464,0,9168,3066736,239601,12176,1140,1163,1130,6,0,573,1134,1163,557,poisson-block-composition
1936,sp_workloads,1690805680,wl_small_mem,1289,mixed:GM-LM-RR-LSVT-SGD-PATE-sub25100-defpa,1,dpk-gurobi,block-composition,poisson,ncd,mixed:GM-LM-RR-LSVT-SGD-PATE,sub25100,nopa,Unlocking,0.4,MLNoisySGDMechanism,{'Optimal': 40},3197047,217314,22128,551610,13061,9536,2645437,204253,12592,1145,1089,1161,265,95,585,880,994,576,poisson-block-composition
1937,sp_workloads,1690805680,wl_small_mem,1289,mixed:GM-LM-RR-LSVT-SGD-PATE-sub25100-defpa,1,dpk-gurobi,block-composition,poisson,ncd,mixed:GM-LM-RR-LSVT-SGD-PATE,sub25100,nopa,Unlocking,0.4,MLPateGaussianMechanism,{'Optimal': 40},3203621,231498,21632,407401,32464,9136,2796220,199034,12496,1163,1144,1138,195,243,571,968,901,567,poisson-block-composition
1938,sp_workloads,1690805680,wl_small_mem,1289,mixed:GM-LM-RR-LSVT-SGD-PATE-sub25100-defpa,1,dpk-gurobi,block-composition,poisson,ncd,mixed:GM-LM-RR-LSVT-SGD-PATE,sub25100,nopa,Unlocking,0.4,RandResponseMechanism,{'Optimal': 40},3122577,243521,22560,0,0,8832,3122577,243521,13728,1093,1164,1181,0,0,552,1093,1164,629,poisson-block-composition
1939,sp_workloads,1690805680,wl_small_mem,1289,mixed:GM-LM-RR-LSVT-SGD-PATE-sub25100-defpa,1,dpk-gurobi,block-composition,poisson,ncd,mixed:GM-LM-RR-LSVT-SGD-PATE,sub25100,nopa,Unlocking,0.4,SVTLaplaceMechanism,{'Optimal': 40},3189411,227364,20784,0,0,8720,3189411,227364,12064,1178,1127,1089,0,0,545,1178,1127,544,poisson-block-composition
1940,sp_workloads,1690805680,wl_small_mem,1290,mixed:GM-LM-RR-LSVT-SGD-PATE-sub25100-defpa,1,dpk-gurobi,block-composition,upc,ncd,mixed:GM-LM-RR-LSVT-SGD-PATE,sub25100,nopa,Unlocking,0.2,GaussianMechanism,{'Optimal': 40},3132487,230731,21232,0,12447,8528,3132487,218284,12704,1075,1140,1126,0,134,533,1075,1006,593,upc-block-composition
1941,sp_workloads,1690805680,wl_small_mem,1290,mixed:GM-LM-RR-LSVT-SGD-PATE-sub25100-defpa,1,dpk-gurobi,block-composition,upc,ncd,mixed:GM-LM-RR-LSVT-SGD-PATE,sub25100,nopa,Unlocking,0.2,LaplaceMechanism,{'Optimal': 40},3099847,241488,21408,0,1289,9040,3099847,240199,12368,1140,1163,1130,0,11,560,1140,1152,570,upc-block-composition
1942,sp_workloads,1690805680,wl_small_mem,1290,mixed:GM-LM-RR-LSVT-SGD-PATE-sub25100-defpa,1,dpk-gurobi,block-composition,upc,ncd,mixed:GM-LM-RR-LSVT-SGD-PATE,sub25100,nopa,Unlocking,0.2,MLNoisySGDMechanism,{'Optimal': 40},3154870,213434,22336,337383,23973,10768,2817487,189461,11568,1145,1089,1161,115,166,620,1030,923,541,upc-block-composition
1943,sp_workloads,1690805680,wl_small_mem,1290,mixed:GM-LM-RR-LSVT-SGD-PATE-sub25100-defpa,1,dpk-gurobi,block-composition,upc,ncd,mixed:GM-LM-RR-LSVT-SGD-PATE,sub25100,nopa,Unlocking,0.2,MLPateGaussianMechanism,{'Optimal': 40},3325335,225275,21360,1488,11918,8448,3323847,213357,12912,1163,1144,1138,1,119,528,1162,1025,610,upc-block-composition
1944,sp_workloads,1690805680,wl_small_mem,1290,mixed:GM-LM-RR-LSVT-SGD-PATE-sub25100-defpa,1,dpk-gurobi,block-composition,upc,ncd,mixed:GM-LM-RR-LSVT-SGD-PATE,sub25100,nopa,Unlocking,0.2,RandResponseMechanism,{'Optimal': 40},2890868,228789,22304,0,917,8384,2890868,227872,13920,1093,1164,1181,0,10,523,1093,1154,658,upc-block-composition
1945,sp_workloads,1690805680,wl_small_mem,1290,mixed:GM-LM-RR-LSVT-SGD-PATE-sub25100-defpa,1,dpk-gurobi,block-composition,upc,ncd,mixed:GM-LM-RR-LSVT-SGD-PATE,sub25100,nopa,Unlocking,0.2,SVTLaplaceMechanism,{'Optimal': 40},3335945,229922,20624,0,805,8384,3335945,229117,12240,1178,1127,1089,0,6,524,1178,1121,565,upc-block-composition
1946,sp_workloads,1690805680,wl_small_mem,1291,mixed:GM-LM-RR-LSVT-SGD-PATE-sub25100-defpa,1,dpk-gurobi,block-composition,upc,ncd,mixed:GM-LM-RR-LSVT-SGD-PATE,sub25100,nopa,Unlocking,0.4,GaussianMechanism,{'Optimal': 40},3132487,230731,21232,2103,17520,8000,3130384,213211,13232,1075,1140,1126,1,172,500,1074,968,626,upc-block-composition
1947,sp_workloads,1690805680,wl_small_mem,1291,mixed:GM-LM-RR-LSVT-SGD-PATE-sub25100-defpa,1,dpk-gurobi,block-composition,upc,ncd,mixed:GM-LM-RR-LSVT-SGD-PATE,sub25100,nopa,Unlocking,0.4,LaplaceMechanism,{'Optimal': 40},3099847,241488,21408,0,1853,8800,3099847,239635,12608,1140,1163,1130,0,15,541,1140,1148,589,upc-block-composition
1948,sp_workloads,1690805680,wl_small_mem,1291,mixed:GM-LM-RR-LSVT-SGD-PATE-sub25100-defpa,1,dpk-gurobi,block-composition,upc,ncd,mixed:GM-LM-RR-LSVT-SGD-PATE,sub25100,nopa,Unlocking,0.4,MLNoisySGDMechanism,{'Optimal': 40},3154870,213434,22336,295244,24848,9872,2859626,188586,12464,1145,1089,1161,116,201,588,1029,888,573,upc-block-composition
1949,sp_workloads,1690805680,wl_small_mem,1291,mixed:GM-LM-RR-LSVT-SGD-PATE-sub25100-defpa,1,dpk-gurobi,block-composition,upc,ncd,mixed:GM-LM-RR-LSVT-SGD-PATE,sub25100,nopa,Unlocking,0.4,MLPateGaussianMechanism,{'Optimal': 40},3325335,225275,21360,0,17912,7968,3325335,207363,13392,1163,1144,1138,0,175,498,1163,969,640,upc-block-composition
1950,sp_workloads,1690805680,wl_small_mem,1291,mixed:GM-LM-RR-LSVT-SGD-PATE-sub25100-defpa,1,dpk-gurobi,block-composition,upc,ncd,mixed:GM-LM-RR-LSVT-SGD-PATE,sub25100,nopa,Unlocking,0.4,RandResponseMechanism,{'Optimal': 40},2890868,228789,22304,2248,1192,8288,2888620,227597,14016,1093,1164,1181,1,12,515,1092,1152,666,upc-block-composition
1951,sp_workloads,1690805680,wl_small_mem,1291,mixed:GM-LM-RR-LSVT-SGD-PATE-sub25100-defpa,1,dpk-gurobi,block-composition,upc,ncd,mixed:GM-LM-RR-LSVT-SGD-PATE,sub25100,nopa,Unlocking,0.4,SVTLaplaceMechanism,{'Optimal': 40},3335945,229922,20624,16,2062,8032,3335929,227860,12592,1178,1127,1089,1,18,500,1177,1109,589,upc-block-composition
1952,sp_workloads,1690805680,wl_small_mem,1292,mixed:GM-LM-RR-LSVT-SGD-PATE-sub25100-defpa,1,dpk-gurobi,block-composition,poisson,equal-ncd,mixed:GM-LM-RR-LSVT-SGD-PATE,sub25100,nopa,Unlocking,0.2,GaussianMechanism,{'Optimal': 40},1075,1140,1126,0,598,1126,1075,542,0,1075,1140,1126,0,598,1126,1075,542,0,poisson-block-composition
1953,sp_workloads,1690805680,wl_small_mem,1292,mixed:GM-LM-RR-LSVT-SGD-PATE-sub25100-defpa,1,dpk-gurobi,block-composition,poisson,equal-ncd,mixed:GM-LM-RR-LSVT-SGD-PATE,sub25100,nopa,Unlocking,0.2,LaplaceMechanism,{'Optimal': 40},1140,1163,1130,0,380,1130,1140,783,0,1140,1163,1130,0,380,1130,1140,783,0,poisson-block-composition
1954,sp_workloads,1690805680,wl_small_mem,1292,mixed:GM-LM-RR-LSVT-SGD-PATE-sub25100-defpa,1,dpk-gurobi,block-composition,poisson,equal-ncd,mixed:GM-LM-RR-LSVT-SGD-PATE,sub25100,nopa,Unlocking,0.2,MLNoisySGDMechanism,{'Optimal': 40},1145,1089,1161,0,553,1161,1145,536,0,1145,1089,1161,0,553,1161,1145,536,0,poisson-block-composition
1955,sp_workloads,1690805680,wl_small_mem,1292,mixed:GM-LM-RR-LSVT-SGD-PATE-sub25100-defpa,1,dpk-gurobi,block-composition,poisson,equal-ncd,mixed:GM-LM-RR-LSVT-SGD-PATE,sub25100,nopa,Unlocking,0.2,MLPateGaussianMechanism,{'Optimal': 40},1163,1144,1138,0,580,1138,1163,564,0,1163,1144,1138,0,580,1138,1163,564,0,poisson-block-composition
1956,sp_workloads,1690805680,wl_small_mem,1292,mixed:GM-LM-RR-LSVT-SGD-PATE-sub25100-defpa,1,dpk-gurobi,block-composition,poisson,equal-ncd,mixed:GM-LM-RR-LSVT-SGD-PATE,sub25100,nopa,Unlocking,0.2,RandResponseMechanism,{'Optimal': 40},1093,1164,1181,0,0,1181,1093,1164,0,1093,1164,1181,0,0,1181,1093,1164,0,poisson-block-composition
1957,sp_workloads,1690805680,wl_small_mem,1292,mixed:GM-LM-RR-LSVT-SGD-PATE-sub25100-defpa,1,dpk-gurobi,block-composition,poisson,equal-ncd,mixed:GM-LM-RR-LSVT-SGD-PATE,sub25100,nopa,Unlocking,0.2,SVTLaplaceMechanism,{'Optimal': 40},1178,1127,1089,0,45,1089,1178,1082,0,1178,1127,1089,0,45,1089,1178,1082,0,poisson-block-composition
1958,sp_workloads,1690805680,wl_small_mem,1293,mixed:GM-LM-RR-LSVT-SGD-PATE-sub25100-defpa,1,dpk-gurobi,block-composition,poisson,equal-ncd,mixed:GM-LM-RR-LSVT-SGD-PATE,sub25100,nopa,Unlocking,0.4,GaussianMechanism,{'Optimal': 40},1075,1140,1126,0,598,1111,1075,542,15,1075,1140,1126,0,598,1111,1075,542,15,poisson-block-composition
1959,sp_workloads,1690805680,wl_small_mem,1293,mixed:GM-LM-RR-LSVT-SGD-PATE-sub25100-defpa,1,dpk-gurobi,block-composition,poisson,equal-ncd,mixed:GM-LM-RR-LSVT-SGD-PATE,sub25100,nopa,Unlocking,0.4,LaplaceMechanism,{'Optimal': 40},1140,1163,1130,0,342,1130,1140,821,0,1140,1163,1130,0,342,1130,1140,821,0,poisson-block-composition
1960,sp_workloads,1690805680,wl_small_mem,1293,mixed:GM-LM-RR-LSVT-SGD-PATE-sub25100-defpa,1,dpk-gurobi,block-composition,poisson,equal-ncd,mixed:GM-LM-RR-LSVT-SGD-PATE,sub25100,nopa,Unlocking,0.4,MLNoisySGDMechanism,{'Optimal': 40},1145,1089,1161,0,384,1161,1145,705,0,1145,1089,1161,0,384,1161,1145,705,0,poisson-block-composition
1961,sp_workloads,1690805680,wl_small_mem,1293,mixed:GM-LM-RR-LSVT-SGD-PATE-sub25100-defpa,1,dpk-gurobi,block-composition,poisson,equal-ncd,mixed:GM-LM-RR-LSVT-SGD-PATE,sub25100,nopa,Unlocking,0.4,MLPateGaussianMechanism,{'Optimal': 40},1163,1144,1138,0,580,1067,1163,564,71,1163,1144,1138,0,580,1067,1163,564,71,poisson-block-composition
1962,sp_workloads,1690805680,wl_small_mem,1293,mixed:GM-LM-RR-LSVT-SGD-PATE-sub25100-defpa,1,dpk-gurobi,block-composition,poisson,equal-ncd,mixed:GM-LM-RR-LSVT-SGD-PATE,sub25100,nopa,Unlocking,0.4,RandResponseMechanism,{'Optimal': 40},1093,1164,1181,0,0,1181,1093,1164,0,1093,1164,1181,0,0,1181,1093,1164,0,poisson-block-composition
1963,sp_workloads,1690805680,wl_small_mem,1293,mixed:GM-LM-RR-LSVT-SGD-PATE-sub25100-defpa,1,dpk-gurobi,block-composition,poisson,equal-ncd,mixed:GM-LM-RR-LSVT-SGD-PATE,sub25100,nopa,Unlocking,0.4,SVTLaplaceMechanism,{'Optimal': 40},1178,1127,1089,0,119,1087,1178,1008,2,1178,1127,1089,0,119,1087,1178,1008,2,poisson-block-composition
1964,sp_workloads,1690805680,wl_small_mem,1294,mixed:GM-LM-RR-LSVT-SGD-PATE-sub25100-defpa,1,dpk-gurobi,block-composition,upc,equal-ncd,mixed:GM-LM-RR-LSVT-SGD-PATE,sub25100,nopa,Unlocking,0.2,GaussianMechanism,{'Optimal': 40},1075,1140,1126,0,249,1126,1075,891,0,1075,1140,1126,0,249,1126,1075,891,0,upc-block-composition
1965,sp_workloads,1690805680,wl_small_mem,1294,mixed:GM-LM-RR-LSVT-SGD-PATE-sub25100-defpa,1,dpk-gurobi,block-composition,upc,equal-ncd,mixed:GM-LM-RR-LSVT-SGD-PATE,sub25100,nopa,Unlocking,0.2,LaplaceMechanism,{'Optimal': 40},1140,1163,1130,0,1,1130,1140,1162,0,1140,1163,1130,0,1,1130,1140,1162,0,upc-block-composition
1966,sp_workloads,1690805680,wl_small_mem,1294,mixed:GM-LM-RR-LSVT-SGD-PATE-sub25100-defpa,1,dpk-gurobi,block-composition,upc,equal-ncd,mixed:GM-LM-RR-LSVT-SGD-PATE,sub25100,nopa,Unlocking,0.2,MLNoisySGDMechanism,{'Optimal': 40},1145,1089,1161,0,506,1161,1145,583,0,1145,1089,1161,0,506,1161,1145,583,0,upc-block-composition
1967,sp_workloads,1690805680,wl_small_mem,1294,mixed:GM-LM-RR-LSVT-SGD-PATE-sub25100-defpa,1,dpk-gurobi,block-composition,upc,equal-ncd,mixed:GM-LM-RR-LSVT-SGD-PATE,sub25100,nopa,Unlocking,0.2,MLPateGaussianMechanism,{'Optimal': 40},1163,1144,1138,0,255,1138,1163,889,0,1163,1144,1138,0,255,1138,1163,889,0,upc-block-composition
1968,sp_workloads,1690805680,wl_small_mem,1294,mixed:GM-LM-RR-LSVT-SGD-PATE-sub25100-defpa,1,dpk-gurobi,block-composition,upc,equal-ncd,mixed:GM-LM-RR-LSVT-SGD-PATE,sub25100,nopa,Unlocking,0.2,RandResponseMechanism,{'Optimal': 40},1093,1164,1181,0,3,1181,1093,1161,0,1093,1164,1181,0,3,1181,1093,1161,0,upc-block-composition
1969,sp_workloads,1690805680,wl_small_mem,1294,mixed:GM-LM-RR-LSVT-SGD-PATE-sub25100-defpa,1,dpk-gurobi,block-composition,upc,equal-ncd,mixed:GM-LM-RR-LSVT-SGD-PATE,sub25100,nopa,Unlocking,0.2,SVTLaplaceMechanism,{'Optimal': 40},1178,1127,1089,0,1,1089,1178,1126,0,1178,1127,1089,0,1,1089,1178,1126,0,upc-block-composition
1970,sp_workloads,1690805680,wl_small_mem,1295,mixed:GM-LM-RR-LSVT-SGD-PATE-sub25100-defpa,1,dpk-gurobi,block-composition,upc,equal-ncd,mixed:GM-LM-RR-LSVT-SGD-PATE,sub25100,nopa,Unlocking,0.4,GaussianMechanism,{'Optimal': 40},1075,1140,1126,1,245,1126,1074,895,0,1075,1140,1126,1,245,1126,1074,895,0,upc-block-composition
1971,sp_workloads,1690805680,wl_small_mem,1295,mixed:GM-LM-RR-LSVT-SGD-PATE-sub25100-defpa,1,dpk-gurobi,block-composition,upc,equal-ncd,mixed:GM-LM-RR-LSVT-SGD-PATE,sub25100,nopa,Unlocking,0.4,LaplaceMechanism,{'Optimal': 40},1140,1163,1130,0,11,1130,1140,1152,0,1140,1163,1130,0,11,1130,1140,1152,0,upc-block-composition
1972,sp_workloads,1690805680,wl_small_mem,1295,mixed:GM-LM-RR-LSVT-SGD-PATE-sub25100-defpa,1,dpk-gurobi,block-composition,upc,equal-ncd,mixed:GM-LM-RR-LSVT-SGD-PATE,sub25100,nopa,Unlocking,0.4,MLNoisySGDMechanism,{'Optimal': 40},1145,1089,1161,2,382,1161,1143,707,0,1145,1089,1161,2,382,1161,1143,707,0,upc-block-composition
1973,sp_workloads,1690805680,wl_small_mem,1295,mixed:GM-LM-RR-LSVT-SGD-PATE-sub25100-defpa,1,dpk-gurobi,block-composition,upc,equal-ncd,mixed:GM-LM-RR-LSVT-SGD-PATE,sub25100,nopa,Unlocking,0.4,MLPateGaussianMechanism,{'Optimal': 40},1163,1144,1138,0,236,1111,1163,908,27,1163,1144,1138,0,236,1111,1163,908,27,upc-block-composition
1974,sp_workloads,1690805680,wl_small_mem,1295,mixed:GM-LM-RR-LSVT-SGD-PATE-sub25100-defpa,1,dpk-gurobi,block-composition,upc,equal-ncd,mixed:GM-LM-RR-LSVT-SGD-PATE,sub25100,nopa,Unlocking,0.4,RandResponseMechanism,{'Optimal': 40},1093,1164,1181,1,10,1181,1092,1154,0,1093,1164,1181,1,10,1181,1092,1154,0,upc-block-composition
1975,sp_workloads,1690805680,wl_small_mem,1295,mixed:GM-LM-RR-LSVT-SGD-PATE-sub25100-defpa,1,dpk-gurobi,block-composition,upc,equal-ncd,mixed:GM-LM-RR-LSVT-SGD-PATE,sub25100,nopa,Unlocking,0.4,SVTLaplaceMechanism,{'Optimal': 40},1178,1127,1089,0,13,1089,1178,1114,0,1178,1127,1089,0,13,1089,1178,1114,0,upc-block-composition
1976,sp_workloads,1690805680,wl_small_mem,1296,mixed:GM-LM-RR-LSVT-SGD-PATE-sub25100-defpa,2,dpk-gurobi,block-composition,poisson,ncd,mixed:GM-LM-RR-LSVT-SGD-PATE,sub25100,nopa,Unlocking,0.2,GaussianMechanism,{'Optimal': 40},3297557,222693,20889,414795,21119,8325,2882762,201574,12564,1107,1156,1159,197,161,555,910,995,604,poisson-block-composition
1977,sp_workloads,1690805680,wl_small_mem,1296,mixed:GM-LM-RR-LSVT-SGD-PATE-sub25100-defpa,2,dpk-gurobi,block-composition,poisson,ncd,mixed:GM-LM-RR-LSVT-SGD-PATE,sub25100,nopa,Unlocking,0.2,LaplaceMechanism,{'Optimal': 40},2847135,226653,20024,2122,0,8681,2845013,226653,11343,1061,1136,1112,1,0,567,1060,1136,545,poisson-block-composition
1978,sp_workloads,1690805680,wl_small_mem,1296,mixed:GM-LM-RR-LSVT-SGD-PATE-sub25100-defpa,2,dpk-gurobi,block-composition,poisson,ncd,mixed:GM-LM-RR-LSVT-SGD-PATE,sub25100,nopa,Unlocking,0.2,MLNoisySGDMechanism,{'Optimal': 40},3065470,217531,20600,511912,14698,9735,2553558,202833,10865,1088,1113,1144,248,118,617,840,995,527,poisson-block-composition
1979,sp_workloads,1690805680,wl_small_mem,1296,mixed:GM-LM-RR-LSVT-SGD-PATE-sub25100-defpa,2,dpk-gurobi,block-composition,poisson,ncd,mixed:GM-LM-RR-LSVT-SGD-PATE,sub25100,nopa,Unlocking,0.2,MLPateGaussianMechanism,{'Optimal': 40},3183074,228777,19443,376560,27348,8730,2806514,201429,10713,1123,1178,1085,181,204,582,942,974,503,poisson-block-composition
1980,sp_workloads,1690805680,wl_small_mem,1296,mixed:GM-LM-RR-LSVT-SGD-PATE-sub25100-defpa,2,dpk-gurobi,block-composition,poisson,ncd,mixed:GM-LM-RR-LSVT-SGD-PATE,sub25100,nopa,Unlocking,0.2,RandResponseMechanism,{'Optimal': 40},3253029,217115,19830,0,0,8191,3253029,217115,11639,1136,1135,1114,0,0,545,1136,1135,569,poisson-block-composition
1981,sp_workloads,1690805680,wl_small_mem,1296,mixed:GM-LM-RR-LSVT-SGD-PATE-sub25100-defpa,2,dpk-gurobi,block-composition,poisson,ncd,mixed:GM-LM-RR-LSVT-SGD-PATE,sub25100,nopa,Unlocking,0.2,SVTLaplaceMechanism,{'Optimal': 40},3041723,217557,19755,0,0,7470,3041723,217557,12285,1106,1092,1109,0,0,498,1106,1092,611,poisson-block-composition
1982,sp_workloads,1690805680,wl_small_mem,1297,mixed:GM-LM-RR-LSVT-SGD-PATE-sub25100-defpa,2,dpk-gurobi,block-composition,poisson,ncd,mixed:GM-LM-RR-LSVT-SGD-PATE,sub25100,nopa,Unlocking,0.4,GaussianMechanism,{'Optimal': 40},3297557,222693,20889,386102,21640,8325,2911455,201053,12564,1107,1156,1159,188,168,555,919,988,604,poisson-block-composition
1983,sp_workloads,1690805680,wl_small_mem,1297,mixed:GM-LM-RR-LSVT-SGD-PATE-sub25100-defpa,2,dpk-gurobi,block-composition,poisson,ncd,mixed:GM-LM-RR-LSVT-SGD-PATE,sub25100,nopa,Unlocking,0.4,LaplaceMechanism,{'Optimal': 40},2847135,226653,20024,8936,0,8588,2838199,226653,11436,1061,1136,1112,4,0,564,1057,1136,548,poisson-block-composition
1984,sp_workloads,1690805680,wl_small_mem,1297,mixed:GM-LM-RR-LSVT-SGD-PATE-sub25100-defpa,2,dpk-gurobi,block-composition,poisson,ncd,mixed:GM-LM-RR-LSVT-SGD-PATE,sub25100,nopa,Unlocking,0.4,MLNoisySGDMechanism,{'Optimal': 40},3065470,217531,20600,517673,18204,9267,2547797,199327,11333,1088,1113,1144,250,148,589,838,965,555,poisson-block-composition
1985,sp_workloads,1690805680,wl_small_mem,1297,mixed:GM-LM-RR-LSVT-SGD-PATE-sub25100-defpa,2,dpk-gurobi,block-composition,poisson,ncd,mixed:GM-LM-RR-LSVT-SGD-PATE,sub25100,nopa,Unlocking,0.4,MLPateGaussianMechanism,{'Optimal': 40},3183074,228777,19443,369106,25945,8730,2813968,202832,10713,1123,1178,1085,183,199,582,940,979,503,poisson-block-composition
1986,sp_workloads,1690805680,wl_small_mem,1297,mixed:GM-LM-RR-LSVT-SGD-PATE-sub25100-defpa,2,dpk-gurobi,block-composition,poisson,ncd,mixed:GM-LM-RR-LSVT-SGD-PATE,sub25100,nopa,Unlocking,0.4,RandResponseMechanism,{'Optimal': 40},3253029,217115,19830,0,0,7907,3253029,217115,11923,1136,1135,1114,0,0,525,1136,1135,589,poisson-block-composition
1987,sp_workloads,1690805680,wl_small_mem,1297,mixed:GM-LM-RR-LSVT-SGD-PATE-sub25100-defpa,2,dpk-gurobi,block-composition,poisson,ncd,mixed:GM-LM-RR-LSVT-SGD-PATE,sub25100,nopa,Unlocking,0.4,SVTLaplaceMechanism,{'Optimal': 40},3041723,217557,19755,0,0,7440,3041723,217557,12315,1106,1092,1109,0,0,496,1106,1092,613,poisson-block-composition
1988,sp_workloads,1690805680,wl_small_mem,1298,mixed:GM-LM-RR-LSVT-SGD-PATE-sub25100-defpa,2,dpk-gurobi,block-composition,upc,ncd,mixed:GM-LM-RR-LSVT-SGD-PATE,sub25100,nopa,Unlocking,0.2,GaussianMechanism,{'Optimal': 40},3028685,226201,22304,0,14368,8080,3028685,211833,14224,1107,1156,1159,0,141,505,1107,1015,654,upc-block-composition
1989,sp_workloads,1690805680,wl_small_mem,1298,mixed:GM-LM-RR-LSVT-SGD-PATE-sub25100-defpa,2,dpk-gurobi,block-composition,upc,ncd,mixed:GM-LM-RR-LSVT-SGD-PATE,sub25100,nopa,Unlocking,0.2,LaplaceMechanism,{'Optimal': 40},2820488,216183,20704,0,854,8592,2820488,215329,12112,1061,1136,1112,0,7,531,1061,1129,581,upc-block-composition
1990,sp_workloads,1690805680,wl_small_mem,1298,mixed:GM-LM-RR-LSVT-SGD-PATE-sub25100-defpa,2,dpk-gurobi,block-composition,upc,ncd,mixed:GM-LM-RR-LSVT-SGD-PATE,sub25100,nopa,Unlocking,0.2,MLNoisySGDMechanism,{'Optimal': 40},3179489,220472,21440,341560,16747,10112,2837929,203725,11328,1088,1113,1144,118,158,604,970,955,540,upc-block-composition
1991,sp_workloads,1690805680,wl_small_mem,1298,mixed:GM-LM-RR-LSVT-SGD-PATE-sub25100-defpa,2,dpk-gurobi,block-composition,upc,ncd,mixed:GM-LM-RR-LSVT-SGD-PATE,sub25100,nopa,Unlocking,0.2,MLPateGaussianMechanism,{'Optimal': 40},3159577,225347,20608,0,14368,8368,3159577,210979,12240,1123,1178,1085,0,141,523,1123,1037,562,upc-block-composition
1992,sp_workloads,1690805680,wl_small_mem,1298,mixed:GM-LM-RR-LSVT-SGD-PATE-sub25100-defpa,2,dpk-gurobi,block-composition,upc,ncd,mixed:GM-LM-RR-LSVT-SGD-PATE,sub25100,nopa,Unlocking,0.2,RandResponseMechanism,{'Optimal': 40},3276567,216246,21344,0,564,8224,3276567,215682,13120,1136,1135,1114,0,5,513,1136,1130,601,upc-block-composition
1993,sp_workloads,1690805680,wl_small_mem,1298,mixed:GM-LM-RR-LSVT-SGD-PATE-sub25100-defpa,2,dpk-gurobi,block-composition,upc,ncd,mixed:GM-LM-RR-LSVT-SGD-PATE,sub25100,nopa,Unlocking,0.2,SVTLaplaceMechanism,{'Optimal': 40},3232745,216520,21504,0,1111,8256,3232745,215409,13248,1106,1092,1109,0,13,516,1106,1079,593,upc-block-composition
1994,sp_workloads,1690805680,wl_small_mem,1299,mixed:GM-LM-RR-LSVT-SGD-PATE-sub25100-defpa,2,dpk-gurobi,block-composition,upc,ncd,mixed:GM-LM-RR-LSVT-SGD-PATE,sub25100,nopa,Unlocking,0.4,GaussianMechanism,{'Optimal': 40},3028685,226201,22304,0,14882,7728,3028685,211319,14576,1107,1156,1159,0,149,483,1107,1007,676,upc-block-composition
1995,sp_workloads,1690805680,wl_small_mem,1299,mixed:GM-LM-RR-LSVT-SGD-PATE-sub25100-defpa,2,dpk-gurobi,block-composition,upc,ncd,mixed:GM-LM-RR-LSVT-SGD-PATE,sub25100,nopa,Unlocking,0.4,LaplaceMechanism,{'Optimal': 40},2820488,216183,20704,0,1450,7872,2820488,214733,12832,1061,1136,1112,0,14,491,1061,1122,621,upc-block-composition
1996,sp_workloads,1690805680,wl_small_mem,1299,mixed:GM-LM-RR-LSVT-SGD-PATE-sub25100-defpa,2,dpk-gurobi,block-composition,upc,ncd,mixed:GM-LM-RR-LSVT-SGD-PATE,sub25100,nopa,Unlocking,0.4,MLNoisySGDMechanism,{'Optimal': 40},3179489,220472,21440,313762,29681,9712,2865727,190791,11728,1088,1113,1144,113,218,584,975,895,560,upc-block-composition
1997,sp_workloads,1690805680,wl_small_mem,1299,mixed:GM-LM-RR-LSVT-SGD-PATE-sub25100-defpa,2,dpk-gurobi,block-composition,upc,ncd,mixed:GM-LM-RR-LSVT-SGD-PATE,sub25100,nopa,Unlocking,0.4,MLPateGaussianMechanism,{'Optimal': 40},3159577,225347,20608,2235,17111,7664,3157342,208236,12944,1123,1178,1085,1,165,479,1122,1013,606,upc-block-composition
1998,sp_workloads,1690805680,wl_small_mem,1299,mixed:GM-LM-RR-LSVT-SGD-PATE-sub25100-defpa,2,dpk-gurobi,block-composition,upc,ncd,mixed:GM-LM-RR-LSVT-SGD-PATE,sub25100,nopa,Unlocking,0.4,RandResponseMechanism,{'Optimal': 40},3276567,216246,21344,16,1353,7504,3276551,214893,13840,1136,1135,1114,1,15,469,1135,1120,645,upc-block-composition
1999,sp_workloads,1690805680,wl_small_mem,1299,mixed:GM-LM-RR-LSVT-SGD-PATE-sub25100-defpa,2,dpk-gurobi,block-composition,upc,ncd,mixed:GM-LM-RR-LSVT-SGD-PATE,sub25100,nopa,Unlocking,0.4,SVTLaplaceMechanism,{'Optimal': 40},3232745,216520,21504,0,1047,7840,3232745,215473,13664,1106,1092,1109,0,10,490,1106,1082,619,upc-block-composition
2000,sp_workloads,1690805680,wl_small_mem,1300,mixed:GM-LM-RR-LSVT-SGD-PATE-sub25100-defpa,2,dpk-gurobi,block-composition,poisson,equal-ncd,mixed:GM-LM-RR-LSVT-SGD-PATE,sub25100,nopa,Unlocking,0.2,GaussianMechanism,{'Optimal': 40},1107,1156,1159,0,601,1159,1107,555,0,1107,1156,1159,0,601,1159,1107,555,0,poisson-block-composition
2001,sp_workloads,1690805680,wl_small_mem,1300,mixed:GM-LM-RR-LSVT-SGD-PATE-sub25100-defpa,2,dpk-gurobi,block-composition,poisson,equal-ncd,mixed:GM-LM-RR-LSVT-SGD-PATE,sub25100,nopa,Unlocking,0.2,LaplaceMechanism,{'Optimal': 40},1061,1136,1112,0,378,1112,1061,758,0,1061,1136,1112,0,378,1112,1061,758,0,poisson-block-composition
2002,sp_workloads,1690805680,wl_small_mem,1300,mixed:GM-LM-RR-LSVT-SGD-PATE-sub25100-defpa,2,dpk-gurobi,block-composition,poisson,equal-ncd,mixed:GM-LM-RR-LSVT-SGD-PATE,sub25100,nopa,Unlocking,0.2,MLNoisySGDMechanism,{'Optimal': 40},1088,1113,1144,0,555,1144,1088,558,0,1088,1113,1144,0,555,1144,1088,558,0,poisson-block-composition
2003,sp_workloads,1690805680,wl_small_mem,1300,mixed:GM-LM-RR-LSVT-SGD-PATE-sub25100-defpa,2,dpk-gurobi,block-composition,poisson,equal-ncd,mixed:GM-LM-RR-LSVT-SGD-PATE,sub25100,nopa,Unlocking,0.2,MLPateGaussianMechanism,{'Optimal': 40},1123,1178,1085,0,598,1085,1123,580,0,1123,1178,1085,0,598,1085,1123,580,0,poisson-block-composition
2004,sp_workloads,1690805680,wl_small_mem,1300,mixed:GM-LM-RR-LSVT-SGD-PATE-sub25100-defpa,2,dpk-gurobi,block-composition,poisson,equal-ncd,mixed:GM-LM-RR-LSVT-SGD-PATE,sub25100,nopa,Unlocking,0.2,RandResponseMechanism,{'Optimal': 40},1136,1135,1114,0,0,1114,1136,1135,0,1136,1135,1114,0,0,1114,1136,1135,0,poisson-block-composition
2005,sp_workloads,1690805680,wl_small_mem,1300,mixed:GM-LM-RR-LSVT-SGD-PATE-sub25100-defpa,2,dpk-gurobi,block-composition,poisson,equal-ncd,mixed:GM-LM-RR-LSVT-SGD-PATE,sub25100,nopa,Unlocking,0.2,SVTLaplaceMechanism,{'Optimal': 40},1106,1092,1109,0,51,1109,1106,1041,0,1106,1092,1109,0,51,1109,1106,1041,0,poisson-block-composition
2006,sp_workloads,1690805680,wl_small_mem,1301,mixed:GM-LM-RR-LSVT-SGD-PATE-sub25100-defpa,2,dpk-gurobi,block-composition,poisson,equal-ncd,mixed:GM-LM-RR-LSVT-SGD-PATE,sub25100,nopa,Unlocking,0.4,GaussianMechanism,{'Optimal': 40},1107,1156,1159,0,601,1156,1107,555,3,1107,1156,1159,0,601,1156,1107,555,3,poisson-block-composition
2007,sp_workloads,1690805680,wl_small_mem,1301,mixed:GM-LM-RR-LSVT-SGD-PATE-sub25100-defpa,2,dpk-gurobi,block-composition,poisson,equal-ncd,mixed:GM-LM-RR-LSVT-SGD-PATE,sub25100,nopa,Unlocking,0.4,LaplaceMechanism,{'Optimal': 40},1061,1136,1112,0,309,1112,1061,827,0,1061,1136,1112,0,309,1112,1061,827,0,poisson-block-composition
2008,sp_workloads,1690805680,wl_small_mem,1301,mixed:GM-LM-RR-LSVT-SGD-PATE-sub25100-defpa,2,dpk-gurobi,block-composition,poisson,equal-ncd,mixed:GM-LM-RR-LSVT-SGD-PATE,sub25100,nopa,Unlocking,0.4,MLNoisySGDMechanism,{'Optimal': 40},1088,1113,1144,0,425,1144,1088,688,0,1088,1113,1144,0,425,1144,1088,688,0,poisson-block-composition
2009,sp_workloads,1690805680,wl_small_mem,1301,mixed:GM-LM-RR-LSVT-SGD-PATE-sub25100-defpa,2,dpk-gurobi,block-composition,poisson,equal-ncd,mixed:GM-LM-RR-LSVT-SGD-PATE,sub25100,nopa,Unlocking,0.4,MLPateGaussianMechanism,{'Optimal': 40},1123,1178,1085,0,598,1020,1123,580,65,1123,1178,1085,0,598,1020,1123,580,65,poisson-block-composition
2010,sp_workloads,1690805680,wl_small_mem,1301,mixed:GM-LM-RR-LSVT-SGD-PATE-sub25100-defpa,2,dpk-gurobi,block-composition,poisson,equal-ncd,mixed:GM-LM-RR-LSVT-SGD-PATE,sub25100,nopa,Unlocking,0.4,RandResponseMechanism,{'Optimal': 40},1136,1135,1114,0,6,1114,1136,1129,0,1136,1135,1114,0,6,1114,1136,1129,0,poisson-block-composition
2011,sp_workloads,1690805680,wl_small_mem,1301,mixed:GM-LM-RR-LSVT-SGD-PATE-sub25100-defpa,2,dpk-gurobi,block-composition,poisson,equal-ncd,mixed:GM-LM-RR-LSVT-SGD-PATE,sub25100,nopa,Unlocking,0.4,SVTLaplaceMechanism,{'Optimal': 40},1106,1092,1109,0,134,1109,1106,958,0,1106,1092,1109,0,134,1109,1106,958,0,poisson-block-composition
2012,sp_workloads,1690805680,wl_small_mem,1302,mixed:GM-LM-RR-LSVT-SGD-PATE-sub25100-defpa,2,dpk-gurobi,block-composition,upc,equal-ncd,mixed:GM-LM-RR-LSVT-SGD-PATE,sub25100,nopa,Unlocking,0.2,GaussianMechanism,{'Optimal': 40},1107,1156,1159,0,256,1159,1107,900,0,1107,1156,1159,0,256,1159,1107,900,0,upc-block-composition
2013,sp_workloads,1690805680,wl_small_mem,1302,mixed:GM-LM-RR-LSVT-SGD-PATE-sub25100-defpa,2,dpk-gurobi,block-composition,upc,equal-ncd,mixed:GM-LM-RR-LSVT-SGD-PATE,sub25100,nopa,Unlocking,0.2,LaplaceMechanism,{'Optimal': 40},1061,1136,1112,0,3,1112,1061,1133,0,1061,1136,1112,0,3,1112,1061,1133,0,upc-block-composition
2014,sp_workloads,1690805680,wl_small_mem,1302,mixed:GM-LM-RR-LSVT-SGD-PATE-sub25100-defpa,2,dpk-gurobi,block-composition,upc,equal-ncd,mixed:GM-LM-RR-LSVT-SGD-PATE,sub25100,nopa,Unlocking,0.2,MLNoisySGDMechanism,{'Optimal': 40},1088,1113,1144,0,495,1144,1088,618,0,1088,1113,1144,0,495,1144,1088,618,0,upc-block-composition
2015,sp_workloads,1690805680,wl_small_mem,1302,mixed:GM-LM-RR-LSVT-SGD-PATE-sub25100-defpa,2,dpk-gurobi,block-composition,upc,equal-ncd,mixed:GM-LM-RR-LSVT-SGD-PATE,sub25100,nopa,Unlocking,0.2,MLPateGaussianMechanism,{'Optimal': 40},1123,1178,1085,0,259,1085,1123,919,0,1123,1178,1085,0,259,1085,1123,919,0,upc-block-composition
2016,sp_workloads,1690805680,wl_small_mem,1302,mixed:GM-LM-RR-LSVT-SGD-PATE-sub25100-defpa,2,dpk-gurobi,block-composition,upc,equal-ncd,mixed:GM-LM-RR-LSVT-SGD-PATE,sub25100,nopa,Unlocking,0.2,RandResponseMechanism,{'Optimal': 40},1136,1135,1114,0,4,1114,1136,1131,0,1136,1135,1114,0,4,1114,1136,1131,0,upc-block-composition
2017,sp_workloads,1690805680,wl_small_mem,1302,mixed:GM-LM-RR-LSVT-SGD-PATE-sub25100-defpa,2,dpk-gurobi,block-composition,upc,equal-ncd,mixed:GM-LM-RR-LSVT-SGD-PATE,sub25100,nopa,Unlocking,0.2,SVTLaplaceMechanism,{'Optimal': 40},1106,1092,1109,0,0,1109,1106,1092,0,1106,1092,1109,0,0,1109,1106,1092,0,upc-block-composition
2018,sp_workloads,1690805680,wl_small_mem,1303,mixed:GM-LM-RR-LSVT-SGD-PATE-sub25100-defpa,2,dpk-gurobi,block-composition,upc,equal-ncd,mixed:GM-LM-RR-LSVT-SGD-PATE,sub25100,nopa,Unlocking,0.4,GaussianMechanism,{'Optimal': 40},1107,1156,1159,0,262,1159,1107,894,0,1107,1156,1159,0,262,1159,1107,894,0,upc-block-composition
2019,sp_workloads,1690805680,wl_small_mem,1303,mixed:GM-LM-RR-LSVT-SGD-PATE-sub25100-defpa,2,dpk-gurobi,block-composition,upc,equal-ncd,mixed:GM-LM-RR-LSVT-SGD-PATE,sub25100,nopa,Unlocking,0.4,LaplaceMechanism,{'Optimal': 40},1061,1136,1112,0,15,1112,1061,1121,0,1061,1136,1112,0,15,1112,1061,1121,0,upc-block-composition
2020,sp_workloads,1690805680,wl_small_mem,1303,mixed:GM-LM-RR-LSVT-SGD-PATE-sub25100-defpa,2,dpk-gurobi,block-composition,upc,equal-ncd,mixed:GM-LM-RR-LSVT-SGD-PATE,sub25100,nopa,Unlocking,0.4,MLNoisySGDMechanism,{'Optimal': 40},1088,1113,1144,1,398,1144,1087,715,0,1088,1113,1144,1,398,1144,1087,715,0,upc-block-composition
2021,sp_workloads,1690805680,wl_small_mem,1303,mixed:GM-LM-RR-LSVT-SGD-PATE-sub25100-defpa,2,dpk-gurobi,block-composition,upc,equal-ncd,mixed:GM-LM-RR-LSVT-SGD-PATE,sub25100,nopa,Unlocking,0.4,MLPateGaussianMechanism,{'Optimal': 40},1123,1178,1085,0,232,1068,1123,946,17,1123,1178,1085,0,232,1068,1123,946,17,upc-block-composition
2022,sp_workloads,1690805680,wl_small_mem,1303,mixed:GM-LM-RR-LSVT-SGD-PATE-sub25100-defpa,2,dpk-gurobi,block-composition,upc,equal-ncd,mixed:GM-LM-RR-LSVT-SGD-PATE,sub25100,nopa,Unlocking,0.4,RandResponseMechanism,{'Optimal': 40},1136,1135,1114,0,9,1114,1136,1126,0,1136,1135,1114,0,9,1114,1136,1126,0,upc-block-composition
2023,sp_workloads,1690805680,wl_small_mem,1303,mixed:GM-LM-RR-LSVT-SGD-PATE-sub25100-defpa,2,dpk-gurobi,block-composition,upc,equal-ncd,mixed:GM-LM-RR-LSVT-SGD-PATE,sub25100,nopa,Unlocking,0.4,SVTLaplaceMechanism,{'Optimal': 40},1106,1092,1109,0,9,1109,1106,1083,0,1106,1092,1109,0,9,1109,1106,1083,0,upc-block-composition
2024,sp_workloads,1690805680,wl_small_mem,1304,mixed:GM-LM-RR-LSVT-SGD-PATE-sub25100-defpa,3,dpk-gurobi,block-composition,poisson,ncd,mixed:GM-LM-RR-LSVT-SGD-PATE,sub25100,nopa,Unlocking,0.2,GaussianMechanism,{'Optimal': 40},3014106,221031,21056,401601,22400,8816,2612505,198631,12240,1094,1113,1104,188,173,551,906,940,553,poisson-block-composition
2025,sp_workloads,1690805680,wl_small_mem,1304,mixed:GM-LM-RR-LSVT-SGD-PATE-sub25100-defpa,3,dpk-gurobi,block-composition,poisson,ncd,mixed:GM-LM-RR-LSVT-SGD-PATE,sub25100,nopa,Unlocking,0.2,LaplaceMechanism,{'Optimal': 40},3356641,218178,20864,6774,0,9472,3349867,218178,11392,1169,1154,1119,3,0,591,1166,1154,528,poisson-block-composition
2026,sp_workloads,1690805680,wl_small_mem,1304,mixed:GM-LM-RR-LSVT-SGD-PATE-sub25100-defpa,3,dpk-gurobi,block-composition,poisson,ncd,mixed:GM-LM-RR-LSVT-SGD-PATE,sub25100,nopa,Unlocking,0.2,MLNoisySGDMechanism,{'Optimal': 40},2886113,212328,21728,475453,18090,9488,2410660,194238,12240,1057,1087,1124,235,140,573,822,947,551,poisson-block-composition
2027,sp_workloads,1690805680,wl_small_mem,1304,mixed:GM-LM-RR-LSVT-SGD-PATE-sub25100-defpa,3,dpk-gurobi,block-composition,poisson,ncd,mixed:GM-LM-RR-LSVT-SGD-PATE,sub25100,nopa,Unlocking,0.2,MLPateGaussianMechanism,{'Optimal': 40},3286989,218751,22304,409022,24949,9360,2877967,193802,12944,1114,1105,1168,194,190,585,920,915,583,poisson-block-composition
2028,sp_workloads,1690805680,wl_small_mem,1304,mixed:GM-LM-RR-LSVT-SGD-PATE-sub25100-defpa,3,dpk-gurobi,block-composition,poisson,ncd,mixed:GM-LM-RR-LSVT-SGD-PATE,sub25100,nopa,Unlocking,0.2,RandResponseMechanism,{'Optimal': 40},3304405,225397,21760,0,0,9488,3304405,225397,12272,1160,1175,1154,0,0,593,1160,1175,561,poisson-block-composition
2029,sp_workloads,1690805680,wl_small_mem,1304,mixed:GM-LM-RR-LSVT-SGD-PATE-sub25100-defpa,3,dpk-gurobi,block-composition,poisson,ncd,mixed:GM-LM-RR-LSVT-SGD-PATE,sub25100,nopa,Unlocking,0.2,SVTLaplaceMechanism,{'Optimal': 40},2975196,221951,22352,0,0,9312,2975196,221951,13040,1080,1132,1168,0,0,582,1080,1132,586,poisson-block-composition
2030,sp_workloads,1690805680,wl_small_mem,1305,mixed:GM-LM-RR-LSVT-SGD-PATE-sub25100-defpa,3,dpk-gurobi,block-composition,poisson,ncd,mixed:GM-LM-RR-LSVT-SGD-PATE,sub25100,nopa,Unlocking,0.4,GaussianMechanism,{'Optimal': 40},3014106,221031,21056,382099,23241,8816,2632007,197790,12240,1094,1113,1104,185,180,551,909,933,553,poisson-block-composition
2031,sp_workloads,1690805680,wl_small_mem,1305,mixed:GM-LM-RR-LSVT-SGD-PATE-sub25100-defpa,3,dpk-gurobi,block-composition,poisson,ncd,mixed:GM-LM-RR-LSVT-SGD-PATE,sub25100,nopa,Unlocking,0.4,LaplaceMechanism,{'Optimal': 40},3356641,218178,20864,6742,0,9440,3349899,218178,11424,1169,1154,1119,3,0,590,1166,1154,529,poisson-block-composition
2032,sp_workloads,1690805680,wl_small_mem,1305,mixed:GM-LM-RR-LSVT-SGD-PATE-sub25100-defpa,3,dpk-gurobi,block-composition,poisson,ncd,mixed:GM-LM-RR-LSVT-SGD-PATE,sub25100,nopa,Unlocking,0.4,MLNoisySGDMechanism,{'Optimal': 40},2886113,212328,21728,492127,20211,9968,2393986,192117,11760,1057,1087,1124,246,153,589,811,934,535,poisson-block-composition
2033,sp_workloads,1690805680,wl_small_mem,1305,mixed:GM-LM-RR-LSVT-SGD-PATE-sub25100-defpa,3,dpk-gurobi,block-composition,poisson,ncd,mixed:GM-LM-RR-LSVT-SGD-PATE,sub25100,nopa,Unlocking,0.4,MLPateGaussianMechanism,{'Optimal': 40},3286989,218751,22304,387023,24880,9360,2899966,193871,12944,1114,1105,1168,188,195,585,926,910,583,poisson-block-composition
2034,sp_workloads,1690805680,wl_small_mem,1305,mixed:GM-LM-RR-LSVT-SGD-PATE-sub25100-defpa,3,dpk-gurobi,block-composition,poisson,ncd,mixed:GM-LM-RR-LSVT-SGD-PATE,sub25100,nopa,Unlocking,0.4,RandResponseMechanism,{'Optimal': 40},3304405,225397,21760,0,0,9216,3304405,225397,12544,1160,1175,1154,0,0,576,1160,1175,578,poisson-block-composition
2035,sp_workloads,1690805680,wl_small_mem,1305,mixed:GM-LM-RR-LSVT-SGD-PATE-sub25100-defpa,3,dpk-gurobi,block-composition,poisson,ncd,mixed:GM-LM-RR-LSVT-SGD-PATE,sub25100,nopa,Unlocking,0.4,SVTLaplaceMechanism,{'Optimal': 40},2975196,221951,22352,0,0,9200,2975196,221951,13152,1080,1132,1168,0,0,575,1080,1132,593,poisson-block-composition
2036,sp_workloads,1690805680,wl_small_mem,1306,mixed:GM-LM-RR-LSVT-SGD-PATE-sub25100-defpa,3,dpk-gurobi,block-composition,upc,ncd,mixed:GM-LM-RR-LSVT-SGD-PATE,sub25100,nopa,Unlocking,0.2,GaussianMechanism,{'Optimal': 40},3015210,216424,20816,1919,13481,8160,3013291,202943,12656,1094,1113,1104,1,142,510,1093,971,594,upc-block-composition
2037,sp_workloads,1690805680,wl_small_mem,1306,mixed:GM-LM-RR-LSVT-SGD-PATE-sub25100-defpa,3,dpk-gurobi,block-composition,upc,ncd,mixed:GM-LM-RR-LSVT-SGD-PATE,sub25100,nopa,Unlocking,0.2,LaplaceMechanism,{'Optimal': 40},3318690,224507,21008,0,1433,9328,3318690,223074,11680,1169,1154,1119,0,12,578,1169,1142,541,upc-block-composition
2038,sp_workloads,1690805680,wl_small_mem,1306,mixed:GM-LM-RR-LSVT-SGD-PATE-sub25100-defpa,3,dpk-gurobi,block-composition,upc,ncd,mixed:GM-LM-RR-LSVT-SGD-PATE,sub25100,nopa,Unlocking,0.2,MLNoisySGDMechanism,{'Optimal': 40},3049040,216655,21456,317927,22879,10032,2731113,193776,11424,1057,1087,1124,104,183,585,953,904,539,upc-block-composition
2039,sp_workloads,1690805680,wl_small_mem,1306,mixed:GM-LM-RR-LSVT-SGD-PATE-sub25100-defpa,3,dpk-gurobi,block-composition,upc,ncd,mixed:GM-LM-RR-LSVT-SGD-PATE,sub25100,nopa,Unlocking,0.2,MLPateGaussianMechanism,{'Optimal': 40},3068572,223959,21712,4450,12100,8736,3064122,211859,12976,1114,1105,1168,2,125,546,1112,980,622,upc-block-composition
2040,sp_workloads,1690805680,wl_small_mem,1306,mixed:GM-LM-RR-LSVT-SGD-PATE-sub25100-defpa,3,dpk-gurobi,block-composition,upc,ncd,mixed:GM-LM-RR-LSVT-SGD-PATE,sub25100,nopa,Unlocking,0.2,RandResponseMechanism,{'Optimal': 40},3242042,226884,21536,0,1271,9216,3242042,225613,12320,1160,1175,1154,0,11,576,1160,1164,578,upc-block-composition
2041,sp_workloads,1690805680,wl_small_mem,1306,mixed:GM-LM-RR-LSVT-SGD-PATE-sub25100-defpa,3,dpk-gurobi,block-composition,upc,ncd,mixed:GM-LM-RR-LSVT-SGD-PATE,sub25100,nopa,Unlocking,0.2,SVTLaplaceMechanism,{'Optimal': 40},3121265,219086,22384,0,611,9184,3121265,218475,13200,1080,1132,1168,0,8,574,1080,1124,594,upc-block-composition
2042,sp_workloads,1690805680,wl_small_mem,1307,mixed:GM-LM-RR-LSVT-SGD-PATE-sub25100-defpa,3,dpk-gurobi,block-composition,upc,ncd,mixed:GM-LM-RR-LSVT-SGD-PATE,sub25100,nopa,Unlocking,0.4,GaussianMechanism,{'Optimal': 40},3015210,216424,20816,1919,11465,7312,3013291,204959,13504,1094,1113,1104,1,117,457,1093,996,647,upc-block-composition
2043,sp_workloads,1690805680,wl_small_mem,1307,mixed:GM-LM-RR-LSVT-SGD-PATE-sub25100-defpa,3,dpk-gurobi,block-composition,upc,ncd,mixed:GM-LM-RR-LSVT-SGD-PATE,sub25100,nopa,Unlocking,0.4,LaplaceMechanism,{'Optimal': 40},3318690,224507,21008,0,2270,8576,3318690,222237,12432,1169,1154,1119,0,20,530,1169,1134,589,upc-block-composition
2044,sp_workloads,1690805680,wl_small_mem,1307,mixed:GM-LM-RR-LSVT-SGD-PATE-sub25100-defpa,3,dpk-gurobi,block-composition,upc,ncd,mixed:GM-LM-RR-LSVT-SGD-PATE,sub25100,nopa,Unlocking,0.4,MLNoisySGDMechanism,{'Optimal': 40},3049040,216655,21456,347272,24236,9072,2701768,192419,12384,1057,1087,1124,111,169,550,946,918,574,upc-block-composition
2045,sp_workloads,1690805680,wl_small_mem,1307,mixed:GM-LM-RR-LSVT-SGD-PATE-sub25100-defpa,3,dpk-gurobi,block-composition,upc,ncd,mixed:GM-LM-RR-LSVT-SGD-PATE,sub25100,nopa,Unlocking,0.4,MLPateGaussianMechanism,{'Optimal': 40},3068572,223959,21712,0,13853,8224,3068572,210106,13488,1114,1105,1168,0,129,514,1114,976,654,upc-block-composition
2046,sp_workloads,1690805680,wl_small_mem,1307,mixed:GM-LM-RR-LSVT-SGD-PATE-sub25100-defpa,3,dpk-gurobi,block-composition,upc,ncd,mixed:GM-LM-RR-LSVT-SGD-PATE,sub25100,nopa,Unlocking,0.4,RandResponseMechanism,{'Optimal': 40},3242042,226884,21536,0,1030,8608,3242042,225854,12928,1160,1175,1154,0,10,538,1160,1165,616,upc-block-composition
2047,sp_workloads,1690805680,wl_small_mem,1307,mixed:GM-LM-RR-LSVT-SGD-PATE-sub25100-defpa,3,dpk-gurobi,block-composition,upc,ncd,mixed:GM-LM-RR-LSVT-SGD-PATE,sub25100,nopa,Unlocking,0.4,SVTLaplaceMechanism,{'Optimal': 40},3121265,219086,22384,0,1126,8608,3121265,217960,13776,1080,1132,1168,0,10,538,1080,1122,630,upc-block-composition
2048,sp_workloads,1690805680,wl_small_mem,1308,mixed:GM-LM-RR-LSVT-SGD-PATE-sub25100-defpa,3,dpk-gurobi,block-composition,poisson,equal-ncd,mixed:GM-LM-RR-LSVT-SGD-PATE,sub25100,nopa,Unlocking,0.2,GaussianMechanism,{'Optimal': 40},1094,1113,1104,0,549,1104,1094,564,0,1094,1113,1104,0,549,1104,1094,564,0,poisson-block-composition
2049,sp_workloads,1690805680,wl_small_mem,1308,mixed:GM-LM-RR-LSVT-SGD-PATE-sub25100-defpa,3,dpk-gurobi,block-composition,poisson,equal-ncd,mixed:GM-LM-RR-LSVT-SGD-PATE,sub25100,nopa,Unlocking,0.2,LaplaceMechanism,{'Optimal': 40},1169,1154,1119,0,419,1119,1169,735,0,1169,1154,1119,0,419,1119,1169,735,0,poisson-block-composition
2050,sp_workloads,1690805680,wl_small_mem,1308,mixed:GM-LM-RR-LSVT-SGD-PATE-sub25100-defpa,3,dpk-gurobi,block-composition,poisson,equal-ncd,mixed:GM-LM-RR-LSVT-SGD-PATE,sub25100,nopa,Unlocking,0.2,MLNoisySGDMechanism,{'Optimal': 40},1057,1087,1124,0,548,1124,1057,539,0,1057,1087,1124,0,548,1124,1057,539,0,poisson-block-composition
2051,sp_workloads,1690805680,wl_small_mem,1308,mixed:GM-LM-RR-LSVT-SGD-PATE-sub25100-defpa,3,dpk-gurobi,block-composition,poisson,equal-ncd,mixed:GM-LM-RR-LSVT-SGD-PATE,sub25100,nopa,Unlocking,0.2,MLPateGaussianMechanism,{'Optimal': 40},1114,1105,1168,0,555,1168,1114,550,0,1114,1105,1168,0,555,1168,1114,550,0,poisson-block-composition
2052,sp_workloads,1690805680,wl_small_mem,1308,mixed:GM-LM-RR-LSVT-SGD-PATE-sub25100-defpa,3,dpk-gurobi,block-composition,poisson,equal-ncd,mixed:GM-LM-RR-LSVT-SGD-PATE,sub25100,nopa,Unlocking,0.2,RandResponseMechanism,{'Optimal': 40},1160,1175,1154,0,0,1154,1160,1175,0,1160,1175,1154,0,0,1154,1160,1175,0,poisson-block-composition
2053,sp_workloads,1690805680,wl_small_mem,1308,mixed:GM-LM-RR-LSVT-SGD-PATE-sub25100-defpa,3,dpk-gurobi,block-composition,poisson,equal-ncd,mixed:GM-LM-RR-LSVT-SGD-PATE,sub25100,nopa,Unlocking,0.2,SVTLaplaceMechanism,{'Optimal': 40},1080,1132,1168,0,33,1168,1080,1099,0,1080,1132,1168,0,33,1168,1080,1099,0,poisson-block-composition
2054,sp_workloads,1690805680,wl_small_mem,1309,mixed:GM-LM-RR-LSVT-SGD-PATE-sub25100-defpa,3,dpk-gurobi,block-composition,poisson,equal-ncd,mixed:GM-LM-RR-LSVT-SGD-PATE,sub25100,nopa,Unlocking,0.4,GaussianMechanism,{'Optimal': 40},1094,1113,1104,0,549,1104,1094,564,0,1094,1113,1104,0,549,1104,1094,564,0,poisson-block-composition
2055,sp_workloads,1690805680,wl_small_mem,1309,mixed:GM-LM-RR-LSVT-SGD-PATE-sub25100-defpa,3,dpk-gurobi,block-composition,poisson,equal-ncd,mixed:GM-LM-RR-LSVT-SGD-PATE,sub25100,nopa,Unlocking,0.4,LaplaceMechanism,{'Optimal': 40},1169,1154,1119,0,361,1119,1169,793,0,1169,1154,1119,0,361,1119,1169,793,0,poisson-block-composition
2056,sp_workloads,1690805680,wl_small_mem,1309,mixed:GM-LM-RR-LSVT-SGD-PATE-sub25100-defpa,3,dpk-gurobi,block-composition,poisson,equal-ncd,mixed:GM-LM-RR-LSVT-SGD-PATE,sub25100,nopa,Unlocking,0.4,MLNoisySGDMechanism,{'Optimal': 40},1057,1087,1124,0,437,1124,1057,650,0,1057,1087,1124,0,437,1124,1057,650,0,poisson-block-composition
2057,sp_workloads,1690805680,wl_small_mem,1309,mixed:GM-LM-RR-LSVT-SGD-PATE-sub25100-defpa,3,dpk-gurobi,block-composition,poisson,equal-ncd,mixed:GM-LM-RR-LSVT-SGD-PATE,sub25100,nopa,Unlocking,0.4,MLPateGaussianMechanism,{'Optimal': 40},1114,1105,1168,0,555,1134,1114,550,34,1114,1105,1168,0,555,1134,1114,550,34,poisson-block-composition
2058,sp_workloads,1690805680,wl_small_mem,1309,mixed:GM-LM-RR-LSVT-SGD-PATE-sub25100-defpa,3,dpk-gurobi,block-composition,poisson,equal-ncd,mixed:GM-LM-RR-LSVT-SGD-PATE,sub25100,nopa,Unlocking,0.4,RandResponseMechanism,{'Optimal': 40},1160,1175,1154,0,4,1154,1160,1171,0,1160,1175,1154,0,4,1154,1160,1171,0,poisson-block-composition
2059,sp_workloads,1690805680,wl_small_mem,1309,mixed:GM-LM-RR-LSVT-SGD-PATE-sub25100-defpa,3,dpk-gurobi,block-composition,poisson,equal-ncd,mixed:GM-LM-RR-LSVT-SGD-PATE,sub25100,nopa,Unlocking,0.4,SVTLaplaceMechanism,{'Optimal': 40},1080,1132,1168,0,103,1168,1080,1029,0,1080,1132,1168,0,103,1168,1080,1029,0,poisson-block-composition
2060,sp_workloads,1690805680,wl_small_mem,1310,mixed:GM-LM-RR-LSVT-SGD-PATE-sub25100-defpa,3,dpk-gurobi,block-composition,upc,equal-ncd,mixed:GM-LM-RR-LSVT-SGD-PATE,sub25100,nopa,Unlocking,0.2,GaussianMechanism,{'Optimal': 40},1094,1113,1104,1,245,1104,1093,868,0,1094,1113,1104,1,245,1104,1093,868,0,upc-block-composition
2061,sp_workloads,1690805680,wl_small_mem,1310,mixed:GM-LM-RR-LSVT-SGD-PATE-sub25100-defpa,3,dpk-gurobi,block-composition,upc,equal-ncd,mixed:GM-LM-RR-LSVT-SGD-PATE,sub25100,nopa,Unlocking,0.2,LaplaceMechanism,{'Optimal': 40},1169,1154,1119,0,3,1119,1169,1151,0,1169,1154,1119,0,3,1119,1169,1151,0,upc-block-composition
2062,sp_workloads,1690805680,wl_small_mem,1310,mixed:GM-LM-RR-LSVT-SGD-PATE-sub25100-defpa,3,dpk-gurobi,block-composition,upc,equal-ncd,mixed:GM-LM-RR-LSVT-SGD-PATE,sub25100,nopa,Unlocking,0.2,MLNoisySGDMechanism,{'Optimal': 40},1057,1087,1124,0,512,1124,1057,575,0,1057,1087,1124,0,512,1124,1057,575,0,upc-block-composition
2063,sp_workloads,1690805680,wl_small_mem,1310,mixed:GM-LM-RR-LSVT-SGD-PATE-sub25100-defpa,3,dpk-gurobi,block-composition,upc,equal-ncd,mixed:GM-LM-RR-LSVT-SGD-PATE,sub25100,nopa,Unlocking,0.2,MLPateGaussianMechanism,{'Optimal': 40},1114,1105,1168,0,242,1168,1114,863,0,1114,1105,1168,0,242,1168,1114,863,0,upc-block-composition
2064,sp_workloads,1690805680,wl_small_mem,1310,mixed:GM-LM-RR-LSVT-SGD-PATE-sub25100-defpa,3,dpk-gurobi,block-composition,upc,equal-ncd,mixed:GM-LM-RR-LSVT-SGD-PATE,sub25100,nopa,Unlocking,0.2,RandResponseMechanism,{'Optimal': 40},1160,1175,1154,0,1,1154,1160,1174,0,1160,1175,1154,0,1,1154,1160,1174,0,upc-block-composition
2065,sp_workloads,1690805680,wl_small_mem,1310,mixed:GM-LM-RR-LSVT-SGD-PATE-sub25100-defpa,3,dpk-gurobi,block-composition,upc,equal-ncd,mixed:GM-LM-RR-LSVT-SGD-PATE,sub25100,nopa,Unlocking,0.2,SVTLaplaceMechanism,{'Optimal': 40},1080,1132,1168,0,2,1168,1080,1130,0,1080,1132,1168,0,2,1168,1080,1130,0,upc-block-composition
2066,sp_workloads,1690805680,wl_small_mem,1311,mixed:GM-LM-RR-LSVT-SGD-PATE-sub25100-defpa,3,dpk-gurobi,block-composition,upc,equal-ncd,mixed:GM-LM-RR-LSVT-SGD-PATE,sub25100,nopa,Unlocking,0.4,GaussianMechanism,{'Optimal': 40},1094,1113,1104,0,229,1104,1094,884,0,1094,1113,1104,0,229,1104,1094,884,0,upc-block-composition
2067,sp_workloads,1690805680,wl_small_mem,1311,mixed:GM-LM-RR-LSVT-SGD-PATE-sub25100-defpa,3,dpk-gurobi,block-composition,upc,equal-ncd,mixed:GM-LM-RR-LSVT-SGD-PATE,sub25100,nopa,Unlocking,0.4,LaplaceMechanism,{'Optimal': 40},1169,1154,1119,0,11,1119,1169,1143,0,1169,1154,1119,0,11,1119,1169,1143,0,upc-block-composition
2068,sp_workloads,1690805680,wl_small_mem,1311,mixed:GM-LM-RR-LSVT-SGD-PATE-sub25100-defpa,3,dpk-gurobi,block-composition,upc,equal-ncd,mixed:GM-LM-RR-LSVT-SGD-PATE,sub25100,nopa,Unlocking,0.4,MLNoisySGDMechanism,{'Optimal': 40},1057,1087,1124,2,395,1124,1055,692,0,1057,1087,1124,2,395,1124,1055,692,0,upc-block-composition
2069,sp_workloads,1690805680,wl_small_mem,1311,mixed:GM-LM-RR-LSVT-SGD-PATE-sub25100-defpa,3,dpk-gurobi,block-composition,upc,equal-ncd,mixed:GM-LM-RR-LSVT-SGD-PATE,sub25100,nopa,Unlocking,0.4,MLPateGaussianMechanism,{'Optimal': 40},1114,1105,1168,0,254,1168,1114,851,0,1114,1105,1168,0,254,1168,1114,851,0,upc-block-composition
2070,sp_workloads,1690805680,wl_small_mem,1311,mixed:GM-LM-RR-LSVT-SGD-PATE-sub25100-defpa,3,dpk-gurobi,block-composition,upc,equal-ncd,mixed:GM-LM-RR-LSVT-SGD-PATE,sub25100,nopa,Unlocking,0.4,RandResponseMechanism,{'Optimal': 40},1160,1175,1154,0,14,1154,1160,1161,0,1160,1175,1154,0,14,1154,1160,1161,0,upc-block-composition
2071,sp_workloads,1690805680,wl_small_mem,1311,mixed:GM-LM-RR-LSVT-SGD-PATE-sub25100-defpa,3,dpk-gurobi,block-composition,upc,equal-ncd,mixed:GM-LM-RR-LSVT-SGD-PATE,sub25100,nopa,Unlocking,0.4,SVTLaplaceMechanism,{'Optimal': 40},1080,1132,1168,0,5,1168,1080,1127,0,1080,1132,1168,0,5,1168,1080,1127,0,upc-block-composition
2072,sp_workloads,1690805680,wl_small_mem,1312,mixed:GM-LM-RR-LSVT-SGD-PATE-sub25100-defpa,4,dpk-gurobi,block-composition,poisson,ncd,mixed:GM-LM-RR-LSVT-SGD-PATE,sub25100,nopa,Unlocking,0.2,GaussianMechanism,{'Optimal': 40},3164159,212016,19356,393963,22390,7725,2770196,189626,11631,1113,1088,1060,188,170,515,925,918,545,poisson-block-composition
2073,sp_workloads,1690805680,wl_small_mem,1312,mixed:GM-LM-RR-LSVT-SGD-PATE-sub25100-defpa,4,dpk-gurobi,block-composition,poisson,ncd,mixed:GM-LM-RR-LSVT-SGD-PATE,sub25100,nopa,Unlocking,0.2,LaplaceMechanism,{'Optimal': 40},2854575,215653,19585,0,0,8072,2854575,215653,11513,1062,1115,1087,0,0,536,1062,1115,551,poisson-block-composition
2074,sp_workloads,1690805680,wl_small_mem,1312,mixed:GM-LM-RR-LSVT-SGD-PATE-sub25100-defpa,4,dpk-gurobi,block-composition,poisson,ncd,mixed:GM-LM-RR-LSVT-SGD-PATE,sub25100,nopa,Unlocking,0.2,MLNoisySGDMechanism,{'Optimal': 40},3215801,221736,20277,496719,18503,8846,2719082,203233,11431,1144,1128,1131,242,137,578,902,991,553,poisson-block-composition
2075,sp_workloads,1690805680,wl_small_mem,1312,mixed:GM-LM-RR-LSVT-SGD-PATE-sub25100-defpa,4,dpk-gurobi,block-composition,poisson,ncd,mixed:GM-LM-RR-LSVT-SGD-PATE,sub25100,nopa,Unlocking,0.2,MLPateGaussianMechanism,{'Optimal': 40},3246364,219077,18914,416055,23355,8280,2830309,195722,10634,1154,1099,1070,198,181,552,956,918,518,poisson-block-composition
2076,sp_workloads,1690805680,wl_small_mem,1312,mixed:GM-LM-RR-LSVT-SGD-PATE-sub25100-defpa,4,dpk-gurobi,block-composition,poisson,ncd,mixed:GM-LM-RR-LSVT-SGD-PATE,sub25100,nopa,Unlocking,0.2,RandResponseMechanism,{'Optimal': 40},3086084,218125,20774,0,0,8357,3086084,218125,12417,1149,1123,1162,0,0,555,1149,1123,607,poisson-block-composition
2077,sp_workloads,1690805680,wl_small_mem,1312,mixed:GM-LM-RR-LSVT-SGD-PATE-sub25100-defpa,4,dpk-gurobi,block-composition,poisson,ncd,mixed:GM-LM-RR-LSVT-SGD-PATE,sub25100,nopa,Unlocking,0.2,SVTLaplaceMechanism,{'Optimal': 40},3076541,223346,21123,0,0,8160,3076541,223346,12963,1073,1134,1197,0,0,544,1073,1134,653,poisson-block-composition
2078,sp_workloads,1690805680,wl_small_mem,1313,mixed:GM-LM-RR-LSVT-SGD-PATE-sub25100-defpa,4,dpk-gurobi,block-composition,poisson,ncd,mixed:GM-LM-RR-LSVT-SGD-PATE,sub25100,nopa,Unlocking,0.4,GaussianMechanism,{'Optimal': 40},3164159,212016,19356,365980,24063,7725,2798179,187953,11631,1113,1088,1060,182,193,515,931,895,545,poisson-block-composition
2079,sp_workloads,1690805680,wl_small_mem,1313,mixed:GM-LM-RR-LSVT-SGD-PATE-sub25100-defpa,4,dpk-gurobi,block-composition,poisson,ncd,mixed:GM-LM-RR-LSVT-SGD-PATE,sub25100,nopa,Unlocking,0.4,LaplaceMechanism,{'Optimal': 40},2854575,215653,19585,13412,0,8010,2841163,215653,11575,1062,1115,1087,6,0,534,1056,1115,553,poisson-block-composition
2080,sp_workloads,1690805680,wl_small_mem,1313,mixed:GM-LM-RR-LSVT-SGD-PATE-sub25100-defpa,4,dpk-gurobi,block-composition,poisson,ncd,mixed:GM-LM-RR-LSVT-SGD-PATE,sub25100,nopa,Unlocking,0.4,MLNoisySGDMechanism,{'Optimal': 40},3215801,221736,20277,505891,21574,9081,2709910,200162,11196,1144,1128,1131,251,170,583,893,958,548,poisson-block-composition
2081,sp_workloads,1690805680,wl_small_mem,1313,mixed:GM-LM-RR-LSVT-SGD-PATE-sub25100-defpa,4,dpk-gurobi,block-composition,poisson,ncd,mixed:GM-LM-RR-LSVT-SGD-PATE,sub25100,nopa,Unlocking,0.4,MLPateGaussianMechanism,{'Optimal': 40},3246364,219077,18914,381168,26575,8280,2865196,192502,10634,1154,1099,1070,187,209,552,967,890,518,poisson-block-composition
2082,sp_workloads,1690805680,wl_small_mem,1313,mixed:GM-LM-RR-LSVT-SGD-PATE-sub25100-defpa,4,dpk-gurobi,block-composition,poisson,ncd,mixed:GM-LM-RR-LSVT-SGD-PATE,sub25100,nopa,Unlocking,0.4,RandResponseMechanism,{'Optimal': 40},3086084,218125,20774,0,0,8355,3086084,218125,12419,1149,1123,1162,0,0,557,1149,1123,605,poisson-block-composition
2083,sp_workloads,1690805680,wl_small_mem,1313,mixed:GM-LM-RR-LSVT-SGD-PATE-sub25100-defpa,4,dpk-gurobi,block-composition,poisson,ncd,mixed:GM-LM-RR-LSVT-SGD-PATE,sub25100,nopa,Unlocking,0.4,SVTLaplaceMechanism,{'Optimal': 40},3076541,223346,21123,0,0,8400,3076541,223346,12723,1073,1134,1197,0,0,560,1073,1134,637,poisson-block-composition
2084,sp_workloads,1690805680,wl_small_mem,1314,mixed:GM-LM-RR-LSVT-SGD-PATE-sub25100-defpa,4,dpk-gurobi,block-composition,upc,ncd,mixed:GM-LM-RR-LSVT-SGD-PATE,sub25100,nopa,Unlocking,0.2,GaussianMechanism,{'Optimal': 40},3153220,205905,19356,0,15067,7095,3153220,190838,12261,1113,1088,1060,0,149,473,1113,939,587,upc-block-composition
2085,sp_workloads,1690805680,wl_small_mem,1314,mixed:GM-LM-RR-LSVT-SGD-PATE-sub25100-defpa,4,dpk-gurobi,block-composition,upc,ncd,mixed:GM-LM-RR-LSVT-SGD-PATE,sub25100,nopa,Unlocking,0.2,LaplaceMechanism,{'Optimal': 40},2793843,215187,19457,0,426,7731,2793843,214761,11726,1062,1115,1087,0,6,509,1062,1109,578,upc-block-composition
2086,sp_workloads,1690805680,wl_small_mem,1314,mixed:GM-LM-RR-LSVT-SGD-PATE-sub25100-defpa,4,dpk-gurobi,block-composition,upc,ncd,mixed:GM-LM-RR-LSVT-SGD-PATE,sub25100,nopa,Unlocking,0.2,MLNoisySGDMechanism,{'Optimal': 40},3134809,228778,20357,339501,17468,9192,2795308,211310,11165,1144,1128,1131,113,152,584,1031,976,547,upc-block-composition
2087,sp_workloads,1690805680,wl_small_mem,1314,mixed:GM-LM-RR-LSVT-SGD-PATE-sub25100-defpa,4,dpk-gurobi,block-composition,upc,ncd,mixed:GM-LM-RR-LSVT-SGD-PATE,sub25100,nopa,Unlocking,0.2,MLPateGaussianMechanism,{'Optimal': 40},3244641,218308,19042,2227,12650,7440,3242414,205658,11602,1154,1099,1070,1,134,496,1153,965,574,upc-block-composition
2088,sp_workloads,1690805680,wl_small_mem,1314,mixed:GM-LM-RR-LSVT-SGD-PATE-sub25100-defpa,4,dpk-gurobi,block-composition,upc,ncd,mixed:GM-LM-RR-LSVT-SGD-PATE,sub25100,nopa,Unlocking,0.2,RandResponseMechanism,{'Optimal': 40},3229961,212087,20918,0,316,8146,3229961,211771,12772,1149,1123,1162,0,4,542,1149,1119,620,upc-block-composition
2089,sp_workloads,1690805680,wl_small_mem,1314,mixed:GM-LM-RR-LSVT-SGD-PATE-sub25100-defpa,4,dpk-gurobi,block-composition,upc,ncd,mixed:GM-LM-RR-LSVT-SGD-PATE,sub25100,nopa,Unlocking,0.2,SVTLaplaceMechanism,{'Optimal': 40},3098261,219430,21459,0,871,8820,3098261,218559,12639,1073,1134,1197,0,9,588,1073,1125,609,upc-block-composition
2090,sp_workloads,1690805680,wl_small_mem,1315,mixed:GM-LM-RR-LSVT-SGD-PATE-sub25100-defpa,4,dpk-gurobi,block-composition,upc,ncd,mixed:GM-LM-RR-LSVT-SGD-PATE,sub25100,nopa,Unlocking,0.4,GaussianMechanism,{'Optimal': 40},3153220,205905,19356,0,14699,6735,3153220,191206,12621,1113,1088,1060,0,149,449,1113,939,611,upc-block-composition
2091,sp_workloads,1690805680,wl_small_mem,1315,mixed:GM-LM-RR-LSVT-SGD-PATE-sub25100-defpa,4,dpk-gurobi,block-composition,upc,ncd,mixed:GM-LM-RR-LSVT-SGD-PATE,sub25100,nopa,Unlocking,0.4,LaplaceMechanism,{'Optimal': 40},2793843,215187,19457,0,1726,8069,2793843,213461,11388,1062,1115,1087,0,18,523,1062,1097,564,upc-block-composition
2092,sp_workloads,1690805680,wl_small_mem,1315,mixed:GM-LM-RR-LSVT-SGD-PATE-sub25100-defpa,4,dpk-gurobi,block-composition,upc,ncd,mixed:GM-LM-RR-LSVT-SGD-PATE,sub25100,nopa,Unlocking,0.4,MLNoisySGDMechanism,{'Optimal': 40},3134809,228778,20357,326917,29734,9391,2807892,199044,10966,1144,1128,1131,111,193,593,1033,935,538,upc-block-composition
2093,sp_workloads,1690805680,wl_small_mem,1315,mixed:GM-LM-RR-LSVT-SGD-PATE-sub25100-defpa,4,dpk-gurobi,block-composition,upc,ncd,mixed:GM-LM-RR-LSVT-SGD-PATE,sub25100,nopa,Unlocking,0.4,MLPateGaussianMechanism,{'Optimal': 40},3244641,218308,19042,0,11639,7485,3244641,206669,11557,1154,1099,1070,0,121,499,1154,978,571,upc-block-composition
2094,sp_workloads,1690805680,wl_small_mem,1315,mixed:GM-LM-RR-LSVT-SGD-PATE-sub25100-defpa,4,dpk-gurobi,block-composition,upc,ncd,mixed:GM-LM-RR-LSVT-SGD-PATE,sub25100,nopa,Unlocking,0.4,RandResponseMechanism,{'Optimal': 40},3229961,212087,20918,0,1424,8086,3229961,210663,12832,1149,1123,1162,0,16,538,1149,1107,624,upc-block-composition
2095,sp_workloads,1690805680,wl_small_mem,1315,mixed:GM-LM-RR-LSVT-SGD-PATE-sub25100-defpa,4,dpk-gurobi,block-composition,upc,ncd,mixed:GM-LM-RR-LSVT-SGD-PATE,sub25100,nopa,Unlocking,0.4,SVTLaplaceMechanism,{'Optimal': 40},3098261,219430,21459,0,919,8610,3098261,218511,12849,1073,1134,1197,0,9,574,1073,1125,623,upc-block-composition
2096,sp_workloads,1690805680,wl_small_mem,1316,mixed:GM-LM-RR-LSVT-SGD-PATE-sub25100-defpa,4,dpk-gurobi,block-composition,poisson,equal-ncd,mixed:GM-LM-RR-LSVT-SGD-PATE,sub25100,nopa,Unlocking,0.2,GaussianMechanism,{'Optimal': 40},1113,1088,1060,0,565,1060,1113,523,0,1113,1088,1060,0,565,1060,1113,523,0,poisson-block-composition
2097,sp_workloads,1690805680,wl_small_mem,1316,mixed:GM-LM-RR-LSVT-SGD-PATE-sub25100-defpa,4,dpk-gurobi,block-composition,poisson,equal-ncd,mixed:GM-LM-RR-LSVT-SGD-PATE,sub25100,nopa,Unlocking,0.2,LaplaceMechanism,{'Optimal': 40},1062,1115,1087,0,389,1087,1062,726,0,1062,1115,1087,0,389,1087,1062,726,0,poisson-block-composition
2098,sp_workloads,1690805680,wl_small_mem,1316,mixed:GM-LM-RR-LSVT-SGD-PATE-sub25100-defpa,4,dpk-gurobi,block-composition,poisson,equal-ncd,mixed:GM-LM-RR-LSVT-SGD-PATE,sub25100,nopa,Unlocking,0.2,MLNoisySGDMechanism,{'Optimal': 40},1144,1128,1131,0,575,1131,1144,553,0,1144,1128,1131,0,575,1131,1144,553,0,poisson-block-composition
2099,sp_workloads,1690805680,wl_small_mem,1316,mixed:GM-LM-RR-LSVT-SGD-PATE-sub25100-defpa,4,dpk-gurobi,block-composition,poisson,equal-ncd,mixed:GM-LM-RR-LSVT-SGD-PATE,sub25100,nopa,Unlocking,0.2,MLPateGaussianMechanism,{'Optimal': 40},1154,1099,1070,0,539,1070,1154,560,0,1154,1099,1070,0,539,1070,1154,560,0,poisson-block-composition
2100,sp_workloads,1690805680,wl_small_mem,1316,mixed:GM-LM-RR-LSVT-SGD-PATE-sub25100-defpa,4,dpk-gurobi,block-composition,poisson,equal-ncd,mixed:GM-LM-RR-LSVT-SGD-PATE,sub25100,nopa,Unlocking,0.2,RandResponseMechanism,{'Optimal': 40},1149,1123,1162,0,0,1162,1149,1123,0,1149,1123,1162,0,0,1162,1149,1123,0,poisson-block-composition
2101,sp_workloads,1690805680,wl_small_mem,1316,mixed:GM-LM-RR-LSVT-SGD-PATE-sub25100-defpa,4,dpk-gurobi,block-composition,poisson,equal-ncd,mixed:GM-LM-RR-LSVT-SGD-PATE,sub25100,nopa,Unlocking,0.2,SVTLaplaceMechanism,{'Optimal': 40},1073,1134,1197,0,51,1197,1073,1083,0,1073,1134,1197,0,51,1197,1073,1083,0,poisson-block-composition
2102,sp_workloads,1690805680,wl_small_mem,1317,mixed:GM-LM-RR-LSVT-SGD-PATE-sub25100-defpa,4,dpk-gurobi,block-composition,poisson,equal-ncd,mixed:GM-LM-RR-LSVT-SGD-PATE,sub25100,nopa,Unlocking,0.4,GaussianMechanism,{'Optimal': 40},1113,1088,1060,0,565,1060,1113,523,0,1113,1088,1060,0,565,1060,1113,523,0,poisson-block-composition
2103,sp_workloads,1690805680,wl_small_mem,1317,mixed:GM-LM-RR-LSVT-SGD-PATE-sub25100-defpa,4,dpk-gurobi,block-composition,poisson,equal-ncd,mixed:GM-LM-RR-LSVT-SGD-PATE,sub25100,nopa,Unlocking,0.4,LaplaceMechanism,{'Optimal': 40},1062,1115,1087,0,331,1087,1062,784,0,1062,1115,1087,0,331,1087,1062,784,0,poisson-block-composition
2104,sp_workloads,1690805680,wl_small_mem,1317,mixed:GM-LM-RR-LSVT-SGD-PATE-sub25100-defpa,4,dpk-gurobi,block-composition,poisson,equal-ncd,mixed:GM-LM-RR-LSVT-SGD-PATE,sub25100,nopa,Unlocking,0.4,MLNoisySGDMechanism,{'Optimal': 40},1144,1128,1131,0,435,1131,1144,693,0,1144,1128,1131,0,435,1131,1144,693,0,poisson-block-composition
2105,sp_workloads,1690805680,wl_small_mem,1317,mixed:GM-LM-RR-LSVT-SGD-PATE-sub25100-defpa,4,dpk-gurobi,block-composition,poisson,equal-ncd,mixed:GM-LM-RR-LSVT-SGD-PATE,sub25100,nopa,Unlocking,0.4,MLPateGaussianMechanism,{'Optimal': 40},1154,1099,1070,0,539,1031,1154,560,39,1154,1099,1070,0,539,1031,1154,560,39,poisson-block-composition
2106,sp_workloads,1690805680,wl_small_mem,1317,mixed:GM-LM-RR-LSVT-SGD-PATE-sub25100-defpa,4,dpk-gurobi,block-composition,poisson,equal-ncd,mixed:GM-LM-RR-LSVT-SGD-PATE,sub25100,nopa,Unlocking,0.4,RandResponseMechanism,{'Optimal': 40},1149,1123,1162,0,0,1162,1149,1123,0,1149,1123,1162,0,0,1162,1149,1123,0,poisson-block-composition
2107,sp_workloads,1690805680,wl_small_mem,1317,mixed:GM-LM-RR-LSVT-SGD-PATE-sub25100-defpa,4,dpk-gurobi,block-composition,poisson,equal-ncd,mixed:GM-LM-RR-LSVT-SGD-PATE,sub25100,nopa,Unlocking,0.4,SVTLaplaceMechanism,{'Optimal': 40},1073,1134,1197,0,131,1197,1073,1003,0,1073,1134,1197,0,131,1197,1073,1003,0,poisson-block-composition
2108,sp_workloads,1690805680,wl_small_mem,1318,mixed:GM-LM-RR-LSVT-SGD-PATE-sub25100-defpa,4,dpk-gurobi,block-composition,upc,equal-ncd,mixed:GM-LM-RR-LSVT-SGD-PATE,sub25100,nopa,Unlocking,0.2,GaussianMechanism,{'Optimal': 40},1113,1088,1060,0,257,1060,1113,831,0,1113,1088,1060,0,257,1060,1113,831,0,upc-block-composition
2109,sp_workloads,1690805680,wl_small_mem,1318,mixed:GM-LM-RR-LSVT-SGD-PATE-sub25100-defpa,4,dpk-gurobi,block-composition,upc,equal-ncd,mixed:GM-LM-RR-LSVT-SGD-PATE,sub25100,nopa,Unlocking,0.2,LaplaceMechanism,{'Optimal': 40},1062,1115,1087,0,1,1087,1062,1114,0,1062,1115,1087,0,1,1087,1062,1114,0,upc-block-composition
2110,sp_workloads,1690805680,wl_small_mem,1318,mixed:GM-LM-RR-LSVT-SGD-PATE-sub25100-defpa,4,dpk-gurobi,block-composition,upc,equal-ncd,mixed:GM-LM-RR-LSVT-SGD-PATE,sub25100,nopa,Unlocking,0.2,MLNoisySGDMechanism,{'Optimal': 40},1144,1128,1131,0,524,1131,1144,604,0,1144,1128,1131,0,524,1131,1144,604,0,upc-block-composition
2111,sp_workloads,1690805680,wl_small_mem,1318,mixed:GM-LM-RR-LSVT-SGD-PATE-sub25100-defpa,4,dpk-gurobi,block-composition,upc,equal-ncd,mixed:GM-LM-RR-LSVT-SGD-PATE,sub25100,nopa,Unlocking,0.2,MLPateGaussianMechanism,{'Optimal': 40},1154,1099,1070,1,244,1070,1153,855,0,1154,1099,1070,1,244,1070,1153,855,0,upc-block-composition
2112,sp_workloads,1690805680,wl_small_mem,1318,mixed:GM-LM-RR-LSVT-SGD-PATE-sub25100-defpa,4,dpk-gurobi,block-composition,upc,equal-ncd,mixed:GM-LM-RR-LSVT-SGD-PATE,sub25100,nopa,Unlocking,0.2,RandResponseMechanism,{'Optimal': 40},1149,1123,1162,0,0,1162,1149,1123,0,1149,1123,1162,0,0,1162,1149,1123,0,upc-block-composition
2113,sp_workloads,1690805680,wl_small_mem,1318,mixed:GM-LM-RR-LSVT-SGD-PATE-sub25100-defpa,4,dpk-gurobi,block-composition,upc,equal-ncd,mixed:GM-LM-RR-LSVT-SGD-PATE,sub25100,nopa,Unlocking,0.2,SVTLaplaceMechanism,{'Optimal': 40},1073,1134,1197,0,1,1197,1073,1133,0,1073,1134,1197,0,1,1197,1073,1133,0,upc-block-composition
2114,sp_workloads,1690805680,wl_small_mem,1319,mixed:GM-LM-RR-LSVT-SGD-PATE-sub25100-defpa,4,dpk-gurobi,block-composition,upc,equal-ncd,mixed:GM-LM-RR-LSVT-SGD-PATE,sub25100,nopa,Unlocking,0.4,GaussianMechanism,{'Optimal': 40},1113,1088,1060,0,219,1060,1113,869,0,1113,1088,1060,0,219,1060,1113,869,0,upc-block-composition
2115,sp_workloads,1690805680,wl_small_mem,1319,mixed:GM-LM-RR-LSVT-SGD-PATE-sub25100-defpa,4,dpk-gurobi,block-composition,upc,equal-ncd,mixed:GM-LM-RR-LSVT-SGD-PATE,sub25100,nopa,Unlocking,0.4,LaplaceMechanism,{'Optimal': 40},1062,1115,1087,0,21,1087,1062,1094,0,1062,1115,1087,0,21,1087,1062,1094,0,upc-block-composition
2116,sp_workloads,1690805680,wl_small_mem,1319,mixed:GM-LM-RR-LSVT-SGD-PATE-sub25100-defpa,4,dpk-gurobi,block-composition,upc,equal-ncd,mixed:GM-LM-RR-LSVT-SGD-PATE,sub25100,nopa,Unlocking,0.4,MLNoisySGDMechanism,{'Optimal': 40},1144,1128,1131,1,390,1131,1143,738,0,1144,1128,1131,1,390,1131,1143,738,0,upc-block-composition
2117,sp_workloads,1690805680,wl_small_mem,1319,mixed:GM-LM-RR-LSVT-SGD-PATE-sub25100-defpa,4,dpk-gurobi,block-composition,upc,equal-ncd,mixed:GM-LM-RR-LSVT-SGD-PATE,sub25100,nopa,Unlocking,0.4,MLPateGaussianMechanism,{'Optimal': 40},1154,1099,1070,1,212,1068,1153,887,2,1154,1099,1070,1,212,1068,1153,887,2,upc-block-composition
2118,sp_workloads,1690805680,wl_small_mem,1319,mixed:GM-LM-RR-LSVT-SGD-PATE-sub25100-defpa,4,dpk-gurobi,block-composition,upc,equal-ncd,mixed:GM-LM-RR-LSVT-SGD-PATE,sub25100,nopa,Unlocking,0.4,RandResponseMechanism,{'Optimal': 40},1149,1123,1162,0,13,1162,1149,1110,0,1149,1123,1162,0,13,1162,1149,1110,0,upc-block-composition
2119,sp_workloads,1690805680,wl_small_mem,1319,mixed:GM-LM-RR-LSVT-SGD-PATE-sub25100-defpa,4,dpk-gurobi,block-composition,upc,equal-ncd,mixed:GM-LM-RR-LSVT-SGD-PATE,sub25100,nopa,Unlocking,0.4,SVTLaplaceMechanism,{'Optimal': 40},1073,1134,1197,0,12,1197,1073,1122,0,1073,1134,1197,0,12,1197,1073,1122,0,upc-block-composition
2120,sp_workloads,1690805680,wl_small_mem,1320,basic:GM-LM-RR-LSVT-sub25100-defpa,0,dpk-gurobi,block-composition,poisson,ncd,basic:GM-LM-RR-LSVT,sub25100,nopa,Unlocking,0.2,GaussianMechanism,{'Optimal': 40},4847751,317174,28905,811050,56630,11910,4036701,260544,16995,1760,1618,1607,439,483,794,1321,1135,813,poisson-block-composition
2121,sp_workloads,1690805680,wl_small_mem,1320,basic:GM-LM-RR-LSVT-sub25100-defpa,0,dpk-gurobi,block-composition,poisson,ncd,basic:GM-LM-RR-LSVT,sub25100,nopa,Unlocking,0.2,LaplaceMechanism,{'Optimal': 40},4580618,310999,29482,110887,0,15533,4469731,310999,13949,1690,1679,1654,51,0,931,1639,1679,723,poisson-block-composition
2122,sp_workloads,1690805680,wl_small_mem,1320,basic:GM-LM-RR-LSVT-sub25100-defpa,0,dpk-gurobi,block-composition,poisson,ncd,basic:GM-LM-RR-LSVT,sub25100,nopa,Unlocking,0.2,RandResponseMechanism,{'Optimal': 40},4834309,320190,30099,0,0,13097,4834309,320190,17002,1752,1677,1693,0,0,855,1752,1677,838,poisson-block-composition
2123,sp_workloads,1690805680,wl_small_mem,1320,basic:GM-LM-RR-LSVT-sub25100-defpa,0,dpk-gurobi,block-composition,poisson,ncd,basic:GM-LM-RR-LSVT,sub25100,nopa,Unlocking,0.2,SVTLaplaceMechanism,{'Optimal': 40},4502539,307841,30348,0,0,12675,4502539,307841,17673,1685,1652,1684,0,0,845,1685,1652,839,poisson-block-composition
2124,sp_workloads,1690805680,wl_small_mem,1321,basic:GM-LM-RR-LSVT-sub25100-defpa,0,dpk-gurobi,block-composition,poisson,ncd,basic:GM-LM-RR-LSVT,sub25100,nopa,Unlocking,0.4,GaussianMechanism,{'Optimal': 40},4847751,317174,28905,755405,52778,11910,4092346,264396,16995,1760,1618,1607,404,427,794,1356,1191,813,poisson-block-composition
2125,sp_workloads,1690805680,wl_small_mem,1321,basic:GM-LM-RR-LSVT-sub25100-defpa,0,dpk-gurobi,block-composition,poisson,ncd,basic:GM-LM-RR-LSVT,sub25100,nopa,Unlocking,0.4,LaplaceMechanism,{'Optimal': 40},4580618,310999,29482,147412,0,16091,4433206,310999,13391,1690,1679,1654,68,0,949,1622,1679,705,poisson-block-composition
2126,sp_workloads,1690805680,wl_small_mem,1321,basic:GM-LM-RR-LSVT-sub25100-defpa,0,dpk-gurobi,block-composition,poisson,ncd,basic:GM-LM-RR-LSVT,sub25100,nopa,Unlocking,0.4,RandResponseMechanism,{'Optimal': 40},4834309,320190,30099,0,0,13748,4834309,320190,16351,1752,1677,1693,0,0,876,1752,1677,817,poisson-block-composition
2127,sp_workloads,1690805680,wl_small_mem,1321,basic:GM-LM-RR-LSVT-sub25100-defpa,0,dpk-gurobi,block-composition,poisson,ncd,basic:GM-LM-RR-LSVT,sub25100,nopa,Unlocking,0.4,SVTLaplaceMechanism,{'Optimal': 40},4502539,307841,30348,0,0,12830,4502539,307841,17518,1685,1652,1684,0,0,850,1685,1652,834,poisson-block-composition
2128,sp_workloads,1690805680,wl_small_mem,1322,basic:GM-LM-RR-LSVT-sub25100-defpa,0,dpk-gurobi,block-composition,upc,ncd,basic:GM-LM-RR-LSVT,sub25100,nopa,Unlocking,0.2,GaussianMechanism,{'Optimal': 40},4839540,325950,29705,84338,47367,11025,4755202,278583,18680,1760,1618,1607,40,270,735,1720,1348,872,upc-block-composition
2129,sp_workloads,1690805680,wl_small_mem,1322,basic:GM-LM-RR-LSVT-sub25100-defpa,0,dpk-gurobi,block-composition,upc,ncd,basic:GM-LM-RR-LSVT,sub25100,nopa,Unlocking,0.2,LaplaceMechanism,{'Optimal': 40},4568749,317398,30234,6514,2861,16060,4562235,314537,14174,1690,1679,1654,3,29,932,1687,1650,722,upc-block-composition
2130,sp_workloads,1690805680,wl_small_mem,1322,basic:GM-LM-RR-LSVT-sub25100-defpa,0,dpk-gurobi,block-composition,upc,ncd,basic:GM-LM-RR-LSVT,sub25100,nopa,Unlocking,0.2,RandResponseMechanism,{'Optimal': 40},4657750,323549,30931,16852,3648,12274,4640898,319901,18657,1752,1677,1693,8,30,814,1744,1647,879,upc-block-composition
2131,sp_workloads,1690805680,wl_small_mem,1322,basic:GM-LM-RR-LSVT-sub25100-defpa,0,dpk-gurobi,block-composition,upc,ncd,basic:GM-LM-RR-LSVT,sub25100,nopa,Unlocking,0.2,SVTLaplaceMechanism,{'Optimal': 40},4659614,324927,30284,8198,3127,12345,4651416,321800,17939,1685,1652,1684,4,32,823,1681,1620,861,upc-block-composition
2132,sp_workloads,1690805680,wl_small_mem,1323,basic:GM-LM-RR-LSVT-sub25100-defpa,0,dpk-gurobi,block-composition,upc,ncd,basic:GM-LM-RR-LSVT,sub25100,nopa,Unlocking,0.4,GaussianMechanism,{'Optimal': 40},4839540,325950,29705,80922,96101,11700,4758618,229849,18005,1760,1618,1607,38,427,780,1722,1191,827,upc-block-composition
2133,sp_workloads,1690805680,wl_small_mem,1323,basic:GM-LM-RR-LSVT-sub25100-defpa,0,dpk-gurobi,block-composition,upc,ncd,basic:GM-LM-RR-LSVT,sub25100,nopa,Unlocking,0.4,LaplaceMechanism,{'Optimal': 40},4568749,317398,30234,2895,2345,17827,4565854,315053,12407,1690,1679,1654,2,24,1005,1688,1655,649,upc-block-composition
2134,sp_workloads,1690805680,wl_small_mem,1323,basic:GM-LM-RR-LSVT-sub25100-defpa,0,dpk-gurobi,block-composition,upc,ncd,basic:GM-LM-RR-LSVT,sub25100,nopa,Unlocking,0.4,RandResponseMechanism,{'Optimal': 40},4657750,323549,30931,8591,2174,13624,4649159,321375,17307,1752,1677,1693,4,21,872,1748,1656,821,upc-block-composition
2135,sp_workloads,1690805680,wl_small_mem,1323,basic:GM-LM-RR-LSVT-sub25100-defpa,0,dpk-gurobi,block-composition,upc,ncd,basic:GM-LM-RR-LSVT,sub25100,nopa,Unlocking,0.4,SVTLaplaceMechanism,{'Optimal': 40},4659614,324927,30284,6404,2237,12830,4653210,322690,17454,1685,1652,1684,3,19,850,1682,1633,834,upc-block-composition
2136,sp_workloads,1690805680,wl_small_mem,1324,basic:GM-LM-RR-LSVT-sub25100-defpa,0,dpk-gurobi,block-composition,poisson,equal-ncd,basic:GM-LM-RR-LSVT,sub25100,nopa,Unlocking,0.2,GaussianMechanism,{'Optimal': 40},1760,1618,1607,0,776,1607,1760,842,0,1760,1618,1607,0,776,1607,1760,842,0,poisson-block-composition
2137,sp_workloads,1690805680,wl_small_mem,1324,basic:GM-LM-RR-LSVT-sub25100-defpa,0,dpk-gurobi,block-composition,poisson,equal-ncd,basic:GM-LM-RR-LSVT,sub25100,nopa,Unlocking,0.2,LaplaceMechanism,{'Optimal': 40},1690,1679,1654,0,614,1654,1690,1065,0,1690,1679,1654,0,614,1654,1690,1065,0,poisson-block-composition
2138,sp_workloads,1690805680,wl_small_mem,1324,basic:GM-LM-RR-LSVT-sub25100-defpa,0,dpk-gurobi,block-composition,poisson,equal-ncd,basic:GM-LM-RR-LSVT,sub25100,nopa,Unlocking,0.2,RandResponseMechanism,{'Optimal': 40},1752,1677,1693,0,0,1693,1752,1677,0,1752,1677,1693,0,0,1693,1752,1677,0,poisson-block-composition
2139,sp_workloads,1690805680,wl_small_mem,1324,basic:GM-LM-RR-LSVT-sub25100-defpa,0,dpk-gurobi,block-composition,poisson,equal-ncd,basic:GM-LM-RR-LSVT,sub25100,nopa,Unlocking,0.2,SVTLaplaceMechanism,{'Optimal': 40},1685,1652,1684,0,17,1684,1685,1635,0,1685,1652,1684,0,17,1684,1685,1635,0,poisson-block-composition
2140,sp_workloads,1690805680,wl_small_mem,1325,basic:GM-LM-RR-LSVT-sub25100-defpa,0,dpk-gurobi,block-composition,poisson,equal-ncd,basic:GM-LM-RR-LSVT,sub25100,nopa,Unlocking,0.4,GaussianMechanism,{'Optimal': 40},1760,1618,1607,0,776,1599,1760,842,8,1760,1618,1607,0,776,1599,1760,842,8,poisson-block-composition
2141,sp_workloads,1690805680,wl_small_mem,1325,basic:GM-LM-RR-LSVT-sub25100-defpa,0,dpk-gurobi,block-composition,poisson,equal-ncd,basic:GM-LM-RR-LSVT,sub25100,nopa,Unlocking,0.4,LaplaceMechanism,{'Optimal': 40},1690,1679,1654,0,549,1654,1690,1130,0,1690,1679,1654,0,549,1654,1690,1130,0,poisson-block-composition
2142,sp_workloads,1690805680,wl_small_mem,1325,basic:GM-LM-RR-LSVT-sub25100-defpa,0,dpk-gurobi,block-composition,poisson,equal-ncd,basic:GM-LM-RR-LSVT,sub25100,nopa,Unlocking,0.4,RandResponseMechanism,{'Optimal': 40},1752,1677,1693,0,0,1693,1752,1677,0,1752,1677,1693,0,0,1693,1752,1677,0,poisson-block-composition
2143,sp_workloads,1690805680,wl_small_mem,1325,basic:GM-LM-RR-LSVT-sub25100-defpa,0,dpk-gurobi,block-composition,poisson,equal-ncd,basic:GM-LM-RR-LSVT,sub25100,nopa,Unlocking,0.4,SVTLaplaceMechanism,{'Optimal': 40},1685,1652,1684,0,76,1684,1685,1576,0,1685,1652,1684,0,76,1684,1685,1576,0,poisson-block-composition
2144,sp_workloads,1690805680,wl_small_mem,1326,basic:GM-LM-RR-LSVT-sub25100-defpa,0,dpk-gurobi,block-composition,upc,equal-ncd,basic:GM-LM-RR-LSVT,sub25100,nopa,Unlocking,0.2,GaussianMechanism,{'Optimal': 40},1760,1618,1607,0,676,1607,1760,942,0,1760,1618,1607,0,676,1607,1760,942,0,upc-block-composition
2145,sp_workloads,1690805680,wl_small_mem,1326,basic:GM-LM-RR-LSVT-sub25100-defpa,0,dpk-gurobi,block-composition,upc,equal-ncd,basic:GM-LM-RR-LSVT,sub25100,nopa,Unlocking,0.2,LaplaceMechanism,{'Optimal': 40},1690,1679,1654,0,18,1654,1690,1661,0,1690,1679,1654,0,18,1654,1690,1661,0,upc-block-composition
2146,sp_workloads,1690805680,wl_small_mem,1326,basic:GM-LM-RR-LSVT-sub25100-defpa,0,dpk-gurobi,block-composition,upc,equal-ncd,basic:GM-LM-RR-LSVT,sub25100,nopa,Unlocking,0.2,RandResponseMechanism,{'Optimal': 40},1752,1677,1693,0,14,1693,1752,1663,0,1752,1677,1693,0,14,1693,1752,1663,0,upc-block-composition
2147,sp_workloads,1690805680,wl_small_mem,1326,basic:GM-LM-RR-LSVT-sub25100-defpa,0,dpk-gurobi,block-composition,upc,equal-ncd,basic:GM-LM-RR-LSVT,sub25100,nopa,Unlocking,0.2,SVTLaplaceMechanism,{'Optimal': 40},1685,1652,1684,1,12,1684,1684,1640,0,1685,1652,1684,1,12,1684,1684,1640,0,upc-block-composition
2148,sp_workloads,1690805680,wl_small_mem,1327,basic:GM-LM-RR-LSVT-sub25100-defpa,0,dpk-gurobi,block-composition,upc,equal-ncd,basic:GM-LM-RR-LSVT,sub25100,nopa,Unlocking,0.4,GaussianMechanism,{'Optimal': 40},1760,1618,1607,0,497,1607,1760,1121,0,1760,1618,1607,0,497,1607,1760,1121,0,upc-block-composition
2149,sp_workloads,1690805680,wl_small_mem,1327,basic:GM-LM-RR-LSVT-sub25100-defpa,0,dpk-gurobi,block-composition,upc,equal-ncd,basic:GM-LM-RR-LSVT,sub25100,nopa,Unlocking,0.4,LaplaceMechanism,{'Optimal': 40},1690,1679,1654,0,37,1654,1690,1642,0,1690,1679,1654,0,37,1654,1690,1642,0,upc-block-composition
2150,sp_workloads,1690805680,wl_small_mem,1327,basic:GM-LM-RR-LSVT-sub25100-defpa,0,dpk-gurobi,block-composition,upc,equal-ncd,basic:GM-LM-RR-LSVT,sub25100,nopa,Unlocking,0.4,RandResponseMechanism,{'Optimal': 40},1752,1677,1693,1,29,1693,1751,1648,0,1752,1677,1693,1,29,1693,1751,1648,0,upc-block-composition
2151,sp_workloads,1690805680,wl_small_mem,1327,basic:GM-LM-RR-LSVT-sub25100-defpa,0,dpk-gurobi,block-composition,upc,equal-ncd,basic:GM-LM-RR-LSVT,sub25100,nopa,Unlocking,0.4,SVTLaplaceMechanism,{'Optimal': 40},1685,1652,1684,0,29,1684,1685,1623,0,1685,1652,1684,0,29,1684,1685,1623,0,upc-block-composition
2152,sp_workloads,1690805680,wl_small_mem,1328,basic:GM-LM-RR-LSVT-sub25100-defpa,1,dpk-gurobi,block-composition,poisson,ncd,basic:GM-LM-RR-LSVT,sub25100,nopa,Unlocking,0.2,GaussianMechanism,{'Optimal': 40},4674135,351804,29818,888232,60586,12900,3785903,291218,16918,1725,1745,1670,476,507,860,1249,1238,810,poisson-block-composition
2153,sp_workloads,1690805680,wl_small_mem,1328,basic:GM-LM-RR-LSVT-sub25100-defpa,1,dpk-gurobi,block-composition,poisson,ncd,basic:GM-LM-RR-LSVT,sub25100,nopa,Unlocking,0.2,LaplaceMechanism,{'Optimal': 40},4701336,316959,30901,74260,0,16255,4627076,316959,14646,1705,1659,1707,34,0,945,1671,1659,762,poisson-block-composition
2154,sp_workloads,1690805680,wl_small_mem,1328,basic:GM-LM-RR-LSVT-sub25100-defpa,1,dpk-gurobi,block-composition,poisson,ncd,basic:GM-LM-RR-LSVT,sub25100,nopa,Unlocking,0.2,RandResponseMechanism,{'Optimal': 40},4751311,334074,30363,0,0,12922,4751311,334074,17441,1634,1678,1701,0,0,854,1634,1678,847,poisson-block-composition
2155,sp_workloads,1690805680,wl_small_mem,1328,basic:GM-LM-RR-LSVT-sub25100-defpa,1,dpk-gurobi,block-composition,poisson,ncd,basic:GM-LM-RR-LSVT,sub25100,nopa,Unlocking,0.2,SVTLaplaceMechanism,{'Optimal': 40},4658717,301226,29963,0,0,12135,4658717,301226,17828,1700,1628,1669,0,0,809,1700,1628,860,poisson-block-composition
2156,sp_workloads,1690805680,wl_small_mem,1329,basic:GM-LM-RR-LSVT-sub25100-defpa,1,dpk-gurobi,block-composition,poisson,ncd,basic:GM-LM-RR-LSVT,sub25100,nopa,Unlocking,0.4,GaussianMechanism,{'Optimal': 40},4674135,351804,29818,839115,51372,12900,3835020,300432,16918,1725,1745,1670,446,444,860,1279,1301,810,poisson-block-composition
2157,sp_workloads,1690805680,wl_small_mem,1329,basic:GM-LM-RR-LSVT-sub25100-defpa,1,dpk-gurobi,block-composition,poisson,ncd,basic:GM-LM-RR-LSVT,sub25100,nopa,Unlocking,0.4,LaplaceMechanism,{'Optimal': 40},4701336,316959,30901,119290,0,15325,4582046,316959,15576,1705,1659,1707,55,0,915,1650,1659,792,poisson-block-composition
2158,sp_workloads,1690805680,wl_small_mem,1329,basic:GM-LM-RR-LSVT-sub25100-defpa,1,dpk-gurobi,block-composition,poisson,ncd,basic:GM-LM-RR-LSVT,sub25100,nopa,Unlocking,0.4,RandResponseMechanism,{'Optimal': 40},4751311,334074,30363,0,0,13201,4751311,334074,17162,1634,1678,1701,0,0,863,1634,1678,838,poisson-block-composition
2159,sp_workloads,1690805680,wl_small_mem,1329,basic:GM-LM-RR-LSVT-sub25100-defpa,1,dpk-gurobi,block-composition,poisson,ncd,basic:GM-LM-RR-LSVT,sub25100,nopa,Unlocking,0.4,SVTLaplaceMechanism,{'Optimal': 40},4658717,301226,29963,0,0,12122,4658717,301226,17841,1700,1628,1669,0,0,806,1700,1628,863,poisson-block-composition
2160,sp_workloads,1690805680,wl_small_mem,1330,basic:GM-LM-RR-LSVT-sub25100-defpa,1,dpk-gurobi,block-composition,upc,ncd,basic:GM-LM-RR-LSVT,sub25100,nopa,Unlocking,0.2,GaussianMechanism,{'Optimal': 40},4676698,329662,29265,82312,51871,12450,4594386,277791,16815,1725,1745,1670,39,331,824,1686,1414,846,upc-block-composition
2161,sp_workloads,1690805680,wl_small_mem,1330,basic:GM-LM-RR-LSVT-sub25100-defpa,1,dpk-gurobi,block-composition,upc,ncd,basic:GM-LM-RR-LSVT,sub25100,nopa,Unlocking,0.2,LaplaceMechanism,{'Optimal': 40},4681859,300972,30705,12598,3499,15060,4669261,297473,15645,1705,1659,1707,6,38,913,1699,1621,794,upc-block-composition
2162,sp_workloads,1690805680,wl_small_mem,1330,basic:GM-LM-RR-LSVT-sub25100-defpa,1,dpk-gurobi,block-composition,upc,ncd,basic:GM-LM-RR-LSVT,sub25100,nopa,Unlocking,0.2,RandResponseMechanism,{'Optimal': 40},4647322,315319,30810,6246,2649,13200,4641076,312670,17610,1634,1678,1701,3,22,855,1631,1656,846,upc-block-composition
2163,sp_workloads,1690805680,wl_small_mem,1330,basic:GM-LM-RR-LSVT-sub25100-defpa,1,dpk-gurobi,block-composition,upc,ncd,basic:GM-LM-RR-LSVT,sub25100,nopa,Unlocking,0.2,SVTLaplaceMechanism,{'Optimal': 40},4823541,315411,30210,4316,3425,12090,4819225,311986,18120,1700,1628,1669,3,28,798,1697,1600,871,upc-block-composition
2164,sp_workloads,1690805680,wl_small_mem,1331,basic:GM-LM-RR-LSVT-sub25100-defpa,1,dpk-gurobi,block-composition,upc,ncd,basic:GM-LM-RR-LSVT,sub25100,nopa,Unlocking,0.4,GaussianMechanism,{'Optimal': 40},4676698,329662,29265,69652,88679,12780,4607046,240983,16485,1725,1745,1670,34,447,852,1691,1298,818,upc-block-composition
2165,sp_workloads,1690805680,wl_small_mem,1331,basic:GM-LM-RR-LSVT-sub25100-defpa,1,dpk-gurobi,block-composition,upc,ncd,basic:GM-LM-RR-LSVT,sub25100,nopa,Unlocking,0.4,LaplaceMechanism,{'Optimal': 40},4681859,300972,30705,3872,2083,16875,4677987,298889,13830,1705,1659,1707,3,22,968,1702,1637,739,upc-block-composition
2166,sp_workloads,1690805680,wl_small_mem,1331,basic:GM-LM-RR-LSVT-sub25100-defpa,1,dpk-gurobi,block-composition,upc,ncd,basic:GM-LM-RR-LSVT,sub25100,nopa,Unlocking,0.4,RandResponseMechanism,{'Optimal': 40},4647322,315319,30810,6108,2906,13215,4641214,312413,17595,1634,1678,1701,3,28,861,1631,1650,840,upc-block-composition
2167,sp_workloads,1690805680,wl_small_mem,1331,basic:GM-LM-RR-LSVT-sub25100-defpa,1,dpk-gurobi,block-composition,upc,ncd,basic:GM-LM-RR-LSVT,sub25100,nopa,Unlocking,0.4,SVTLaplaceMechanism,{'Optimal': 40},4823541,315411,30210,14589,1764,12150,4808952,313647,18060,1700,1628,1669,7,20,809,1693,1608,860,upc-block-composition
2168,sp_workloads,1690805680,wl_small_mem,1332,basic:GM-LM-RR-LSVT-sub25100-defpa,1,dpk-gurobi,block-composition,poisson,equal-ncd,basic:GM-LM-RR-LSVT,sub25100,nopa,Unlocking,0.2,GaussianMechanism,{'Optimal': 40},1725,1745,1670,0,861,1670,1725,884,0,1725,1745,1670,0,861,1670,1725,884,0,poisson-block-composition
2169,sp_workloads,1690805680,wl_small_mem,1332,basic:GM-LM-RR-LSVT-sub25100-defpa,1,dpk-gurobi,block-composition,poisson,equal-ncd,basic:GM-LM-RR-LSVT,sub25100,nopa,Unlocking,0.2,LaplaceMechanism,{'Optimal': 40},1705,1659,1707,0,568,1707,1705,1091,0,1705,1659,1707,0,568,1707,1705,1091,0,poisson-block-composition
2170,sp_workloads,1690805680,wl_small_mem,1332,basic:GM-LM-RR-LSVT-sub25100-defpa,1,dpk-gurobi,block-composition,poisson,equal-ncd,basic:GM-LM-RR-LSVT,sub25100,nopa,Unlocking,0.2,RandResponseMechanism,{'Optimal': 40},1634,1678,1701,0,0,1701,1634,1678,0,1634,1678,1701,0,0,1701,1634,1678,0,poisson-block-composition
2171,sp_workloads,1690805680,wl_small_mem,1332,basic:GM-LM-RR-LSVT-sub25100-defpa,1,dpk-gurobi,block-composition,poisson,equal-ncd,basic:GM-LM-RR-LSVT,sub25100,nopa,Unlocking,0.2,SVTLaplaceMechanism,{'Optimal': 40},1700,1628,1669,0,27,1669,1700,1601,0,1700,1628,1669,0,27,1669,1700,1601,0,poisson-block-composition
2172,sp_workloads,1690805680,wl_small_mem,1333,basic:GM-LM-RR-LSVT-sub25100-defpa,1,dpk-gurobi,block-composition,poisson,equal-ncd,basic:GM-LM-RR-LSVT,sub25100,nopa,Unlocking,0.4,GaussianMechanism,{'Optimal': 40},1725,1745,1670,0,861,1641,1725,884,29,1725,1745,1670,0,861,1641,1725,884,29,poisson-block-composition
2173,sp_workloads,1690805680,wl_small_mem,1333,basic:GM-LM-RR-LSVT-sub25100-defpa,1,dpk-gurobi,block-composition,poisson,equal-ncd,basic:GM-LM-RR-LSVT,sub25100,nopa,Unlocking,0.4,LaplaceMechanism,{'Optimal': 40},1705,1659,1707,0,497,1707,1705,1162,0,1705,1659,1707,0,497,1707,1705,1162,0,poisson-block-composition
2174,sp_workloads,1690805680,wl_small_mem,1333,basic:GM-LM-RR-LSVT-sub25100-defpa,1,dpk-gurobi,block-composition,poisson,equal-ncd,basic:GM-LM-RR-LSVT,sub25100,nopa,Unlocking,0.4,RandResponseMechanism,{'Optimal': 40},1634,1678,1701,0,0,1701,1634,1678,0,1634,1678,1701,0,0,1701,1634,1678,0,poisson-block-composition
2175,sp_workloads,1690805680,wl_small_mem,1333,basic:GM-LM-RR-LSVT-sub25100-defpa,1,dpk-gurobi,block-composition,poisson,equal-ncd,basic:GM-LM-RR-LSVT,sub25100,nopa,Unlocking,0.4,SVTLaplaceMechanism,{'Optimal': 40},1700,1628,1669,0,94,1669,1700,1534,0,1700,1628,1669,0,94,1669,1700,1534,0,poisson-block-composition
2176,sp_workloads,1690805680,wl_small_mem,1334,basic:GM-LM-RR-LSVT-sub25100-defpa,1,dpk-gurobi,block-composition,upc,equal-ncd,basic:GM-LM-RR-LSVT,sub25100,nopa,Unlocking,0.2,GaussianMechanism,{'Optimal': 40},1725,1745,1670,0,720,1670,1725,1025,0,1725,1745,1670,0,720,1670,1725,1025,0,upc-block-composition
2177,sp_workloads,1690805680,wl_small_mem,1334,basic:GM-LM-RR-LSVT-sub25100-defpa,1,dpk-gurobi,block-composition,upc,equal-ncd,basic:GM-LM-RR-LSVT,sub25100,nopa,Unlocking,0.2,LaplaceMechanism,{'Optimal': 40},1705,1659,1707,0,15,1707,1705,1644,0,1705,1659,1707,0,15,1707,1705,1644,0,upc-block-composition
2178,sp_workloads,1690805680,wl_small_mem,1334,basic:GM-LM-RR-LSVT-sub25100-defpa,1,dpk-gurobi,block-composition,upc,equal-ncd,basic:GM-LM-RR-LSVT,sub25100,nopa,Unlocking,0.2,RandResponseMechanism,{'Optimal': 40},1634,1678,1701,0,12,1701,1634,1666,0,1634,1678,1701,0,12,1701,1634,1666,0,upc-block-composition
2179,sp_workloads,1690805680,wl_small_mem,1334,basic:GM-LM-RR-LSVT-sub25100-defpa,1,dpk-gurobi,block-composition,upc,equal-ncd,basic:GM-LM-RR-LSVT,sub25100,nopa,Unlocking,0.2,SVTLaplaceMechanism,{'Optimal': 40},1700,1628,1669,0,11,1669,1700,1617,0,1700,1628,1669,0,11,1669,1700,1617,0,upc-block-composition
2180,sp_workloads,1690805680,wl_small_mem,1335,basic:GM-LM-RR-LSVT-sub25100-defpa,1,dpk-gurobi,block-composition,upc,equal-ncd,basic:GM-LM-RR-LSVT,sub25100,nopa,Unlocking,0.4,GaussianMechanism,{'Optimal': 40},1725,1745,1670,0,520,1652,1725,1225,18,1725,1745,1670,0,520,1652,1725,1225,18,upc-block-composition
2181,sp_workloads,1690805680,wl_small_mem,1335,basic:GM-LM-RR-LSVT-sub25100-defpa,1,dpk-gurobi,block-composition,upc,equal-ncd,basic:GM-LM-RR-LSVT,sub25100,nopa,Unlocking,0.4,LaplaceMechanism,{'Optimal': 40},1705,1659,1707,0,44,1707,1705,1615,0,1705,1659,1707,0,44,1707,1705,1615,0,upc-block-composition
2182,sp_workloads,1690805680,wl_small_mem,1335,basic:GM-LM-RR-LSVT-sub25100-defpa,1,dpk-gurobi,block-composition,upc,equal-ncd,basic:GM-LM-RR-LSVT,sub25100,nopa,Unlocking,0.4,RandResponseMechanism,{'Optimal': 40},1634,1678,1701,0,20,1701,1634,1658,0,1634,1678,1701,0,20,1701,1634,1658,0,upc-block-composition
2183,sp_workloads,1690805680,wl_small_mem,1335,basic:GM-LM-RR-LSVT-sub25100-defpa,1,dpk-gurobi,block-composition,upc,equal-ncd,basic:GM-LM-RR-LSVT,sub25100,nopa,Unlocking,0.4,SVTLaplaceMechanism,{'Optimal': 40},1700,1628,1669,1,21,1669,1699,1607,0,1700,1628,1669,1,21,1669,1699,1607,0,upc-block-composition
2184,sp_workloads,1690805680,wl_small_mem,1336,basic:GM-LM-RR-LSVT-sub25100-defpa,2,dpk-gurobi,block-composition,poisson,ncd,basic:GM-LM-RR-LSVT,sub25100,nopa,Unlocking,0.2,GaussianMechanism,{'Optimal': 40},4344073,336565,33248,795031,60277,13536,3549042,276288,19712,1647,1671,1731,418,502,846,1229,1169,885,poisson-block-composition
2185,sp_workloads,1690805680,wl_small_mem,1336,basic:GM-LM-RR-LSVT-sub25100-defpa,2,dpk-gurobi,block-composition,poisson,ncd,basic:GM-LM-RR-LSVT,sub25100,nopa,Unlocking,0.2,LaplaceMechanism,{'Optimal': 40},4548967,333299,30800,128096,0,16640,4420871,333299,14160,1660,1661,1646,57,0,926,1603,1661,720,poisson-block-composition
2186,sp_workloads,1690805680,wl_small_mem,1336,basic:GM-LM-RR-LSVT-sub25100-defpa,2,dpk-gurobi,block-composition,poisson,ncd,basic:GM-LM-RR-LSVT,sub25100,nopa,Unlocking,0.2,RandResponseMechanism,{'Optimal': 40},5016525,328891,32448,0,0,15104,5016525,328891,17344,1714,1690,1723,0,0,917,1714,1690,806,poisson-block-composition
2187,sp_workloads,1690805680,wl_small_mem,1336,basic:GM-LM-RR-LSVT-sub25100-defpa,2,dpk-gurobi,block-composition,poisson,ncd,basic:GM-LM-RR-LSVT,sub25100,nopa,Unlocking,0.2,SVTLaplaceMechanism,{'Optimal': 40},4781610,327880,32576,0,0,13584,4781610,327880,18992,1631,1679,1700,0,0,849,1631,1679,851,poisson-block-composition
2188,sp_workloads,1690805680,wl_small_mem,1337,basic:GM-LM-RR-LSVT-sub25100-defpa,2,dpk-gurobi,block-composition,poisson,ncd,basic:GM-LM-RR-LSVT,sub25100,nopa,Unlocking,0.4,GaussianMechanism,{'Optimal': 40},4344073,336565,33248,752983,54877,13536,3591090,281688,19712,1647,1671,1731,393,463,846,1254,1208,885,poisson-block-composition
2189,sp_workloads,1690805680,wl_small_mem,1337,basic:GM-LM-RR-LSVT-sub25100-defpa,2,dpk-gurobi,block-composition,poisson,ncd,basic:GM-LM-RR-LSVT,sub25100,nopa,Unlocking,0.4,LaplaceMechanism,{'Optimal': 40},4548967,333299,30800,165130,0,16224,4383837,333299,14576,1660,1661,1646,74,0,913,1586,1661,733,poisson-block-composition
2190,sp_workloads,1690805680,wl_small_mem,1337,basic:GM-LM-RR-LSVT-sub25100-defpa,2,dpk-gurobi,block-composition,poisson,ncd,basic:GM-LM-RR-LSVT,sub25100,nopa,Unlocking,0.4,RandResponseMechanism,{'Optimal': 40},5016525,328891,32448,0,0,15040,5016525,328891,17408,1714,1690,1723,0,0,915,1714,1690,808,poisson-block-composition
2191,sp_workloads,1690805680,wl_small_mem,1337,basic:GM-LM-RR-LSVT-sub25100-defpa,2,dpk-gurobi,block-composition,poisson,ncd,basic:GM-LM-RR-LSVT,sub25100,nopa,Unlocking,0.4,SVTLaplaceMechanism,{'Optimal': 40},4781610,327880,32576,0,0,13552,4781610,327880,19024,1631,1679,1700,0,0,847,1631,1679,853,poisson-block-composition
2192,sp_workloads,1690805680,wl_small_mem,1338,basic:GM-LM-RR-LSVT-sub25100-defpa,2,dpk-gurobi,block-composition,upc,ncd,basic:GM-LM-RR-LSVT,sub25100,nopa,Unlocking,0.2,GaussianMechanism,{'Optimal': 40},4516798,323421,31309,91133,63580,12578,4425665,259841,18731,1647,1671,1731,42,342,830,1605,1329,901,upc-block-composition
2193,sp_workloads,1690805680,wl_small_mem,1338,basic:GM-LM-RR-LSVT-sub25100-defpa,2,dpk-gurobi,block-composition,upc,ncd,basic:GM-LM-RR-LSVT,sub25100,nopa,Unlocking,0.2,LaplaceMechanism,{'Optimal': 40},4830469,312603,29634,4403,3202,16341,4826066,309401,13293,1660,1661,1646,2,30,939,1658,1631,707,upc-block-composition
2194,sp_workloads,1690805680,wl_small_mem,1338,basic:GM-LM-RR-LSVT-sub25100-defpa,2,dpk-gurobi,block-composition,upc,ncd,basic:GM-LM-RR-LSVT,sub25100,nopa,Unlocking,0.2,RandResponseMechanism,{'Optimal': 40},4802902,316035,30613,5817,3125,14100,4797085,312910,16513,1714,1690,1723,3,27,908,1711,1663,815,upc-block-composition
2195,sp_workloads,1690805680,wl_small_mem,1338,basic:GM-LM-RR-LSVT-sub25100-defpa,2,dpk-gurobi,block-composition,upc,ncd,basic:GM-LM-RR-LSVT,sub25100,nopa,Unlocking,0.2,SVTLaplaceMechanism,{'Optimal': 40},4594159,320873,30876,8328,2361,13007,4585831,318512,17869,1631,1679,1700,4,23,849,1627,1656,851,upc-block-composition
2196,sp_workloads,1690805680,wl_small_mem,1339,basic:GM-LM-RR-LSVT-sub25100-defpa,2,dpk-gurobi,block-composition,upc,ncd,basic:GM-LM-RR-LSVT,sub25100,nopa,Unlocking,0.4,GaussianMechanism,{'Optimal': 40},4516798,323421,31309,65226,105015,12510,4451572,218406,18799,1647,1671,1731,30,486,834,1617,1185,897,upc-block-composition
2197,sp_workloads,1690805680,wl_small_mem,1339,basic:GM-LM-RR-LSVT-sub25100-defpa,2,dpk-gurobi,block-composition,upc,ncd,basic:GM-LM-RR-LSVT,sub25100,nopa,Unlocking,0.4,LaplaceMechanism,{'Optimal': 40},4830469,312603,29634,10759,2795,16644,4819710,309808,12990,1660,1661,1646,5,21,956,1655,1640,690,upc-block-composition
2198,sp_workloads,1690805680,wl_small_mem,1339,basic:GM-LM-RR-LSVT-sub25100-defpa,2,dpk-gurobi,block-composition,upc,ncd,basic:GM-LM-RR-LSVT,sub25100,nopa,Unlocking,0.4,RandResponseMechanism,{'Optimal': 40},4802902,316035,30613,2225,3090,14497,4800677,312945,16116,1714,1690,1723,1,30,927,1713,1660,796,upc-block-composition
2199,sp_workloads,1690805680,wl_small_mem,1339,basic:GM-LM-RR-LSVT-sub25100-defpa,2,dpk-gurobi,block-composition,upc,ncd,basic:GM-LM-RR-LSVT,sub25100,nopa,Unlocking,0.4,SVTLaplaceMechanism,{'Optimal': 40},4594159,320873,30876,937,3216,12766,4593222,317657,18110,1631,1679,1700,1,32,850,1630,1647,850,upc-block-composition
2200,sp_workloads,1690805680,wl_small_mem,1340,basic:GM-LM-RR-LSVT-sub25100-defpa,2,dpk-gurobi,block-composition,poisson,equal-ncd,basic:GM-LM-RR-LSVT,sub25100,nopa,Unlocking,0.2,GaussianMechanism,{'Optimal': 40},1647,1671,1731,0,826,1731,1647,845,0,1647,1671,1731,0,826,1731,1647,845,0,poisson-block-composition
2201,sp_workloads,1690805680,wl_small_mem,1340,basic:GM-LM-RR-LSVT-sub25100-defpa,2,dpk-gurobi,block-composition,poisson,equal-ncd,basic:GM-LM-RR-LSVT,sub25100,nopa,Unlocking,0.2,LaplaceMechanism,{'Optimal': 40},1660,1661,1646,0,564,1646,1660,1097,0,1660,1661,1646,0,564,1646,1660,1097,0,poisson-block-composition
2202,sp_workloads,1690805680,wl_small_mem,1340,basic:GM-LM-RR-LSVT-sub25100-defpa,2,dpk-gurobi,block-composition,poisson,equal-ncd,basic:GM-LM-RR-LSVT,sub25100,nopa,Unlocking,0.2,RandResponseMechanism,{'Optimal': 40},1714,1690,1723,0,0,1723,1714,1690,0,1714,1690,1723,0,0,1723,1714,1690,0,poisson-block-composition
2203,sp_workloads,1690805680,wl_small_mem,1340,basic:GM-LM-RR-LSVT-sub25100-defpa,2,dpk-gurobi,block-composition,poisson,equal-ncd,basic:GM-LM-RR-LSVT,sub25100,nopa,Unlocking,0.2,SVTLaplaceMechanism,{'Optimal': 40},1631,1679,1700,0,33,1700,1631,1646,0,1631,1679,1700,0,33,1700,1631,1646,0,poisson-block-composition
2204,sp_workloads,1690805680,wl_small_mem,1341,basic:GM-LM-RR-LSVT-sub25100-defpa,2,dpk-gurobi,block-composition,poisson,equal-ncd,basic:GM-LM-RR-LSVT,sub25100,nopa,Unlocking,0.4,GaussianMechanism,{'Optimal': 40},1647,1671,1731,0,826,1704,1647,845,27,1647,1671,1731,0,826,1704,1647,845,27,poisson-block-composition
2205,sp_workloads,1690805680,wl_small_mem,1341,basic:GM-LM-RR-LSVT-sub25100-defpa,2,dpk-gurobi,block-composition,poisson,equal-ncd,basic:GM-LM-RR-LSVT,sub25100,nopa,Unlocking,0.4,LaplaceMechanism,{'Optimal': 40},1660,1661,1646,0,493,1646,1660,1168,0,1660,1661,1646,0,493,1646,1660,1168,0,poisson-block-composition
2206,sp_workloads,1690805680,wl_small_mem,1341,basic:GM-LM-RR-LSVT-sub25100-defpa,2,dpk-gurobi,block-composition,poisson,equal-ncd,basic:GM-LM-RR-LSVT,sub25100,nopa,Unlocking,0.4,RandResponseMechanism,{'Optimal': 40},1714,1690,1723,0,0,1723,1714,1690,0,1714,1690,1723,0,0,1723,1714,1690,0,poisson-block-composition
2207,sp_workloads,1690805680,wl_small_mem,1341,basic:GM-LM-RR-LSVT-sub25100-defpa,2,dpk-gurobi,block-composition,poisson,equal-ncd,basic:GM-LM-RR-LSVT,sub25100,nopa,Unlocking,0.4,SVTLaplaceMechanism,{'Optimal': 40},1631,1679,1700,0,101,1700,1631,1578,0,1631,1679,1700,0,101,1700,1631,1578,0,poisson-block-composition
2208,sp_workloads,1690805680,wl_small_mem,1342,basic:GM-LM-RR-LSVT-sub25100-defpa,2,dpk-gurobi,block-composition,upc,equal-ncd,basic:GM-LM-RR-LSVT,sub25100,nopa,Unlocking,0.2,GaussianMechanism,{'Optimal': 40},1647,1671,1731,0,717,1731,1647,954,0,1647,1671,1731,0,717,1731,1647,954,0,upc-block-composition
2209,sp_workloads,1690805680,wl_small_mem,1342,basic:GM-LM-RR-LSVT-sub25100-defpa,2,dpk-gurobi,block-composition,upc,equal-ncd,basic:GM-LM-RR-LSVT,sub25100,nopa,Unlocking,0.2,LaplaceMechanism,{'Optimal': 40},1660,1661,1646,0,11,1646,1660,1650,0,1660,1661,1646,0,11,1646,1660,1650,0,upc-block-composition
2210,sp_workloads,1690805680,wl_small_mem,1342,basic:GM-LM-RR-LSVT-sub25100-defpa,2,dpk-gurobi,block-composition,upc,equal-ncd,basic:GM-LM-RR-LSVT,sub25100,nopa,Unlocking,0.2,RandResponseMechanism,{'Optimal': 40},1714,1690,1723,0,7,1723,1714,1683,0,1714,1690,1723,0,7,1723,1714,1683,0,upc-block-composition
2211,sp_workloads,1690805680,wl_small_mem,1342,basic:GM-LM-RR-LSVT-sub25100-defpa,2,dpk-gurobi,block-composition,upc,equal-ncd,basic:GM-LM-RR-LSVT,sub25100,nopa,Unlocking,0.2,SVTLaplaceMechanism,{'Optimal': 40},1631,1679,1700,1,9,1700,1630,1670,0,1631,1679,1700,1,9,1700,1630,1670,0,upc-block-composition
2212,sp_workloads,1690805680,wl_small_mem,1343,basic:GM-LM-RR-LSVT-sub25100-defpa,2,dpk-gurobi,block-composition,upc,equal-ncd,basic:GM-LM-RR-LSVT,sub25100,nopa,Unlocking,0.4,GaussianMechanism,{'Optimal': 40},1647,1671,1731,0,526,1723,1647,1145,8,1647,1671,1731,0,526,1723,1647,1145,8,upc-block-composition
2213,sp_workloads,1690805680,wl_small_mem,1343,basic:GM-LM-RR-LSVT-sub25100-defpa,2,dpk-gurobi,block-composition,upc,equal-ncd,basic:GM-LM-RR-LSVT,sub25100,nopa,Unlocking,0.4,LaplaceMechanism,{'Optimal': 40},1660,1661,1646,0,32,1646,1660,1629,0,1660,1661,1646,0,32,1646,1660,1629,0,upc-block-composition
2214,sp_workloads,1690805680,wl_small_mem,1343,basic:GM-LM-RR-LSVT-sub25100-defpa,2,dpk-gurobi,block-composition,upc,equal-ncd,basic:GM-LM-RR-LSVT,sub25100,nopa,Unlocking,0.4,RandResponseMechanism,{'Optimal': 40},1714,1690,1723,0,22,1723,1714,1668,0,1714,1690,1723,0,22,1723,1714,1668,0,upc-block-composition
2215,sp_workloads,1690805680,wl_small_mem,1343,basic:GM-LM-RR-LSVT-sub25100-defpa,2,dpk-gurobi,block-composition,upc,equal-ncd,basic:GM-LM-RR-LSVT,sub25100,nopa,Unlocking,0.4,SVTLaplaceMechanism,{'Optimal': 40},1631,1679,1700,0,31,1700,1631,1648,0,1631,1679,1700,0,31,1700,1631,1648,0,upc-block-composition
2216,sp_workloads,1690805680,wl_small_mem,1344,basic:GM-LM-RR-LSVT-sub25100-defpa,3,dpk-gurobi,block-composition,poisson,ncd,basic:GM-LM-RR-LSVT,sub25100,nopa,Unlocking,0.2,GaussianMechanism,{'Optimal': 40},4431438,335185,30243,826772,57904,12225,3604666,277281,18018,1636,1707,1661,437,486,815,1199,1221,846,poisson-block-composition
2217,sp_workloads,1690805680,wl_small_mem,1344,basic:GM-LM-RR-LSVT-sub25100-defpa,3,dpk-gurobi,block-composition,poisson,ncd,basic:GM-LM-RR-LSVT,sub25100,nopa,Unlocking,0.2,LaplaceMechanism,{'Optimal': 40},4614241,302136,30909,111244,0,17524,4502997,302136,13385,1669,1590,1731,50,0,1020,1619,1590,711,poisson-block-composition
2218,sp_workloads,1690805680,wl_small_mem,1344,basic:GM-LM-RR-LSVT-sub25100-defpa,3,dpk-gurobi,block-composition,poisson,ncd,basic:GM-LM-RR-LSVT,sub25100,nopa,Unlocking,0.2,RandResponseMechanism,{'Optimal': 40},4710432,347409,29228,0,0,13189,4710432,347409,16039,1691,1685,1636,0,0,859,1691,1685,777,poisson-block-composition
2219,sp_workloads,1690805680,wl_small_mem,1344,basic:GM-LM-RR-LSVT-sub25100-defpa,3,dpk-gurobi,block-composition,poisson,ncd,basic:GM-LM-RR-LSVT,sub25100,nopa,Unlocking,0.2,SVTLaplaceMechanism,{'Optimal': 40},4781445,315437,29779,0,0,11985,4781445,315437,17794,1697,1624,1645,0,0,799,1697,1624,846,poisson-block-composition
2220,sp_workloads,1690805680,wl_small_mem,1345,basic:GM-LM-RR-LSVT-sub25100-defpa,3,dpk-gurobi,block-composition,poisson,ncd,basic:GM-LM-RR-LSVT,sub25100,nopa,Unlocking,0.4,GaussianMechanism,{'Optimal': 40},4431438,335185,30243,767633,55257,12225,3663805,279928,18018,1636,1707,1661,401,439,815,1235,1268,846,poisson-block-composition
2221,sp_workloads,1690805680,wl_small_mem,1345,basic:GM-LM-RR-LSVT-sub25100-defpa,3,dpk-gurobi,block-composition,poisson,ncd,basic:GM-LM-RR-LSVT,sub25100,nopa,Unlocking,0.4,LaplaceMechanism,{'Optimal': 40},4614241,302136,30909,152610,0,16780,4461631,302136,14129,1669,1590,1731,69,0,996,1600,1590,735,poisson-block-composition
2222,sp_workloads,1690805680,wl_small_mem,1345,basic:GM-LM-RR-LSVT-sub25100-defpa,3,dpk-gurobi,block-composition,poisson,ncd,basic:GM-LM-RR-LSVT,sub25100,nopa,Unlocking,0.4,RandResponseMechanism,{'Optimal': 40},4710432,347409,29228,0,0,13344,4710432,347409,15884,1691,1685,1636,0,0,864,1691,1685,772,poisson-block-composition
2223,sp_workloads,1690805680,wl_small_mem,1345,basic:GM-LM-RR-LSVT-sub25100-defpa,3,dpk-gurobi,block-composition,poisson,ncd,basic:GM-LM-RR-LSVT,sub25100,nopa,Unlocking,0.4,SVTLaplaceMechanism,{'Optimal': 40},4781445,315437,29779,0,0,11745,4781445,315437,18034,1697,1624,1645,0,0,783,1697,1624,862,poisson-block-composition
2224,sp_workloads,1690805680,wl_small_mem,1346,basic:GM-LM-RR-LSVT-sub25100-defpa,3,dpk-gurobi,block-composition,upc,ncd,basic:GM-LM-RR-LSVT,sub25100,nopa,Unlocking,0.2,GaussianMechanism,{'Optimal': 40},4564359,342607,29747,69776,65853,11478,4494583,276754,18269,1636,1707,1661,32,352,762,1604,1355,899,upc-block-composition
2225,sp_workloads,1690805680,wl_small_mem,1346,basic:GM-LM-RR-LSVT-sub25100-defpa,3,dpk-gurobi,block-composition,upc,ncd,basic:GM-LM-RR-LSVT,sub25100,nopa,Unlocking,0.2,LaplaceMechanism,{'Optimal': 40},4480666,307160,31021,8464,3679,17226,4472202,303481,13795,1669,1590,1731,4,33,998,1665,1557,733,upc-block-composition
2226,sp_workloads,1690805680,wl_small_mem,1346,basic:GM-LM-RR-LSVT-sub25100-defpa,3,dpk-gurobi,block-composition,upc,ncd,basic:GM-LM-RR-LSVT,sub25100,nopa,Unlocking,0.2,RandResponseMechanism,{'Optimal': 40},4713077,327965,29084,8656,4065,13373,4704421,323900,15711,1691,1685,1636,4,31,851,1687,1654,785,upc-block-composition
2227,sp_workloads,1690805680,wl_small_mem,1346,basic:GM-LM-RR-LSVT-sub25100-defpa,3,dpk-gurobi,block-composition,upc,ncd,basic:GM-LM-RR-LSVT,sub25100,nopa,Unlocking,0.2,SVTLaplaceMechanism,{'Optimal': 40},4783523,317659,29347,6692,3681,11613,4776831,313978,17734,1697,1624,1645,3,31,771,1694,1593,874,upc-block-composition
2228,sp_workloads,1690805680,wl_small_mem,1347,basic:GM-LM-RR-LSVT-sub25100-defpa,3,dpk-gurobi,block-composition,upc,ncd,basic:GM-LM-RR-LSVT,sub25100,nopa,Unlocking,0.4,GaussianMechanism,{'Optimal': 40},4564359,342607,29747,58324,99013,12105,4506035,243594,17642,1636,1707,1661,27,455,807,1609,1252,854,upc-block-composition
2229,sp_workloads,1690805680,wl_small_mem,1347,basic:GM-LM-RR-LSVT-sub25100-defpa,3,dpk-gurobi,block-composition,upc,ncd,basic:GM-LM-RR-LSVT,sub25100,nopa,Unlocking,0.4,LaplaceMechanism,{'Optimal': 40},4480666,307160,31021,8145,2790,18733,4472521,304370,12288,1669,1590,1731,4,26,1059,1665,1564,672,upc-block-composition
2230,sp_workloads,1690805680,wl_small_mem,1347,basic:GM-LM-RR-LSVT-sub25100-defpa,3,dpk-gurobi,block-composition,upc,ncd,basic:GM-LM-RR-LSVT,sub25100,nopa,Unlocking,0.4,RandResponseMechanism,{'Optimal': 40},4713077,327965,29084,4248,3405,13747,4708829,324560,15337,1691,1685,1636,2,35,877,1689,1650,759,upc-block-composition
2231,sp_workloads,1690805680,wl_small_mem,1347,basic:GM-LM-RR-LSVT-sub25100-defpa,3,dpk-gurobi,block-composition,upc,ncd,basic:GM-LM-RR-LSVT,sub25100,nopa,Unlocking,0.4,SVTLaplaceMechanism,{'Optimal': 40},4783523,317659,29347,8896,2788,12140,4774627,314871,17207,1697,1624,1645,4,28,804,1693,1596,841,upc-block-composition
2232,sp_workloads,1690805680,wl_small_mem,1348,basic:GM-LM-RR-LSVT-sub25100-defpa,3,dpk-gurobi,block-composition,poisson,equal-ncd,basic:GM-LM-RR-LSVT,sub25100,nopa,Unlocking,0.2,GaussianMechanism,{'Optimal': 40},1636,1707,1661,0,835,1661,1636,872,0,1636,1707,1661,0,835,1661,1636,872,0,poisson-block-composition
2233,sp_workloads,1690805680,wl_small_mem,1348,basic:GM-LM-RR-LSVT-sub25100-defpa,3,dpk-gurobi,block-composition,poisson,equal-ncd,basic:GM-LM-RR-LSVT,sub25100,nopa,Unlocking,0.2,LaplaceMechanism,{'Optimal': 40},1669,1590,1731,0,549,1731,1669,1041,0,1669,1590,1731,0,549,1731,1669,1041,0,poisson-block-composition
2234,sp_workloads,1690805680,wl_small_mem,1348,basic:GM-LM-RR-LSVT-sub25100-defpa,3,dpk-gurobi,block-composition,poisson,equal-ncd,basic:GM-LM-RR-LSVT,sub25100,nopa,Unlocking,0.2,RandResponseMechanism,{'Optimal': 40},1691,1685,1636,0,0,1636,1691,1685,0,1691,1685,1636,0,0,1636,1691,1685,0,poisson-block-composition
2235,sp_workloads,1690805680,wl_small_mem,1348,basic:GM-LM-RR-LSVT-sub25100-defpa,3,dpk-gurobi,block-composition,poisson,equal-ncd,basic:GM-LM-RR-LSVT,sub25100,nopa,Unlocking,0.2,SVTLaplaceMechanism,{'Optimal': 40},1697,1624,1645,0,50,1645,1697,1574,0,1697,1624,1645,0,50,1645,1697,1574,0,poisson-block-composition
2236,sp_workloads,1690805680,wl_small_mem,1349,basic:GM-LM-RR-LSVT-sub25100-defpa,3,dpk-gurobi,block-composition,poisson,equal-ncd,basic:GM-LM-RR-LSVT,sub25100,nopa,Unlocking,0.4,GaussianMechanism,{'Optimal': 40},1636,1707,1661,0,835,1650,1636,872,11,1636,1707,1661,0,835,1650,1636,872,11,poisson-block-composition
2237,sp_workloads,1690805680,wl_small_mem,1349,basic:GM-LM-RR-LSVT-sub25100-defpa,3,dpk-gurobi,block-composition,poisson,equal-ncd,basic:GM-LM-RR-LSVT,sub25100,nopa,Unlocking,0.4,LaplaceMechanism,{'Optimal': 40},1669,1590,1731,0,472,1731,1669,1118,0,1669,1590,1731,0,472,1731,1669,1118,0,poisson-block-composition
2238,sp_workloads,1690805680,wl_small_mem,1349,basic:GM-LM-RR-LSVT-sub25100-defpa,3,dpk-gurobi,block-composition,poisson,equal-ncd,basic:GM-LM-RR-LSVT,sub25100,nopa,Unlocking,0.4,RandResponseMechanism,{'Optimal': 40},1691,1685,1636,0,0,1636,1691,1685,0,1691,1685,1636,0,0,1636,1691,1685,0,poisson-block-composition
2239,sp_workloads,1690805680,wl_small_mem,1349,basic:GM-LM-RR-LSVT-sub25100-defpa,3,dpk-gurobi,block-composition,poisson,equal-ncd,basic:GM-LM-RR-LSVT,sub25100,nopa,Unlocking,0.4,SVTLaplaceMechanism,{'Optimal': 40},1697,1624,1645,0,120,1645,1697,1504,0,1697,1624,1645,0,120,1645,1697,1504,0,poisson-block-composition
2240,sp_workloads,1690805680,wl_small_mem,1350,basic:GM-LM-RR-LSVT-sub25100-defpa,3,dpk-gurobi,block-composition,upc,equal-ncd,basic:GM-LM-RR-LSVT,sub25100,nopa,Unlocking,0.2,GaussianMechanism,{'Optimal': 40},1636,1707,1661,1,729,1661,1635,978,0,1636,1707,1661,1,729,1661,1635,978,0,upc-block-composition
2241,sp_workloads,1690805680,wl_small_mem,1350,basic:GM-LM-RR-LSVT-sub25100-defpa,3,dpk-gurobi,block-composition,upc,equal-ncd,basic:GM-LM-RR-LSVT,sub25100,nopa,Unlocking,0.2,LaplaceMechanism,{'Optimal': 40},1669,1590,1731,0,9,1731,1669,1581,0,1669,1590,1731,0,9,1731,1669,1581,0,upc-block-composition
2242,sp_workloads,1690805680,wl_small_mem,1350,basic:GM-LM-RR-LSVT-sub25100-defpa,3,dpk-gurobi,block-composition,upc,equal-ncd,basic:GM-LM-RR-LSVT,sub25100,nopa,Unlocking,0.2,RandResponseMechanism,{'Optimal': 40},1691,1685,1636,0,13,1636,1691,1672,0,1691,1685,1636,0,13,1636,1691,1672,0,upc-block-composition
2243,sp_workloads,1690805680,wl_small_mem,1350,basic:GM-LM-RR-LSVT-sub25100-defpa,3,dpk-gurobi,block-composition,upc,equal-ncd,basic:GM-LM-RR-LSVT,sub25100,nopa,Unlocking,0.2,SVTLaplaceMechanism,{'Optimal': 40},1697,1624,1645,0,7,1645,1697,1617,0,1697,1624,1645,0,7,1645,1697,1617,0,upc-block-composition
2244,sp_workloads,1690805680,wl_small_mem,1351,basic:GM-LM-RR-LSVT-sub25100-defpa,3,dpk-gurobi,block-composition,upc,equal-ncd,basic:GM-LM-RR-LSVT,sub25100,nopa,Unlocking,0.4,GaussianMechanism,{'Optimal': 40},1636,1707,1661,1,513,1661,1635,1194,0,1636,1707,1661,1,513,1661,1635,1194,0,upc-block-composition
2245,sp_workloads,1690805680,wl_small_mem,1351,basic:GM-LM-RR-LSVT-sub25100-defpa,3,dpk-gurobi,block-composition,upc,equal-ncd,basic:GM-LM-RR-LSVT,sub25100,nopa,Unlocking,0.4,LaplaceMechanism,{'Optimal': 40},1669,1590,1731,0,39,1731,1669,1551,0,1669,1590,1731,0,39,1731,1669,1551,0,upc-block-composition
2246,sp_workloads,1690805680,wl_small_mem,1351,basic:GM-LM-RR-LSVT-sub25100-defpa,3,dpk-gurobi,block-composition,upc,equal-ncd,basic:GM-LM-RR-LSVT,sub25100,nopa,Unlocking,0.4,RandResponseMechanism,{'Optimal': 40},1691,1685,1636,0,27,1636,1691,1658,0,1691,1685,1636,0,27,1636,1691,1658,0,upc-block-composition
2247,sp_workloads,1690805680,wl_small_mem,1351,basic:GM-LM-RR-LSVT-sub25100-defpa,3,dpk-gurobi,block-composition,upc,equal-ncd,basic:GM-LM-RR-LSVT,sub25100,nopa,Unlocking,0.4,SVTLaplaceMechanism,{'Optimal': 40},1697,1624,1645,0,23,1645,1697,1601,0,1697,1624,1645,0,23,1645,1697,1601,0,upc-block-composition
2248,sp_workloads,1690805680,wl_small_mem,1352,basic:GM-LM-RR-LSVT-sub25100-defpa,4,dpk-gurobi,block-composition,poisson,ncd,basic:GM-LM-RR-LSVT,sub25100,nopa,Unlocking,0.2,GaussianMechanism,{'Optimal': 40},4571824,341651,31424,888444,57796,12896,3683380,283855,18528,1667,1683,1652,467,492,806,1200,1191,846,poisson-block-composition
2249,sp_workloads,1690805680,wl_small_mem,1352,basic:GM-LM-RR-LSVT-sub25100-defpa,4,dpk-gurobi,block-composition,poisson,ncd,basic:GM-LM-RR-LSVT,sub25100,nopa,Unlocking,0.2,LaplaceMechanism,{'Optimal': 40},4559498,310728,31904,87145,0,16848,4472353,310728,15056,1705,1675,1674,39,0,939,1666,1675,735,poisson-block-composition
2250,sp_workloads,1690805680,wl_small_mem,1352,basic:GM-LM-RR-LSVT-sub25100-defpa,4,dpk-gurobi,block-composition,poisson,ncd,basic:GM-LM-RR-LSVT,sub25100,nopa,Unlocking,0.2,RandResponseMechanism,{'Optimal': 40},4915555,321907,33248,0,0,15072,4915555,321907,18176,1732,1682,1739,0,0,909,1732,1682,830,poisson-block-composition
2251,sp_workloads,1690805680,wl_small_mem,1352,basic:GM-LM-RR-LSVT-sub25100-defpa,4,dpk-gurobi,block-composition,poisson,ncd,basic:GM-LM-RR-LSVT,sub25100,nopa,Unlocking,0.2,SVTLaplaceMechanism,{'Optimal': 40},4827443,310825,33008,0,0,14192,4827443,310825,18816,1701,1631,1753,0,0,887,1701,1631,866,poisson-block-composition
2252,sp_workloads,1690805680,wl_small_mem,1353,basic:GM-LM-RR-LSVT-sub25100-defpa,4,dpk-gurobi,block-composition,poisson,ncd,basic:GM-LM-RR-LSVT,sub25100,nopa,Unlocking,0.4,GaussianMechanism,{'Optimal': 40},4571824,341651,31424,823180,59558,12896,3748644,282093,18528,1667,1683,1652,428,487,806,1239,1196,846,poisson-block-composition
2253,sp_workloads,1690805680,wl_small_mem,1353,basic:GM-LM-RR-LSVT-sub25100-defpa,4,dpk-gurobi,block-composition,poisson,ncd,basic:GM-LM-RR-LSVT,sub25100,nopa,Unlocking,0.4,LaplaceMechanism,{'Optimal': 40},4559498,310728,31904,131292,0,15888,4428206,310728,16016,1705,1675,1674,59,0,909,1646,1675,765,poisson-block-composition
2254,sp_workloads,1690805680,wl_small_mem,1353,basic:GM-LM-RR-LSVT-sub25100-defpa,4,dpk-gurobi,block-composition,poisson,ncd,basic:GM-LM-RR-LSVT,sub25100,nopa,Unlocking,0.4,RandResponseMechanism,{'Optimal': 40},4915555,321907,33248,0,0,14720,4915555,321907,18528,1732,1682,1739,0,0,898,1732,1682,841,poisson-block-composition
2255,sp_workloads,1690805680,wl_small_mem,1353,basic:GM-LM-RR-LSVT-sub25100-defpa,4,dpk-gurobi,block-composition,poisson,ncd,basic:GM-LM-RR-LSVT,sub25100,nopa,Unlocking,0.4,SVTLaplaceMechanism,{'Optimal': 40},4827443,310825,33008,0,0,14064,4827443,310825,18944,1701,1631,1753,0,0,879,1701,1631,874,poisson-block-composition
2256,sp_workloads,1690805680,wl_small_mem,1354,basic:GM-LM-RR-LSVT-sub25100-defpa,4,dpk-gurobi,block-composition,upc,ncd,basic:GM-LM-RR-LSVT,sub25100,nopa,Unlocking,0.2,GaussianMechanism,{'Optimal': 40},4695849,326924,29724,69117,61040,11604,4626732,265884,18120,1667,1683,1652,32,336,764,1635,1347,888,upc-block-composition
2257,sp_workloads,1690805680,wl_small_mem,1354,basic:GM-LM-RR-LSVT-sub25100-defpa,4,dpk-gurobi,block-composition,upc,ncd,basic:GM-LM-RR-LSVT,sub25100,nopa,Unlocking,0.2,LaplaceMechanism,{'Optimal': 40},4679017,325790,30262,5891,4066,15598,4673126,321724,14664,1705,1675,1674,3,35,914,1702,1640,760,upc-block-composition
2258,sp_workloads,1690805680,wl_small_mem,1354,basic:GM-LM-RR-LSVT-sub25100-defpa,4,dpk-gurobi,block-composition,upc,ncd,basic:GM-LM-RR-LSVT,sub25100,nopa,Unlocking,0.2,RandResponseMechanism,{'Optimal': 40},4775505,333039,31541,10657,3387,14120,4764848,329652,17421,1732,1682,1739,5,30,888,1727,1652,851,upc-block-composition
2259,sp_workloads,1690805680,wl_small_mem,1354,basic:GM-LM-RR-LSVT-sub25100-defpa,4,dpk-gurobi,block-composition,upc,ncd,basic:GM-LM-RR-LSVT,sub25100,nopa,Unlocking,0.2,SVTLaplaceMechanism,{'Optimal': 40},4720990,300216,31735,11860,3138,13382,4709130,297078,18353,1701,1631,1753,6,25,874,1695,1606,879,upc-block-composition
2260,sp_workloads,1690805680,wl_small_mem,1355,basic:GM-LM-RR-LSVT-sub25100-defpa,4,dpk-gurobi,block-composition,upc,ncd,basic:GM-LM-RR-LSVT,sub25100,nopa,Unlocking,0.4,GaussianMechanism,{'Optimal': 40},4695849,326924,29724,46346,100910,12067,4649503,226014,17657,1667,1683,1652,22,467,797,1645,1216,855,upc-block-composition
2261,sp_workloads,1690805680,wl_small_mem,1355,basic:GM-LM-RR-LSVT-sub25100-defpa,4,dpk-gurobi,block-composition,upc,ncd,basic:GM-LM-RR-LSVT,sub25100,nopa,Unlocking,0.4,LaplaceMechanism,{'Optimal': 40},4679017,325790,30262,15217,3280,17306,4663800,322510,12956,1705,1675,1674,7,28,982,1698,1647,692,upc-block-composition
2262,sp_workloads,1690805680,wl_small_mem,1355,basic:GM-LM-RR-LSVT-sub25100-defpa,4,dpk-gurobi,block-composition,upc,ncd,basic:GM-LM-RR-LSVT,sub25100,nopa,Unlocking,0.4,RandResponseMechanism,{'Optimal': 40},4775505,333039,31541,10102,2675,14537,4765403,330364,17004,1732,1682,1739,5,29,919,1727,1653,820,upc-block-composition
2263,sp_workloads,1690805680,wl_small_mem,1355,basic:GM-LM-RR-LSVT-sub25100-defpa,4,dpk-gurobi,block-composition,upc,ncd,basic:GM-LM-RR-LSVT,sub25100,nopa,Unlocking,0.4,SVTLaplaceMechanism,{'Optimal': 40},4720990,300216,31735,5843,2156,13512,4715147,298060,18223,1701,1631,1753,4,23,888,1697,1608,865,upc-block-composition
2264,sp_workloads,1690805680,wl_small_mem,1356,basic:GM-LM-RR-LSVT-sub25100-defpa,4,dpk-gurobi,block-composition,poisson,equal-ncd,basic:GM-LM-RR-LSVT,sub25100,nopa,Unlocking,0.2,GaussianMechanism,{'Optimal': 40},1667,1683,1652,0,823,1652,1667,860,0,1667,1683,1652,0,823,1652,1667,860,0,poisson-block-composition
2265,sp_workloads,1690805680,wl_small_mem,1356,basic:GM-LM-RR-LSVT-sub25100-defpa,4,dpk-gurobi,block-composition,poisson,equal-ncd,basic:GM-LM-RR-LSVT,sub25100,nopa,Unlocking,0.2,LaplaceMechanism,{'Optimal': 40},1705,1675,1674,0,547,1674,1705,1128,0,1705,1675,1674,0,547,1674,1705,1128,0,poisson-block-composition
2266,sp_workloads,1690805680,wl_small_mem,1356,basic:GM-LM-RR-LSVT-sub25100-defpa,4,dpk-gurobi,block-composition,poisson,equal-ncd,basic:GM-LM-RR-LSVT,sub25100,nopa,Unlocking,0.2,RandResponseMechanism,{'Optimal': 40},1732,1682,1739,0,0,1739,1732,1682,0,1732,1682,1739,0,0,1739,1732,1682,0,poisson-block-composition
2267,sp_workloads,1690805680,wl_small_mem,1356,basic:GM-LM-RR-LSVT-sub25100-defpa,4,dpk-gurobi,block-composition,poisson,equal-ncd,basic:GM-LM-RR-LSVT,sub25100,nopa,Unlocking,0.2,SVTLaplaceMechanism,{'Optimal': 40},1701,1631,1753,0,43,1753,1701,1588,0,1701,1631,1753,0,43,1753,1701,1588,0,poisson-block-composition
2268,sp_workloads,1690805680,wl_small_mem,1357,basic:GM-LM-RR-LSVT-sub25100-defpa,4,dpk-gurobi,block-composition,poisson,equal-ncd,basic:GM-LM-RR-LSVT,sub25100,nopa,Unlocking,0.4,GaussianMechanism,{'Optimal': 40},1667,1683,1652,0,823,1639,1667,860,13,1667,1683,1652,0,823,1639,1667,860,13,poisson-block-composition
2269,sp_workloads,1690805680,wl_small_mem,1357,basic:GM-LM-RR-LSVT-sub25100-defpa,4,dpk-gurobi,block-composition,poisson,equal-ncd,basic:GM-LM-RR-LSVT,sub25100,nopa,Unlocking,0.4,LaplaceMechanism,{'Optimal': 40},1705,1675,1674,0,475,1674,1705,1200,0,1705,1675,1674,0,475,1674,1705,1200,0,poisson-block-composition
2270,sp_workloads,1690805680,wl_small_mem,1357,basic:GM-LM-RR-LSVT-sub25100-defpa,4,dpk-gurobi,block-composition,poisson,equal-ncd,basic:GM-LM-RR-LSVT,sub25100,nopa,Unlocking,0.4,RandResponseMechanism,{'Optimal': 40},1732,1682,1739,0,0,1739,1732,1682,0,1732,1682,1739,0,0,1739,1732,1682,0,poisson-block-composition
2271,sp_workloads,1690805680,wl_small_mem,1357,basic:GM-LM-RR-LSVT-sub25100-defpa,4,dpk-gurobi,block-composition,poisson,equal-ncd,basic:GM-LM-RR-LSVT,sub25100,nopa,Unlocking,0.4,SVTLaplaceMechanism,{'Optimal': 40},1701,1631,1753,0,110,1753,1701,1521,0,1701,1631,1753,0,110,1753,1701,1521,0,poisson-block-composition
2272,sp_workloads,1690805680,wl_small_mem,1358,basic:GM-LM-RR-LSVT-sub25100-defpa,4,dpk-gurobi,block-composition,upc,equal-ncd,basic:GM-LM-RR-LSVT,sub25100,nopa,Unlocking,0.2,GaussianMechanism,{'Optimal': 40},1667,1683,1652,1,715,1652,1666,968,0,1667,1683,1652,1,715,1652,1666,968,0,upc-block-composition
2273,sp_workloads,1690805680,wl_small_mem,1358,basic:GM-LM-RR-LSVT-sub25100-defpa,4,dpk-gurobi,block-composition,upc,equal-ncd,basic:GM-LM-RR-LSVT,sub25100,nopa,Unlocking,0.2,LaplaceMechanism,{'Optimal': 40},1705,1675,1674,0,12,1674,1705,1663,0,1705,1675,1674,0,12,1674,1705,1663,0,upc-block-composition
2274,sp_workloads,1690805680,wl_small_mem,1358,basic:GM-LM-RR-LSVT-sub25100-defpa,4,dpk-gurobi,block-composition,upc,equal-ncd,basic:GM-LM-RR-LSVT,sub25100,nopa,Unlocking,0.2,RandResponseMechanism,{'Optimal': 40},1732,1682,1739,0,5,1739,1732,1677,0,1732,1682,1739,0,5,1739,1732,1677,0,upc-block-composition
2275,sp_workloads,1690805680,wl_small_mem,1358,basic:GM-LM-RR-LSVT-sub25100-defpa,4,dpk-gurobi,block-composition,upc,equal-ncd,basic:GM-LM-RR-LSVT,sub25100,nopa,Unlocking,0.2,SVTLaplaceMechanism,{'Optimal': 40},1701,1631,1753,0,10,1753,1701,1621,0,1701,1631,1753,0,10,1753,1701,1621,0,upc-block-composition
2276,sp_workloads,1690805680,wl_small_mem,1359,basic:GM-LM-RR-LSVT-sub25100-defpa,4,dpk-gurobi,block-composition,upc,equal-ncd,basic:GM-LM-RR-LSVT,sub25100,nopa,Unlocking,0.4,GaussianMechanism,{'Optimal': 40},1667,1683,1652,0,505,1648,1667,1178,4,1667,1683,1652,0,505,1648,1667,1178,4,upc-block-composition
2277,sp_workloads,1690805680,wl_small_mem,1359,basic:GM-LM-RR-LSVT-sub25100-defpa,4,dpk-gurobi,block-composition,upc,equal-ncd,basic:GM-LM-RR-LSVT,sub25100,nopa,Unlocking,0.4,LaplaceMechanism,{'Optimal': 40},1705,1675,1674,0,35,1674,1705,1640,0,1705,1675,1674,0,35,1674,1705,1640,0,upc-block-composition
2278,sp_workloads,1690805680,wl_small_mem,1359,basic:GM-LM-RR-LSVT-sub25100-defpa,4,dpk-gurobi,block-composition,upc,equal-ncd,basic:GM-LM-RR-LSVT,sub25100,nopa,Unlocking,0.4,RandResponseMechanism,{'Optimal': 40},1732,1682,1739,1,19,1739,1731,1663,0,1732,1682,1739,1,19,1739,1731,1663,0,upc-block-composition
2279,sp_workloads,1690805680,wl_small_mem,1359,basic:GM-LM-RR-LSVT-sub25100-defpa,4,dpk-gurobi,block-composition,upc,equal-ncd,basic:GM-LM-RR-LSVT,sub25100,nopa,Unlocking,0.4,SVTLaplaceMechanism,{'Optimal': 40},1701,1631,1753,0,32,1753,1701,1599,0,1701,1631,1753,0,32,1753,1701,1599,0,upc-block-composition
2280,sp_workloads,1690805680,wl_small_mem,1360,gm:GM-sub25100-defpa,0,dpk-gurobi,block-composition-pa,poisson,ncd,gm:GM,sub25100,defpa,Unlocking,0.2,GaussianMechanism,{'Optimal': 40},18864461,1345041,130912,6785813,767097,110016,12078648,577944,20896,6716,6728,6904,2570,4298,5871,4146,2430,1033,poisson-block-composition-pa
2281,sp_workloads,1690805680,wl_small_mem,1361,gm:GM-sub25100-defpa,0,dpk-gurobi,block-composition-pa,poisson,ncd,gm:GM,sub25100,defpa,Unlocking,0.4,GaussianMechanism,{'Optimal': 40},18864461,1345041,130912,7693818,887064,113408,11170643,457977,17504,6716,6728,6904,2988,4579,6032,3728,2149,872,poisson-block-composition-pa
2282,sp_workloads,1690805680,wl_small_mem,1362,gm:GM-sub25100-defpa,0,dpk-gurobi,block-composition-pa,poisson,equal-ncd,gm:GM,sub25100,defpa,Unlocking,0.2,GaussianMechanism,{'Optimal': 40},6716,6728,6904,2760,5880,6904,3956,848,0,6716,6728,6904,2760,5880,6904,3956,848,0,poisson-block-composition-pa
2283,sp_workloads,1690805680,wl_small_mem,1363,gm:GM-sub25100-defpa,0,dpk-gurobi,block-composition-pa,poisson,equal-ncd,gm:GM,sub25100,defpa,Unlocking,0.4,GaussianMechanism,{'Optimal': 40},6716,6728,6904,2968,5927,6904,3748,801,0,6716,6728,6904,2968,5927,6904,3748,801,0,poisson-block-composition-pa
2284,sp_workloads,1690805680,wl_small_mem,1364,gm:GM-sub25100-defpa,1,dpk-gurobi,block-composition-pa,poisson,ncd,gm:GM,sub25100,defpa,Unlocking,0.2,GaussianMechanism,{'Optimal': 40},18715267,1320958,128176,6643096,747652,106512,12072171,573306,21664,6673,6765,6731,2535,4265,5658,4138,2500,1073,poisson-block-composition-pa
2285,sp_workloads,1690805680,wl_small_mem,1365,gm:GM-sub25100-defpa,1,dpk-gurobi,block-composition-pa,poisson,ncd,gm:GM,sub25100,defpa,Unlocking,0.4,GaussianMechanism,{'Optimal': 40},18715267,1320958,128176,7585056,861864,110608,11130211,459094,17568,6673,6765,6731,2951,4601,5860,3722,2164,871,poisson-block-composition-pa
2286,sp_workloads,1690805680,wl_small_mem,1366,gm:GM-sub25100-defpa,1,dpk-gurobi,block-composition-pa,poisson,equal-ncd,gm:GM,sub25100,defpa,Unlocking,0.2,GaussianMechanism,{'Optimal': 40},6673,6765,6731,2747,5975,6731,3926,790,0,6673,6765,6731,2747,5975,6731,3926,790,0,poisson-block-composition-pa
2287,sp_workloads,1690805680,wl_small_mem,1367,gm:GM-sub25100-defpa,1,dpk-gurobi,block-composition-pa,poisson,equal-ncd,gm:GM,sub25100,defpa,Unlocking,0.4,GaussianMechanism,{'Optimal': 40},6673,6765,6731,2936,5979,6731,3737,786,0,6673,6765,6731,2936,5979,6731,3737,786,0,poisson-block-composition-pa
2288,sp_workloads,1690805680,wl_small_mem,1368,gm:GM-sub25100-defpa,2,dpk-gurobi,block-composition-pa,poisson,ncd,gm:GM,sub25100,defpa,Unlocking,0.2,GaussianMechanism,{'Optimal': 40},18806374,1355979,126784,6700589,781552,107056,12105785,574427,19728,6783,6833,6678,2599,4422,5727,4184,2411,951,poisson-block-composition-pa
2289,sp_workloads,1690805680,wl_small_mem,1369,gm:GM-sub25100-defpa,2,dpk-gurobi,block-composition-pa,poisson,ncd,gm:GM,sub25100,defpa,Unlocking,0.4,GaussianMechanism,{'Optimal': 40},18806374,1355979,126784,7562824,886578,110496,11243550,469401,16288,6783,6833,6678,2983,4643,5874,3800,2190,804,poisson-block-composition-pa
2290,sp_workloads,1690805680,wl_small_mem,1370,gm:GM-sub25100-defpa,2,dpk-gurobi,block-composition-pa,poisson,equal-ncd,gm:GM,sub25100,defpa,Unlocking,0.2,GaussianMechanism,{'Optimal': 40},6783,6833,6678,2765,5950,6678,4018,883,0,6783,6833,6678,2765,5950,6678,4018,883,0,poisson-block-composition-pa
2291,sp_workloads,1690805680,wl_small_mem,1371,gm:GM-sub25100-defpa,2,dpk-gurobi,block-composition-pa,poisson,equal-ncd,gm:GM,sub25100,defpa,Unlocking,0.4,GaussianMechanism,{'Optimal': 40},6783,6833,6678,2983,6007,6678,3800,826,0,6783,6833,6678,2983,6007,6678,3800,826,0,poisson-block-composition-pa
2292,sp_workloads,1690805680,wl_small_mem,1372,gm:GM-sub25100-defpa,3,dpk-gurobi,block-composition-pa,poisson,ncd,gm:GM,sub25100,defpa,Unlocking,0.2,GaussianMechanism,{'Optimal': 40},18672541,1292482,118587,6576887,735617,100746,12095654,556865,17841,6771,6693,6629,2543,4190,5702,4228,2503,927,poisson-block-composition-pa
2293,sp_workloads,1690805680,wl_small_mem,1373,gm:GM-sub25100-defpa,3,dpk-gurobi,block-composition-pa,poisson,ncd,gm:GM,sub25100,defpa,Unlocking,0.4,GaussianMechanism,{'Optimal': 40},18672541,1292482,118587,7478640,842347,103160,11193901,450135,15427,6771,6693,6629,2944,4507,5832,3827,2186,797,poisson-block-composition-pa
2294,sp_workloads,1690805680,wl_small_mem,1374,gm:GM-sub25100-defpa,3,dpk-gurobi,block-composition-pa,poisson,equal-ncd,gm:GM,sub25100,defpa,Unlocking,0.2,GaussianMechanism,{'Optimal': 40},6771,6693,6629,2754,5798,6629,4017,895,0,6771,6693,6629,2754,5798,6629,4017,895,0,poisson-block-composition-pa
2295,sp_workloads,1690805680,wl_small_mem,1375,gm:GM-sub25100-defpa,3,dpk-gurobi,block-composition-pa,poisson,equal-ncd,gm:GM,sub25100,defpa,Unlocking,0.4,GaussianMechanism,{'Optimal': 40},6771,6693,6629,2981,5842,6629,3790,851,0,6771,6693,6629,2981,5842,6629,3790,851,0,poisson-block-composition-pa
2296,sp_workloads,1690805680,wl_small_mem,1376,gm:GM-sub25100-defpa,4,dpk-gurobi,block-composition-pa,poisson,ncd,gm:GM,sub25100,defpa,Unlocking,0.2,GaussianMechanism,{'Optimal': 40},18857452,1277663,120343,6728703,720501,101921,12128749,557162,18422,6862,6691,6713,2611,4141,5743,4251,2550,970,poisson-block-composition-pa
2297,sp_workloads,1690805680,wl_small_mem,1377,gm:GM-sub25100-defpa,4,dpk-gurobi,block-composition-pa,poisson,ncd,gm:GM,sub25100,defpa,Unlocking,0.4,GaussianMechanism,{'Optimal': 40},18857452,1277663,120343,7591369,829931,104640,11266083,447732,15703,6862,6691,6713,3029,4482,5888,3833,2209,825,poisson-block-composition-pa
2298,sp_workloads,1690805680,wl_small_mem,1378,gm:GM-sub25100-defpa,4,dpk-gurobi,block-composition-pa,poisson,equal-ncd,gm:GM,sub25100,defpa,Unlocking,0.2,GaussianMechanism,{'Optimal': 40},6862,6691,6713,2759,5807,6713,4103,884,0,6862,6691,6713,2759,5807,6713,4103,884,0,poisson-block-composition-pa
2299,sp_workloads,1690805680,wl_small_mem,1379,gm:GM-sub25100-defpa,4,dpk-gurobi,block-composition-pa,poisson,equal-ncd,gm:GM,sub25100,defpa,Unlocking,0.4,GaussianMechanism,{'Optimal': 40},6862,6691,6713,3010,5860,6713,3852,831,0,6862,6691,6713,3010,5860,6713,3852,831,0,poisson-block-composition-pa
2300,sp_workloads,1690805680,wl_small_mem,1380,ml:SGD-PATE-sub25100-defpa,0,dpk-gurobi,block-composition-pa,poisson,ncd,ml:SGD-PATE,sub25100,defpa,Unlocking,0.2,MLNoisySGDMechanism,{'Optimal': 40},9320337,647144,60780,1624807,118851,28035,7695530,528293,32745,3347,3348,3392,693,689,1712,2654,2659,1680,poisson-block-composition-pa
2301,sp_workloads,1690805680,wl_small_mem,1380,ml:SGD-PATE-sub25100-defpa,0,dpk-gurobi,block-composition-pa,poisson,ncd,ml:SGD-PATE,sub25100,defpa,Unlocking,0.2,MLPateGaussianMechanism,{'Optimal': 40},9560711,630849,59490,942098,138778,29460,8618613,492071,30030,3488,3389,3328,495,824,1839,2993,2565,1489,poisson-block-composition-pa
2302,sp_workloads,1690805680,wl_small_mem,1381,ml:SGD-PATE-sub25100-defpa,0,dpk-gurobi,block-composition-pa,poisson,ncd,ml:SGD-PATE,sub25100,defpa,Unlocking,0.4,MLNoisySGDMechanism,{'Optimal': 40},9320337,647144,60780,1714403,120943,28200,7605934,526201,32580,3347,3348,3392,726,716,1729,2621,2632,1663,poisson-block-composition-pa
2303,sp_workloads,1690805680,wl_small_mem,1381,ml:SGD-PATE-sub25100-defpa,0,dpk-gurobi,block-composition-pa,poisson,ncd,ml:SGD-PATE,sub25100,defpa,Unlocking,0.4,MLPateGaussianMechanism,{'Optimal': 40},9560711,630849,59490,980787,136057,29850,8579924,494792,29640,3488,3389,3328,512,842,1868,2976,2547,1460,poisson-block-composition-pa
2304,sp_workloads,1690805680,wl_small_mem,1382,ml:SGD-PATE-sub25100-defpa,0,dpk-gurobi,block-composition-pa,poisson,equal-ncd,ml:SGD-PATE,sub25100,defpa,Unlocking,0.2,MLNoisySGDMechanism,{'Optimal': 40},3347,3348,3392,517,2021,3392,2830,1327,0,3347,3348,3392,517,2021,3392,2830,1327,0,poisson-block-composition-pa
2305,sp_workloads,1690805680,wl_small_mem,1382,ml:SGD-PATE-sub25100-defpa,0,dpk-gurobi,block-composition-pa,poisson,equal-ncd,ml:SGD-PATE,sub25100,defpa,Unlocking,0.2,MLPateGaussianMechanism,{'Optimal': 40},3488,3389,3328,343,2001,3328,3145,1388,0,3488,3389,3328,343,2001,3328,3145,1388,0,poisson-block-composition-pa
2306,sp_workloads,1690805680,wl_small_mem,1383,ml:SGD-PATE-sub25100-defpa,0,dpk-gurobi,block-composition-pa,poisson,equal-ncd,ml:SGD-PATE,sub25100,defpa,Unlocking,0.4,MLNoisySGDMechanism,{'Optimal': 40},3347,3348,3392,510,2034,3392,2837,1314,0,3347,3348,3392,510,2034,3392,2837,1314,0,poisson-block-composition-pa
2307,sp_workloads,1690805680,wl_small_mem,1383,ml:SGD-PATE-sub25100-defpa,0,dpk-gurobi,block-composition-pa,poisson,equal-ncd,ml:SGD-PATE,sub25100,defpa,Unlocking,0.4,MLPateGaussianMechanism,{'Optimal': 40},3488,3389,3328,333,2000,3328,3155,1389,0,3488,3389,3328,333,2000,3328,3155,1389,0,poisson-block-composition-pa
2308,sp_workloads,1690805680,wl_small_mem,1384,ml:SGD-PATE-sub25100-defpa,1,dpk-gurobi,block-composition-pa,poisson,ncd,ml:SGD-PATE,sub25100,defpa,Unlocking,0.2,MLNoisySGDMechanism,{'Optimal': 40},9612014,638642,60437,1706422,112230,26617,7905592,526412,33820,3436,3336,3371,670,611,1623,2766,2725,1748,poisson-block-composition-pa
2309,sp_workloads,1690805680,wl_small_mem,1384,ml:SGD-PATE-sub25100-defpa,1,dpk-gurobi,block-composition-pa,poisson,ncd,ml:SGD-PATE,sub25100,defpa,Unlocking,0.2,MLPateGaussianMechanism,{'Optimal': 40},9101816,660711,61026,906216,115418,29075,8195600,545293,31951,3337,3307,3358,453,713,1805,2884,2594,1553,poisson-block-composition-pa
2310,sp_workloads,1690805680,wl_small_mem,1385,ml:SGD-PATE-sub25100-defpa,1,dpk-gurobi,block-composition-pa,poisson,ncd,ml:SGD-PATE,sub25100,defpa,Unlocking,0.4,MLNoisySGDMechanism,{'Optimal': 40},9612014,638642,60437,1832912,116249,29004,7779102,522393,31433,3436,3336,3371,714,654,1764,2722,2682,1607,poisson-block-composition-pa
2311,sp_workloads,1690805680,wl_small_mem,1385,ml:SGD-PATE-sub25100-defpa,1,dpk-gurobi,block-composition-pa,poisson,ncd,ml:SGD-PATE,sub25100,defpa,Unlocking,0.4,MLPateGaussianMechanism,{'Optimal': 40},9101816,660711,61026,949154,111553,30266,8152662,549158,30760,3337,3307,3358,478,745,1862,2859,2562,1496,poisson-block-composition-pa
2312,sp_workloads,1690805680,wl_small_mem,1386,ml:SGD-PATE-sub25100-defpa,1,dpk-gurobi,block-composition-pa,poisson,equal-ncd,ml:SGD-PATE,sub25100,defpa,Unlocking,0.2,MLNoisySGDMechanism,{'Optimal': 40},3436,3336,3371,540,1982,3371,2896,1354,0,3436,3336,3371,540,1982,3371,2896,1354,0,poisson-block-composition-pa
2313,sp_workloads,1690805680,wl_small_mem,1386,ml:SGD-PATE-sub25100-defpa,1,dpk-gurobi,block-composition-pa,poisson,equal-ncd,ml:SGD-PATE,sub25100,defpa,Unlocking,0.2,MLPateGaussianMechanism,{'Optimal': 40},3337,3307,3358,394,1866,3358,2943,1441,0,3337,3307,3358,394,1866,3358,2943,1441,0,poisson-block-composition-pa
2314,sp_workloads,1690805680,wl_small_mem,1387,ml:SGD-PATE-sub25100-defpa,1,dpk-gurobi,block-composition-pa,poisson,equal-ncd,ml:SGD-PATE,sub25100,defpa,Unlocking,0.4,MLNoisySGDMechanism,{'Optimal': 40},3436,3336,3371,532,2000,3371,2904,1336,0,3436,3336,3371,532,2000,3371,2904,1336,0,poisson-block-composition-pa
2315,sp_workloads,1690805680,wl_small_mem,1387,ml:SGD-PATE-sub25100-defpa,1,dpk-gurobi,block-composition-pa,poisson,equal-ncd,ml:SGD-PATE,sub25100,defpa,Unlocking,0.4,MLPateGaussianMechanism,{'Optimal': 40},3337,3307,3358,378,1848,3358,2959,1459,0,3337,3307,3358,378,1848,3358,2959,1459,0,poisson-block-composition-pa
2316,sp_workloads,1690805680,wl_small_mem,1388,ml:SGD-PATE-sub25100-defpa,2,dpk-gurobi,block-composition-pa,poisson,ncd,ml:SGD-PATE,sub25100,defpa,Unlocking,0.2,MLNoisySGDMechanism,{'Optimal': 40},9102086,650387,61289,1655620,127451,27124,7446466,522936,34165,3387,3344,3399,671,722,1660,2716,2622,1739,poisson-block-composition-pa
2317,sp_workloads,1690805680,wl_small_mem,1388,ml:SGD-PATE-sub25100-defpa,2,dpk-gurobi,block-composition-pa,poisson,ncd,ml:SGD-PATE,sub25100,defpa,Unlocking,0.2,MLPateGaussianMechanism,{'Optimal': 40},9667159,651460,60587,983415,123050,29350,8683744,528410,31237,3356,3340,3381,481,754,1834,2875,2586,1547,poisson-block-composition-pa
2318,sp_workloads,1690805680,wl_small_mem,1389,ml:SGD-PATE-sub25100-defpa,2,dpk-gurobi,block-composition-pa,poisson,ncd,ml:SGD-PATE,sub25100,defpa,Unlocking,0.4,MLNoisySGDMechanism,{'Optimal': 40},9102086,650387,61289,1659272,126570,28455,7442814,523817,32834,3387,3344,3399,695,734,1737,2692,2610,1662,poisson-block-composition-pa
2319,sp_workloads,1690805680,wl_small_mem,1389,ml:SGD-PATE-sub25100-defpa,2,dpk-gurobi,block-composition-pa,poisson,ncd,ml:SGD-PATE,sub25100,defpa,Unlocking,0.4,MLPateGaussianMechanism,{'Optimal': 40},9667159,651460,60587,1034382,134979,30185,8632777,516481,30402,3356,3340,3381,505,828,1895,2851,2512,1486,poisson-block-composition-pa
2320,sp_workloads,1690805680,wl_small_mem,1390,ml:SGD-PATE-sub25100-defpa,2,dpk-gurobi,block-composition-pa,poisson,equal-ncd,ml:SGD-PATE,sub25100,defpa,Unlocking,0.2,MLNoisySGDMechanism,{'Optimal': 40},3387,3344,3399,526,2053,3399,2861,1291,0,3387,3344,3399,526,2053,3399,2861,1291,0,poisson-block-composition-pa
2321,sp_workloads,1690805680,wl_small_mem,1390,ml:SGD-PATE-sub25100-defpa,2,dpk-gurobi,block-composition-pa,poisson,equal-ncd,ml:SGD-PATE,sub25100,defpa,Unlocking,0.2,MLPateGaussianMechanism,{'Optimal': 40},3356,3340,3381,376,1975,3381,2980,1365,0,3356,3340,3381,376,1975,3381,2980,1365,0,poisson-block-composition-pa
2322,sp_workloads,1690805680,wl_small_mem,1391,ml:SGD-PATE-sub25100-defpa,2,dpk-gurobi,block-composition-pa,poisson,equal-ncd,ml:SGD-PATE,sub25100,defpa,Unlocking,0.4,MLNoisySGDMechanism,{'Optimal': 40},3387,3344,3399,515,2064,3399,2872,1280,0,3387,3344,3399,515,2064,3399,2872,1280,0,poisson-block-composition-pa
2323,sp_workloads,1690805680,wl_small_mem,1391,ml:SGD-PATE-sub25100-defpa,2,dpk-gurobi,block-composition-pa,poisson,equal-ncd,ml:SGD-PATE,sub25100,defpa,Unlocking,0.4,MLPateGaussianMechanism,{'Optimal': 40},3356,3340,3381,373,1977,3381,2983,1363,0,3356,3340,3381,373,1977,3381,2983,1363,0,poisson-block-composition-pa
2324,sp_workloads,1690805680,wl_small_mem,1392,ml:SGD-PATE-sub25100-defpa,3,dpk-gurobi,block-composition-pa,poisson,ncd,ml:SGD-PATE,sub25100,defpa,Unlocking,0.2,MLNoisySGDMechanism,{'Optimal': 40},9538338,661542,60462,1696838,123967,28530,7841500,537575,31932,3432,3504,3362,666,691,1742,2766,2813,1620,poisson-block-composition-pa
2325,sp_workloads,1690805680,wl_small_mem,1392,ml:SGD-PATE-sub25100-defpa,3,dpk-gurobi,block-composition-pa,poisson,ncd,ml:SGD-PATE,sub25100,defpa,Unlocking,0.2,MLPateGaussianMechanism,{'Optimal': 40},9431567,656376,60193,985027,124027,29938,8446540,532349,30255,3379,3400,3343,519,755,1854,2860,2645,1489,poisson-block-composition-pa
2326,sp_workloads,1690805680,wl_small_mem,1393,ml:SGD-PATE-sub25100-defpa,3,dpk-gurobi,block-composition-pa,poisson,ncd,ml:SGD-PATE,sub25100,defpa,Unlocking,0.4,MLNoisySGDMechanism,{'Optimal': 40},9538338,661542,60462,1718667,133936,28523,7819671,527606,31939,3432,3504,3362,676,719,1749,2756,2785,1613,poisson-block-composition-pa
2327,sp_workloads,1690805680,wl_small_mem,1393,ml:SGD-PATE-sub25100-defpa,3,dpk-gurobi,block-composition-pa,poisson,ncd,ml:SGD-PATE,sub25100,defpa,Unlocking,0.4,MLPateGaussianMechanism,{'Optimal': 40},9431567,656376,60193,1056905,121273,30119,8374662,535103,30074,3379,3400,3343,528,784,1881,2851,2616,1462,poisson-block-composition-pa
2328,sp_workloads,1690805680,wl_small_mem,1394,ml:SGD-PATE-sub25100-defpa,3,dpk-gurobi,block-composition-pa,poisson,equal-ncd,ml:SGD-PATE,sub25100,defpa,Unlocking,0.2,MLNoisySGDMechanism,{'Optimal': 40},3432,3504,3362,497,2103,3362,2935,1401,0,3432,3504,3362,497,2103,3362,2935,1401,0,poisson-block-composition-pa
2329,sp_workloads,1690805680,wl_small_mem,1394,ml:SGD-PATE-sub25100-defpa,3,dpk-gurobi,block-composition-pa,poisson,equal-ncd,ml:SGD-PATE,sub25100,defpa,Unlocking,0.2,MLPateGaussianMechanism,{'Optimal': 40},3379,3400,3343,373,2006,3343,3006,1394,0,3379,3400,3343,373,2006,3343,3006,1394,0,poisson-block-composition-pa
2330,sp_workloads,1690805680,wl_small_mem,1395,ml:SGD-PATE-sub25100-defpa,3,dpk-gurobi,block-composition-pa,poisson,equal-ncd,ml:SGD-PATE,sub25100,defpa,Unlocking,0.4,MLNoisySGDMechanism,{'Optimal': 40},3432,3504,3362,478,2099,3362,2954,1405,0,3432,3504,3362,478,2099,3362,2954,1405,0,poisson-block-composition-pa
2331,sp_workloads,1690805680,wl_small_mem,1395,ml:SGD-PATE-sub25100-defpa,3,dpk-gurobi,block-composition-pa,poisson,equal-ncd,ml:SGD-PATE,sub25100,defpa,Unlocking,0.4,MLPateGaussianMechanism,{'Optimal': 40},3379,3400,3343,367,2008,3343,3012,1392,0,3379,3400,3343,367,2008,3343,3012,1392,0,poisson-block-composition-pa
2332,sp_workloads,1690805680,wl_small_mem,1396,ml:SGD-PATE-sub25100-defpa,4,dpk-gurobi,block-composition-pa,poisson,ncd,ml:SGD-PATE,sub25100,defpa,Unlocking,0.2,MLNoisySGDMechanism,{'Optimal': 40},9619476,680600,63408,1827011,124973,28496,7792465,555627,34912,3443,3381,3350,720,696,1647,2723,2685,1703,poisson-block-composition-pa
2333,sp_workloads,1690805680,wl_small_mem,1396,ml:SGD-PATE-sub25100-defpa,4,dpk-gurobi,block-composition-pa,poisson,ncd,ml:SGD-PATE,sub25100,defpa,Unlocking,0.2,MLPateGaussianMechanism,{'Optimal': 40},9087643,650021,64528,937102,117357,32640,8150541,532664,31888,3245,3345,3408,492,764,1924,2753,2581,1484,poisson-block-composition-pa
2334,sp_workloads,1690805680,wl_small_mem,1397,ml:SGD-PATE-sub25100-defpa,4,dpk-gurobi,block-composition-pa,poisson,ncd,ml:SGD-PATE,sub25100,defpa,Unlocking,0.4,MLNoisySGDMechanism,{'Optimal': 40},9619476,680600,63408,1827835,125852,29296,7791641,554748,34112,3443,3381,3350,714,700,1698,2729,2681,1652,poisson-block-composition-pa
2335,sp_workloads,1690805680,wl_small_mem,1397,ml:SGD-PATE-sub25100-defpa,4,dpk-gurobi,block-composition-pa,poisson,ncd,ml:SGD-PATE,sub25100,defpa,Unlocking,0.4,MLPateGaussianMechanism,{'Optimal': 40},9087643,650021,64528,991253,119800,32832,8096390,530221,31696,3245,3345,3408,503,783,1935,2742,2562,1473,poisson-block-composition-pa
2336,sp_workloads,1690805680,wl_small_mem,1398,ml:SGD-PATE-sub25100-defpa,4,dpk-gurobi,block-composition-pa,poisson,equal-ncd,ml:SGD-PATE,sub25100,defpa,Unlocking,0.2,MLNoisySGDMechanism,{'Optimal': 40},3443,3381,3350,540,2034,3344,2903,1347,6,3443,3381,3350,540,2034,3344,2903,1347,6,poisson-block-composition-pa
2337,sp_workloads,1690805680,wl_small_mem,1398,ml:SGD-PATE-sub25100-defpa,4,dpk-gurobi,block-composition-pa,poisson,equal-ncd,ml:SGD-PATE,sub25100,defpa,Unlocking,0.2,MLPateGaussianMechanism,{'Optimal': 40},3245,3345,3408,363,1911,3403,2882,1434,5,3245,3345,3408,363,1911,3403,2882,1434,5,poisson-block-composition-pa
2338,sp_workloads,1690805680,wl_small_mem,1399,ml:SGD-PATE-sub25100-defpa,4,dpk-gurobi,block-composition-pa,poisson,equal-ncd,ml:SGD-PATE,sub25100,defpa,Unlocking,0.4,MLNoisySGDMechanism,{'Optimal': 40},3443,3381,3350,517,2047,3350,2926,1334,0,3443,3381,3350,517,2047,3350,2926,1334,0,poisson-block-composition-pa
2339,sp_workloads,1690805680,wl_small_mem,1399,ml:SGD-PATE-sub25100-defpa,4,dpk-gurobi,block-composition-pa,poisson,equal-ncd,ml:SGD-PATE,sub25100,defpa,Unlocking,0.4,MLPateGaussianMechanism,{'Optimal': 40},3245,3345,3408,367,1923,3408,2878,1422,0,3245,3345,3408,367,1923,3408,2878,1422,0,poisson-block-composition-pa
2340,sp_workloads,1690805680,wl_small_mem,1400,mixed:GM-LM-RR-LSVT-SGD-PATE-sub25100-defpa,0,dpk-gurobi,block-composition-pa,poisson,ncd,mixed:GM-LM-RR-LSVT-SGD-PATE,sub25100,defpa,Unlocking,0.2,GaussianMechanism,{'Optimal': 40},3326864,216518,19768,1686408,166312,17917,1640456,50206,1851,1098,1121,1112,559,863,1011,539,258,101,poisson-block-composition-pa
2341,sp_workloads,1690805680,wl_small_mem,1400,mixed:GM-LM-RR-LSVT-SGD-PATE-sub25100-defpa,0,dpk-gurobi,block-composition-pa,poisson,ncd,mixed:GM-LM-RR-LSVT-SGD-PATE,sub25100,defpa,Unlocking,0.2,LaplaceMechanism,{'Optimal': 40},3160262,214484,19740,793827,99730,18253,2366435,114754,1487,1133,1141,1092,386,583,1011,747,558,81,poisson-block-composition-pa
2342,sp_workloads,1690805680,wl_small_mem,1400,mixed:GM-LM-RR-LSVT-SGD-PATE-sub25100-defpa,0,dpk-gurobi,block-composition-pa,poisson,ncd,mixed:GM-LM-RR-LSVT-SGD-PATE,sub25100,defpa,Unlocking,0.2,MLNoisySGDMechanism,{'Optimal': 40},3049683,202901,20644,262791,29407,8939,2786892,173494,11705,1124,1132,1148,107,198,549,1017,934,599,poisson-block-composition-pa
2343,sp_workloads,1690805680,wl_small_mem,1400,mixed:GM-LM-RR-LSVT-SGD-PATE-sub25100-defpa,0,dpk-gurobi,block-composition-pa,poisson,ncd,mixed:GM-LM-RR-LSVT-SGD-PATE,sub25100,defpa,Unlocking,0.2,MLPateGaussianMechanism,{'Optimal': 40},3104776,219595,19804,154338,33557,9636,2950438,186038,10168,1159,1162,1108,78,231,604,1081,931,504,poisson-block-composition-pa
2344,sp_workloads,1690805680,wl_small_mem,1400,mixed:GM-LM-RR-LSVT-SGD-PATE-sub25100-defpa,0,dpk-gurobi,block-composition-pa,poisson,ncd,mixed:GM-LM-RR-LSVT-SGD-PATE,sub25100,defpa,Unlocking,0.2,RandResponseMechanism,{'Optimal': 40},3027994,204361,19932,57785,7961,6145,2970209,196400,13787,1129,1138,1140,25,46,383,1104,1092,757,poisson-block-composition-pa
2345,sp_workloads,1690805680,wl_small_mem,1400,mixed:GM-LM-RR-LSVT-SGD-PATE-sub25100-defpa,0,dpk-gurobi,block-composition-pa,poisson,ncd,mixed:GM-LM-RR-LSVT-SGD-PATE,sub25100,defpa,Unlocking,0.2,SVTLaplaceMechanism,{'Optimal': 40},3254745,215442,20539,58977,7036,5567,3195768,208406,14972,1155,1111,1125,30,42,337,1125,1069,788,poisson-block-composition-pa
2346,sp_workloads,1690805680,wl_small_mem,1401,mixed:GM-LM-RR-LSVT-SGD-PATE-sub25100-defpa,0,dpk-gurobi,block-composition-pa,poisson,ncd,mixed:GM-LM-RR-LSVT-SGD-PATE,sub25100,defpa,Unlocking,0.4,GaussianMechanism,{'Optimal': 40},3326864,216518,19768,1805489,174202,17932,1521375,42316,1836,1098,1121,1112,614,881,1012,484,240,100,poisson-block-composition-pa
2347,sp_workloads,1690805680,wl_small_mem,1401,mixed:GM-LM-RR-LSVT-SGD-PATE-sub25100-defpa,0,dpk-gurobi,block-composition-pa,poisson,ncd,mixed:GM-LM-RR-LSVT-SGD-PATE,sub25100,defpa,Unlocking,0.4,LaplaceMechanism,{'Optimal': 40},3160262,214484,19740,1104587,97411,18418,2055675,117073,1322,1133,1141,1092,452,589,1022,681,552,70,poisson-block-composition-pa
2348,sp_workloads,1690805680,wl_small_mem,1401,mixed:GM-LM-RR-LSVT-SGD-PATE-sub25100-defpa,0,dpk-gurobi,block-composition-pa,poisson,ncd,mixed:GM-LM-RR-LSVT-SGD-PATE,sub25100,defpa,Unlocking,0.4,MLNoisySGDMechanism,{'Optimal': 40},3049683,202901,20644,270560,37992,9055,2779123,164909,11589,1124,1132,1148,120,230,561,1004,902,587,poisson-block-composition-pa
2349,sp_workloads,1690805680,wl_small_mem,1401,mixed:GM-LM-RR-LSVT-SGD-PATE-sub25100-defpa,0,dpk-gurobi,block-composition-pa,poisson,ncd,mixed:GM-LM-RR-LSVT-SGD-PATE,sub25100,defpa,Unlocking,0.4,MLPateGaussianMechanism,{'Optimal': 40},3104776,219595,19804,195830,42954,9209,2908946,176641,10595,1159,1162,1108,102,292,583,1057,870,525,poisson-block-composition-pa
2350,sp_workloads,1690805680,wl_small_mem,1401,mixed:GM-LM-RR-LSVT-SGD-PATE-sub25100-defpa,0,dpk-gurobi,block-composition-pa,poisson,ncd,mixed:GM-LM-RR-LSVT-SGD-PATE,sub25100,defpa,Unlocking,0.4,RandResponseMechanism,{'Optimal': 40},3027994,204361,19932,60465,8240,6521,2967529,196121,13411,1129,1138,1140,22,51,407,1107,1087,733,poisson-block-composition-pa
2351,sp_workloads,1690805680,wl_small_mem,1401,mixed:GM-LM-RR-LSVT-SGD-PATE-sub25100-defpa,0,dpk-gurobi,block-composition-pa,poisson,ncd,mixed:GM-LM-RR-LSVT-SGD-PATE,sub25100,defpa,Unlocking,0.4,SVTLaplaceMechanism,{'Optimal': 40},3254745,215442,20539,78671,8260,5830,3176074,207182,14709,1155,1111,1125,28,46,362,1127,1065,763,poisson-block-composition-pa
2352,sp_workloads,1690805680,wl_small_mem,1402,mixed:GM-LM-RR-LSVT-SGD-PATE-sub25100-defpa,0,dpk-gurobi,block-composition-pa,poisson,equal-ncd,mixed:GM-LM-RR-LSVT-SGD-PATE,sub25100,defpa,Unlocking,0.2,GaussianMechanism,{'Optimal': 40},1098,1121,1112,510,1053,1111,588,68,1,1098,1121,1112,510,1053,1111,588,68,1,poisson-block-composition-pa
2353,sp_workloads,1690805680,wl_small_mem,1402,mixed:GM-LM-RR-LSVT-SGD-PATE-sub25100-defpa,0,dpk-gurobi,block-composition-pa,poisson,equal-ncd,mixed:GM-LM-RR-LSVT-SGD-PATE,sub25100,defpa,Unlocking,0.2,LaplaceMechanism,{'Optimal': 40},1133,1141,1092,392,805,1092,741,336,0,1133,1141,1092,392,805,1092,741,336,0,poisson-block-composition-pa
2354,sp_workloads,1690805680,wl_small_mem,1402,mixed:GM-LM-RR-LSVT-SGD-PATE-sub25100-defpa,0,dpk-gurobi,block-composition-pa,poisson,equal-ncd,mixed:GM-LM-RR-LSVT-SGD-PATE,sub25100,defpa,Unlocking,0.2,MLNoisySGDMechanism,{'Optimal': 40},1124,1132,1148,131,611,1117,993,521,31,1124,1132,1148,131,611,1117,993,521,31,poisson-block-composition-pa
2355,sp_workloads,1690805680,wl_small_mem,1402,mixed:GM-LM-RR-LSVT-SGD-PATE-sub25100-defpa,0,dpk-gurobi,block-composition-pa,poisson,equal-ncd,mixed:GM-LM-RR-LSVT-SGD-PATE,sub25100,defpa,Unlocking,0.2,MLPateGaussianMechanism,{'Optimal': 40},1159,1162,1108,102,635,1063,1057,527,45,1159,1162,1108,102,635,1063,1057,527,45,poisson-block-composition-pa
2356,sp_workloads,1690805680,wl_small_mem,1402,mixed:GM-LM-RR-LSVT-SGD-PATE-sub25100-defpa,0,dpk-gurobi,block-composition-pa,poisson,equal-ncd,mixed:GM-LM-RR-LSVT-SGD-PATE,sub25100,defpa,Unlocking,0.2,RandResponseMechanism,{'Optimal': 40},1129,1138,1140,15,125,1031,1114,1013,109,1129,1138,1140,15,125,1031,1114,1013,109,poisson-block-composition-pa
2357,sp_workloads,1690805680,wl_small_mem,1402,mixed:GM-LM-RR-LSVT-SGD-PATE-sub25100-defpa,0,dpk-gurobi,block-composition-pa,poisson,equal-ncd,mixed:GM-LM-RR-LSVT-SGD-PATE,sub25100,defpa,Unlocking,0.2,SVTLaplaceMechanism,{'Optimal': 40},1155,1111,1125,29,111,997,1126,1000,128,1155,1111,1125,29,111,997,1126,1000,128,poisson-block-composition-pa
2358,sp_workloads,1690805680,wl_small_mem,1403,mixed:GM-LM-RR-LSVT-SGD-PATE-sub25100-defpa,0,dpk-gurobi,block-composition-pa,poisson,equal-ncd,mixed:GM-LM-RR-LSVT-SGD-PATE,sub25100,defpa,Unlocking,0.4,GaussianMechanism,{'Optimal': 40},1098,1121,1112,538,1057,1112,560,64,0,1098,1121,1112,538,1057,1112,560,64,0,poisson-block-composition-pa
2359,sp_workloads,1690805680,wl_small_mem,1403,mixed:GM-LM-RR-LSVT-SGD-PATE-sub25100-defpa,0,dpk-gurobi,block-composition-pa,poisson,equal-ncd,mixed:GM-LM-RR-LSVT-SGD-PATE,sub25100,defpa,Unlocking,0.4,LaplaceMechanism,{'Optimal': 40},1133,1141,1092,417,837,1092,716,304,0,1133,1141,1092,417,837,1092,716,304,0,poisson-block-composition-pa
2360,sp_workloads,1690805680,wl_small_mem,1403,mixed:GM-LM-RR-LSVT-SGD-PATE-sub25100-defpa,0,dpk-gurobi,block-composition-pa,poisson,equal-ncd,mixed:GM-LM-RR-LSVT-SGD-PATE,sub25100,defpa,Unlocking,0.4,MLNoisySGDMechanism,{'Optimal': 40},1124,1132,1148,144,614,1138,980,518,10,1124,1132,1148,144,614,1138,980,518,10,poisson-block-composition-pa
2361,sp_workloads,1690805680,wl_small_mem,1403,mixed:GM-LM-RR-LSVT-SGD-PATE-sub25100-defpa,0,dpk-gurobi,block-composition-pa,poisson,equal-ncd,mixed:GM-LM-RR-LSVT-SGD-PATE,sub25100,defpa,Unlocking,0.4,MLPateGaussianMechanism,{'Optimal': 40},1159,1162,1108,110,651,1070,1049,511,38,1159,1162,1108,110,651,1070,1049,511,38,poisson-block-composition-pa
2362,sp_workloads,1690805680,wl_small_mem,1403,mixed:GM-LM-RR-LSVT-SGD-PATE-sub25100-defpa,0,dpk-gurobi,block-composition-pa,poisson,equal-ncd,mixed:GM-LM-RR-LSVT-SGD-PATE,sub25100,defpa,Unlocking,0.4,RandResponseMechanism,{'Optimal': 40},1129,1138,1140,20,134,1047,1109,1004,93,1129,1138,1140,20,134,1047,1109,1004,93,poisson-block-composition-pa
2363,sp_workloads,1690805680,wl_small_mem,1403,mixed:GM-LM-RR-LSVT-SGD-PATE-sub25100-defpa,0,dpk-gurobi,block-composition-pa,poisson,equal-ncd,mixed:GM-LM-RR-LSVT-SGD-PATE,sub25100,defpa,Unlocking,0.4,SVTLaplaceMechanism,{'Optimal': 40},1155,1111,1125,33,126,1016,1122,985,109,1155,1111,1125,33,126,1016,1122,985,109,poisson-block-composition-pa
2364,sp_workloads,1690805680,wl_small_mem,1404,mixed:GM-LM-RR-LSVT-SGD-PATE-sub25100-defpa,1,dpk-gurobi,block-composition-pa,poisson,ncd,mixed:GM-LM-RR-LSVT-SGD-PATE,sub25100,defpa,Unlocking,0.2,GaussianMechanism,{'Optimal': 40},3139319,215782,21216,1595450,167858,19104,1543869,47924,2112,1075,1140,1126,551,876,1021,524,264,105,poisson-block-composition-pa
2365,sp_workloads,1690805680,wl_small_mem,1404,mixed:GM-LM-RR-LSVT-SGD-PATE-sub25100-defpa,1,dpk-gurobi,block-composition-pa,poisson,ncd,mixed:GM-LM-RR-LSVT-SGD-PATE,sub25100,defpa,Unlocking,0.2,LaplaceMechanism,{'Optimal': 40},3080200,239601,21344,847662,117314,19264,2232538,122287,2080,1140,1163,1130,415,600,1027,725,563,103,poisson-block-composition-pa
2366,sp_workloads,1690805680,wl_small_mem,1404,mixed:GM-LM-RR-LSVT-SGD-PATE-sub25100-defpa,1,dpk-gurobi,block-composition-pa,poisson,ncd,mixed:GM-LM-RR-LSVT-SGD-PATE,sub25100,defpa,Unlocking,0.2,MLNoisySGDMechanism,{'Optimal': 40},3197047,217314,22128,287194,31414,10240,2909853,185900,11888,1145,1089,1161,110,195,588,1035,894,573,poisson-block-composition-pa
2367,sp_workloads,1690805680,wl_small_mem,1404,mixed:GM-LM-RR-LSVT-SGD-PATE-sub25100-defpa,1,dpk-gurobi,block-composition-pa,poisson,ncd,mixed:GM-LM-RR-LSVT-SGD-PATE,sub25100,defpa,Unlocking,0.2,MLPateGaussianMechanism,{'Optimal': 40},3203621,231498,21632,144486,46437,10480,3059135,185061,11152,1163,1144,1138,81,289,619,1082,855,519,poisson-block-composition-pa
2368,sp_workloads,1690805680,wl_small_mem,1404,mixed:GM-LM-RR-LSVT-SGD-PATE-sub25100-defpa,1,dpk-gurobi,block-composition-pa,poisson,ncd,mixed:GM-LM-RR-LSVT-SGD-PATE,sub25100,defpa,Unlocking,0.2,RandResponseMechanism,{'Optimal': 40},3122577,243521,22560,46041,11755,7056,3076536,231766,15504,1093,1164,1181,31,58,398,1062,1106,783,poisson-block-composition-pa
2369,sp_workloads,1690805680,wl_small_mem,1404,mixed:GM-LM-RR-LSVT-SGD-PATE-sub25100-defpa,1,dpk-gurobi,block-composition-pa,poisson,ncd,mixed:GM-LM-RR-LSVT-SGD-PATE,sub25100,defpa,Unlocking,0.2,SVTLaplaceMechanism,{'Optimal': 40},3189411,227364,20784,58820,9197,5936,3130591,218167,14848,1178,1127,1089,31,54,344,1147,1073,745,poisson-block-composition-pa
2370,sp_workloads,1690805680,wl_small_mem,1405,mixed:GM-LM-RR-LSVT-SGD-PATE-sub25100-defpa,1,dpk-gurobi,block-composition-pa,poisson,ncd,mixed:GM-LM-RR-LSVT-SGD-PATE,sub25100,defpa,Unlocking,0.4,GaussianMechanism,{'Optimal': 40},3139319,215782,21216,1677933,171678,19248,1461386,44104,1968,1075,1140,1126,591,895,1029,484,245,97,poisson-block-composition-pa
2371,sp_workloads,1690805680,wl_small_mem,1405,mixed:GM-LM-RR-LSVT-SGD-PATE-sub25100-defpa,1,dpk-gurobi,block-composition-pa,poisson,ncd,mixed:GM-LM-RR-LSVT-SGD-PATE,sub25100,defpa,Unlocking,0.4,LaplaceMechanism,{'Optimal': 40},3080200,239601,21344,1171253,113562,19536,1908947,126039,1808,1140,1163,1130,464,600,1041,676,563,89,poisson-block-composition-pa
2372,sp_workloads,1690805680,wl_small_mem,1405,mixed:GM-LM-RR-LSVT-SGD-PATE-sub25100-defpa,1,dpk-gurobi,block-composition-pa,poisson,ncd,mixed:GM-LM-RR-LSVT-SGD-PATE,sub25100,defpa,Unlocking,0.4,MLNoisySGDMechanism,{'Optimal': 40},3197047,217314,22128,306444,36415,11200,2890603,180899,10928,1145,1089,1161,135,222,637,1010,867,524,poisson-block-composition-pa
2373,sp_workloads,1690805680,wl_small_mem,1405,mixed:GM-LM-RR-LSVT-SGD-PATE-sub25100-defpa,1,dpk-gurobi,block-composition-pa,poisson,ncd,mixed:GM-LM-RR-LSVT-SGD-PATE,sub25100,defpa,Unlocking,0.4,MLPateGaussianMechanism,{'Optimal': 40},3203621,231498,21632,238171,43677,10784,2965450,187821,10848,1163,1144,1138,120,299,636,1043,845,502,poisson-block-composition-pa
2374,sp_workloads,1690805680,wl_small_mem,1405,mixed:GM-LM-RR-LSVT-SGD-PATE-sub25100-defpa,1,dpk-gurobi,block-composition-pa,poisson,ncd,mixed:GM-LM-RR-LSVT-SGD-PATE,sub25100,defpa,Unlocking,0.4,RandResponseMechanism,{'Optimal': 40},3122577,243521,22560,36782,11478,7760,3085795,232043,14800,1093,1164,1181,29,56,438,1064,1108,743,poisson-block-composition-pa
2375,sp_workloads,1690805680,wl_small_mem,1405,mixed:GM-LM-RR-LSVT-SGD-PATE-sub25100-defpa,1,dpk-gurobi,block-composition-pa,poisson,ncd,mixed:GM-LM-RR-LSVT-SGD-PATE,sub25100,defpa,Unlocking,0.4,SVTLaplaceMechanism,{'Optimal': 40},3189411,227364,20784,86680,7179,7104,3102731,220185,13680,1178,1127,1089,34,49,407,1144,1078,682,poisson-block-composition-pa
2376,sp_workloads,1690805680,wl_small_mem,1406,mixed:GM-LM-RR-LSVT-SGD-PATE-sub25100-defpa,1,dpk-gurobi,block-composition-pa,poisson,equal-ncd,mixed:GM-LM-RR-LSVT-SGD-PATE,sub25100,defpa,Unlocking,0.2,GaussianMechanism,{'Optimal': 40},1075,1140,1126,491,1078,1125,584,62,1,1075,1140,1126,491,1078,1125,584,62,1,poisson-block-composition-pa
2377,sp_workloads,1690805680,wl_small_mem,1406,mixed:GM-LM-RR-LSVT-SGD-PATE-sub25100-defpa,1,dpk-gurobi,block-composition-pa,poisson,equal-ncd,mixed:GM-LM-RR-LSVT-SGD-PATE,sub25100,defpa,Unlocking,0.2,LaplaceMechanism,{'Optimal': 40},1140,1163,1130,440,782,1130,700,381,0,1140,1163,1130,440,782,1130,700,381,0,poisson-block-composition-pa
2378,sp_workloads,1690805680,wl_small_mem,1406,mixed:GM-LM-RR-LSVT-SGD-PATE-sub25100-defpa,1,dpk-gurobi,block-composition-pa,poisson,equal-ncd,mixed:GM-LM-RR-LSVT-SGD-PATE,sub25100,defpa,Unlocking,0.2,MLNoisySGDMechanism,{'Optimal': 40},1145,1089,1161,156,573,1119,989,516,42,1145,1089,1161,156,573,1119,989,516,42,poisson-block-composition-pa
2379,sp_workloads,1690805680,wl_small_mem,1406,mixed:GM-LM-RR-LSVT-SGD-PATE-sub25100-defpa,1,dpk-gurobi,block-composition-pa,poisson,equal-ncd,mixed:GM-LM-RR-LSVT-SGD-PATE,sub25100,defpa,Unlocking,0.2,MLPateGaussianMechanism,{'Optimal': 40},1163,1144,1138,114,620,1081,1049,524,57,1163,1144,1138,114,620,1081,1049,524,57,poisson-block-composition-pa
2380,sp_workloads,1690805680,wl_small_mem,1406,mixed:GM-LM-RR-LSVT-SGD-PATE-sub25100-defpa,1,dpk-gurobi,block-composition-pa,poisson,equal-ncd,mixed:GM-LM-RR-LSVT-SGD-PATE,sub25100,defpa,Unlocking,0.2,RandResponseMechanism,{'Optimal': 40},1093,1164,1181,28,131,1052,1065,1033,129,1093,1164,1181,28,131,1052,1065,1033,129,poisson-block-composition-pa
2381,sp_workloads,1690805680,wl_small_mem,1406,mixed:GM-LM-RR-LSVT-SGD-PATE-sub25100-defpa,1,dpk-gurobi,block-composition-pa,poisson,equal-ncd,mixed:GM-LM-RR-LSVT-SGD-PATE,sub25100,defpa,Unlocking,0.2,SVTLaplaceMechanism,{'Optimal': 40},1178,1127,1089,22,125,957,1156,1002,132,1178,1127,1089,22,125,957,1156,1002,132,poisson-block-composition-pa
2382,sp_workloads,1690805680,wl_small_mem,1407,mixed:GM-LM-RR-LSVT-SGD-PATE-sub25100-defpa,1,dpk-gurobi,block-composition-pa,poisson,equal-ncd,mixed:GM-LM-RR-LSVT-SGD-PATE,sub25100,defpa,Unlocking,0.4,GaussianMechanism,{'Optimal': 40},1075,1140,1126,522,1076,1126,553,64,0,1075,1140,1126,522,1076,1126,553,64,0,poisson-block-composition-pa
2383,sp_workloads,1690805680,wl_small_mem,1407,mixed:GM-LM-RR-LSVT-SGD-PATE-sub25100-defpa,1,dpk-gurobi,block-composition-pa,poisson,equal-ncd,mixed:GM-LM-RR-LSVT-SGD-PATE,sub25100,defpa,Unlocking,0.4,LaplaceMechanism,{'Optimal': 40},1140,1163,1130,448,813,1130,692,350,0,1140,1163,1130,448,813,1130,692,350,0,poisson-block-composition-pa
2384,sp_workloads,1690805680,wl_small_mem,1407,mixed:GM-LM-RR-LSVT-SGD-PATE-sub25100-defpa,1,dpk-gurobi,block-composition-pa,poisson,equal-ncd,mixed:GM-LM-RR-LSVT-SGD-PATE,sub25100,defpa,Unlocking,0.4,MLNoisySGDMechanism,{'Optimal': 40},1145,1089,1161,159,603,1157,986,486,4,1145,1089,1161,159,603,1157,986,486,4,poisson-block-composition-pa
2385,sp_workloads,1690805680,wl_small_mem,1407,mixed:GM-LM-RR-LSVT-SGD-PATE-sub25100-defpa,1,dpk-gurobi,block-composition-pa,poisson,equal-ncd,mixed:GM-LM-RR-LSVT-SGD-PATE,sub25100,defpa,Unlocking,0.4,MLPateGaussianMechanism,{'Optimal': 40},1163,1144,1138,119,662,1117,1044,482,21,1163,1144,1138,119,662,1117,1044,482,21,poisson-block-composition-pa
2386,sp_workloads,1690805680,wl_small_mem,1407,mixed:GM-LM-RR-LSVT-SGD-PATE-sub25100-defpa,1,dpk-gurobi,block-composition-pa,poisson,equal-ncd,mixed:GM-LM-RR-LSVT-SGD-PATE,sub25100,defpa,Unlocking,0.4,RandResponseMechanism,{'Optimal': 40},1093,1164,1181,29,132,1102,1064,1032,79,1093,1164,1181,29,132,1102,1064,1032,79,poisson-block-composition-pa
2387,sp_workloads,1690805680,wl_small_mem,1407,mixed:GM-LM-RR-LSVT-SGD-PATE-sub25100-defpa,1,dpk-gurobi,block-composition-pa,poisson,equal-ncd,mixed:GM-LM-RR-LSVT-SGD-PATE,sub25100,defpa,Unlocking,0.4,SVTLaplaceMechanism,{'Optimal': 40},1178,1127,1089,27,138,1010,1151,989,79,1178,1127,1089,27,138,1010,1151,989,79,poisson-block-composition-pa
2388,sp_workloads,1690805680,wl_small_mem,1408,mixed:GM-LM-RR-LSVT-SGD-PATE-sub25100-defpa,2,dpk-gurobi,block-composition-pa,poisson,ncd,mixed:GM-LM-RR-LSVT-SGD-PATE,sub25100,defpa,Unlocking,0.2,GaussianMechanism,{'Optimal': 40},3297557,222693,20889,1744745,170263,19158,1552812,52430,1731,1107,1156,1159,586,910,1066,521,246,93,poisson-block-composition-pa
2389,sp_workloads,1690805680,wl_small_mem,1408,mixed:GM-LM-RR-LSVT-SGD-PATE-sub25100-defpa,2,dpk-gurobi,block-composition-pa,poisson,ncd,mixed:GM-LM-RR-LSVT-SGD-PATE,sub25100,defpa,Unlocking,0.2,LaplaceMechanism,{'Optimal': 40},2847135,226653,20024,864315,99416,18169,1982820,127237,1855,1061,1136,1112,370,566,1015,691,570,97,poisson-block-composition-pa
2390,sp_workloads,1690805680,wl_small_mem,1408,mixed:GM-LM-RR-LSVT-SGD-PATE-sub25100-defpa,2,dpk-gurobi,block-composition-pa,poisson,ncd,mixed:GM-LM-RR-LSVT-SGD-PATE,sub25100,defpa,Unlocking,0.2,MLNoisySGDMechanism,{'Optimal': 40},3065470,217531,20600,264995,35287,10225,2800475,182244,10375,1088,1113,1144,105,206,623,983,907,521,poisson-block-composition-pa
2391,sp_workloads,1690805680,wl_small_mem,1408,mixed:GM-LM-RR-LSVT-SGD-PATE-sub25100-defpa,2,dpk-gurobi,block-composition-pa,poisson,ncd,mixed:GM-LM-RR-LSVT-SGD-PATE,sub25100,defpa,Unlocking,0.2,MLPateGaussianMechanism,{'Optimal': 40},3183074,228777,19443,146002,39782,10286,3037072,188995,9157,1123,1178,1085,73,277,642,1050,901,443,poisson-block-composition-pa
2392,sp_workloads,1690805680,wl_small_mem,1408,mixed:GM-LM-RR-LSVT-SGD-PATE-sub25100-defpa,2,dpk-gurobi,block-composition-pa,poisson,ncd,mixed:GM-LM-RR-LSVT-SGD-PATE,sub25100,defpa,Unlocking,0.2,RandResponseMechanism,{'Optimal': 40},3253029,217115,19830,72658,10767,6705,3180371,206348,13125,1136,1135,1114,30,52,415,1106,1083,699,poisson-block-composition-pa
2393,sp_workloads,1690805680,wl_small_mem,1408,mixed:GM-LM-RR-LSVT-SGD-PATE-sub25100-defpa,2,dpk-gurobi,block-composition-pa,poisson,ncd,mixed:GM-LM-RR-LSVT-SGD-PATE,sub25100,defpa,Unlocking,0.2,SVTLaplaceMechanism,{'Optimal': 40},3041723,217557,19755,18200,11244,6750,3023523,206313,13005,1106,1092,1109,17,55,418,1089,1037,691,poisson-block-composition-pa
2394,sp_workloads,1690805680,wl_small_mem,1409,mixed:GM-LM-RR-LSVT-SGD-PATE-sub25100-defpa,2,dpk-gurobi,block-composition-pa,poisson,ncd,mixed:GM-LM-RR-LSVT-SGD-PATE,sub25100,defpa,Unlocking,0.4,GaussianMechanism,{'Optimal': 40},3297557,222693,20889,1869392,176523,19083,1428165,46170,1806,1107,1156,1159,637,910,1061,470,246,98,poisson-block-composition-pa
2395,sp_workloads,1690805680,wl_small_mem,1409,mixed:GM-LM-RR-LSVT-SGD-PATE-sub25100-defpa,2,dpk-gurobi,block-composition-pa,poisson,ncd,mixed:GM-LM-RR-LSVT-SGD-PATE,sub25100,defpa,Unlocking,0.4,LaplaceMechanism,{'Optimal': 40},2847135,226653,20024,1134855,106183,18147,1712280,120470,1877,1061,1136,1112,415,589,1021,646,547,91,poisson-block-composition-pa
2396,sp_workloads,1690805680,wl_small_mem,1409,mixed:GM-LM-RR-LSVT-SGD-PATE-sub25100-defpa,2,dpk-gurobi,block-composition-pa,poisson,ncd,mixed:GM-LM-RR-LSVT-SGD-PATE,sub25100,defpa,Unlocking,0.4,MLNoisySGDMechanism,{'Optimal': 40},3065470,217531,20600,240009,36621,10590,2825461,180910,10010,1088,1113,1144,104,234,642,984,879,502,poisson-block-composition-pa
2397,sp_workloads,1690805680,wl_small_mem,1409,mixed:GM-LM-RR-LSVT-SGD-PATE-sub25100-defpa,2,dpk-gurobi,block-composition-pa,poisson,ncd,mixed:GM-LM-RR-LSVT-SGD-PATE,sub25100,defpa,Unlocking,0.4,MLPateGaussianMechanism,{'Optimal': 40},3183074,228777,19443,207418,43740,9862,2975656,185037,9581,1123,1178,1085,103,303,618,1020,875,467,poisson-block-composition-pa
2398,sp_workloads,1690805680,wl_small_mem,1409,mixed:GM-LM-RR-LSVT-SGD-PATE-sub25100-defpa,2,dpk-gurobi,block-composition-pa,poisson,ncd,mixed:GM-LM-RR-LSVT-SGD-PATE,sub25100,defpa,Unlocking,0.4,RandResponseMechanism,{'Optimal': 40},3253029,217115,19830,95540,10165,6683,3157489,206950,13147,1136,1135,1114,37,47,421,1099,1088,693,poisson-block-composition-pa
2399,sp_workloads,1690805680,wl_small_mem,1409,mixed:GM-LM-RR-LSVT-SGD-PATE-sub25100-defpa,2,dpk-gurobi,block-composition-pa,poisson,ncd,mixed:GM-LM-RR-LSVT-SGD-PATE,sub25100,defpa,Unlocking,0.4,SVTLaplaceMechanism,{'Optimal': 40},3041723,217557,19755,43333,10413,6722,2998390,207144,13033,1106,1092,1109,20,56,414,1086,1036,695,poisson-block-composition-pa
2400,sp_workloads,1690805680,wl_small_mem,1410,mixed:GM-LM-RR-LSVT-SGD-PATE-sub25100-defpa,2,dpk-gurobi,block-composition-pa,poisson,equal-ncd,mixed:GM-LM-RR-LSVT-SGD-PATE,sub25100,defpa,Unlocking,0.2,GaussianMechanism,{'Optimal': 40},1107,1156,1159,537,1092,1159,570,64,0,1107,1156,1159,537,1092,1159,570,64,0,poisson-block-composition-pa
2401,sp_workloads,1690805680,wl_small_mem,1410,mixed:GM-LM-RR-LSVT-SGD-PATE-sub25100-defpa,2,dpk-gurobi,block-composition-pa,poisson,equal-ncd,mixed:GM-LM-RR-LSVT-SGD-PATE,sub25100,defpa,Unlocking,0.2,LaplaceMechanism,{'Optimal': 40},1061,1136,1112,377,787,1110,684,349,2,1061,1136,1112,377,787,1110,684,349,2,poisson-block-composition-pa
2402,sp_workloads,1690805680,wl_small_mem,1410,mixed:GM-LM-RR-LSVT-SGD-PATE-sub25100-defpa,2,dpk-gurobi,block-composition-pa,poisson,equal-ncd,mixed:GM-LM-RR-LSVT-SGD-PATE,sub25100,defpa,Unlocking,0.2,MLNoisySGDMechanism,{'Optimal': 40},1088,1113,1144,120,598,1107,968,515,37,1088,1113,1144,120,598,1107,968,515,37,poisson-block-composition-pa
2403,sp_workloads,1690805680,wl_small_mem,1410,mixed:GM-LM-RR-LSVT-SGD-PATE-sub25100-defpa,2,dpk-gurobi,block-composition-pa,poisson,equal-ncd,mixed:GM-LM-RR-LSVT-SGD-PATE,sub25100,defpa,Unlocking,0.2,MLPateGaussianMechanism,{'Optimal': 40},1123,1178,1085,96,662,1052,1027,516,33,1123,1178,1085,96,662,1052,1027,516,33,poisson-block-composition-pa
2404,sp_workloads,1690805680,wl_small_mem,1410,mixed:GM-LM-RR-LSVT-SGD-PATE-sub25100-defpa,2,dpk-gurobi,block-composition-pa,poisson,equal-ncd,mixed:GM-LM-RR-LSVT-SGD-PATE,sub25100,defpa,Unlocking,0.2,RandResponseMechanism,{'Optimal': 40},1136,1135,1114,19,127,1032,1117,1008,82,1136,1135,1114,19,127,1032,1117,1008,82,poisson-block-composition-pa
2405,sp_workloads,1690805680,wl_small_mem,1410,mixed:GM-LM-RR-LSVT-SGD-PATE-sub25100-defpa,2,dpk-gurobi,block-composition-pa,poisson,equal-ncd,mixed:GM-LM-RR-LSVT-SGD-PATE,sub25100,defpa,Unlocking,0.2,SVTLaplaceMechanism,{'Optimal': 40},1106,1092,1109,20,127,1032,1086,965,77,1106,1092,1109,20,127,1032,1086,965,77,poisson-block-composition-pa
2406,sp_workloads,1690805680,wl_small_mem,1411,mixed:GM-LM-RR-LSVT-SGD-PATE-sub25100-defpa,2,dpk-gurobi,block-composition-pa,poisson,equal-ncd,mixed:GM-LM-RR-LSVT-SGD-PATE,sub25100,defpa,Unlocking,0.4,GaussianMechanism,{'Optimal': 40},1107,1156,1159,558,1098,1159,549,58,0,1107,1156,1159,558,1098,1159,549,58,0,poisson-block-composition-pa
2407,sp_workloads,1690805680,wl_small_mem,1411,mixed:GM-LM-RR-LSVT-SGD-PATE-sub25100-defpa,2,dpk-gurobi,block-composition-pa,poisson,equal-ncd,mixed:GM-LM-RR-LSVT-SGD-PATE,sub25100,defpa,Unlocking,0.4,LaplaceMechanism,{'Optimal': 40},1061,1136,1112,395,813,1112,666,323,0,1061,1136,1112,395,813,1112,666,323,0,poisson-block-composition-pa
2408,sp_workloads,1690805680,wl_small_mem,1411,mixed:GM-LM-RR-LSVT-SGD-PATE-sub25100-defpa,2,dpk-gurobi,block-composition-pa,poisson,equal-ncd,mixed:GM-LM-RR-LSVT-SGD-PATE,sub25100,defpa,Unlocking,0.4,MLNoisySGDMechanism,{'Optimal': 40},1088,1113,1144,127,618,1135,961,495,9,1088,1113,1144,127,618,1135,961,495,9,poisson-block-composition-pa
2409,sp_workloads,1690805680,wl_small_mem,1411,mixed:GM-LM-RR-LSVT-SGD-PATE-sub25100-defpa,2,dpk-gurobi,block-composition-pa,poisson,equal-ncd,mixed:GM-LM-RR-LSVT-SGD-PATE,sub25100,defpa,Unlocking,0.4,MLPateGaussianMechanism,{'Optimal': 40},1123,1178,1085,106,679,1061,1017,499,24,1123,1178,1085,106,679,1061,1017,499,24,poisson-block-composition-pa
2410,sp_workloads,1690805680,wl_small_mem,1411,mixed:GM-LM-RR-LSVT-SGD-PATE-sub25100-defpa,2,dpk-gurobi,block-composition-pa,poisson,equal-ncd,mixed:GM-LM-RR-LSVT-SGD-PATE,sub25100,defpa,Unlocking,0.4,RandResponseMechanism,{'Optimal': 40},1136,1135,1114,25,130,1042,1111,1005,72,1136,1135,1114,25,130,1042,1111,1005,72,poisson-block-composition-pa
2411,sp_workloads,1690805680,wl_small_mem,1411,mixed:GM-LM-RR-LSVT-SGD-PATE-sub25100-defpa,2,dpk-gurobi,block-composition-pa,poisson,equal-ncd,mixed:GM-LM-RR-LSVT-SGD-PATE,sub25100,defpa,Unlocking,0.4,SVTLaplaceMechanism,{'Optimal': 40},1106,1092,1109,23,133,1035,1083,959,74,1106,1092,1109,23,133,1035,1083,959,74,poisson-block-composition-pa
2412,sp_workloads,1690805680,wl_small_mem,1412,mixed:GM-LM-RR-LSVT-SGD-PATE-sub25100-defpa,3,dpk-gurobi,block-composition-pa,poisson,ncd,mixed:GM-LM-RR-LSVT-SGD-PATE,sub25100,defpa,Unlocking,0.2,GaussianMechanism,{'Optimal': 40},3014106,221031,21056,1617697,166062,19312,1396409,54969,1744,1094,1113,1104,571,853,1016,523,260,88,poisson-block-composition-pa
2413,sp_workloads,1690805680,wl_small_mem,1412,mixed:GM-LM-RR-LSVT-SGD-PATE-sub25100-defpa,3,dpk-gurobi,block-composition-pa,poisson,ncd,mixed:GM-LM-RR-LSVT-SGD-PATE,sub25100,defpa,Unlocking,0.2,LaplaceMechanism,{'Optimal': 40},3356641,218178,20864,881607,94567,19104,2475034,123611,1760,1169,1154,1119,404,602,1033,765,552,86,poisson-block-composition-pa
2414,sp_workloads,1690805680,wl_small_mem,1412,mixed:GM-LM-RR-LSVT-SGD-PATE-sub25100-defpa,3,dpk-gurobi,block-composition-pa,poisson,ncd,mixed:GM-LM-RR-LSVT-SGD-PATE,sub25100,defpa,Unlocking,0.2,MLNoisySGDMechanism,{'Optimal': 40},2886113,212328,21728,269797,37966,10064,2616316,174362,11664,1057,1087,1124,92,220,584,965,867,540,poisson-block-composition-pa
2415,sp_workloads,1690805680,wl_small_mem,1412,mixed:GM-LM-RR-LSVT-SGD-PATE-sub25100-defpa,3,dpk-gurobi,block-composition-pa,poisson,ncd,mixed:GM-LM-RR-LSVT-SGD-PATE,sub25100,defpa,Unlocking,0.2,MLPateGaussianMechanism,{'Optimal': 40},3286989,218751,22304,142935,34922,10896,3144054,183829,11408,1114,1105,1168,79,222,637,1035,883,531,poisson-block-composition-pa
2416,sp_workloads,1690805680,wl_small_mem,1412,mixed:GM-LM-RR-LSVT-SGD-PATE-sub25100-defpa,3,dpk-gurobi,block-composition-pa,poisson,ncd,mixed:GM-LM-RR-LSVT-SGD-PATE,sub25100,defpa,Unlocking,0.2,RandResponseMechanism,{'Optimal': 40},3304405,225397,21760,77142,7505,7008,3227263,217892,14752,1160,1175,1154,29,45,402,1131,1130,752,poisson-block-composition-pa
2417,sp_workloads,1690805680,wl_small_mem,1412,mixed:GM-LM-RR-LSVT-SGD-PATE-sub25100-defpa,3,dpk-gurobi,block-composition-pa,poisson,ncd,mixed:GM-LM-RR-LSVT-SGD-PATE,sub25100,defpa,Unlocking,0.2,SVTLaplaceMechanism,{'Optimal': 40},2975196,221951,22352,67253,7375,7136,2907943,214576,15216,1080,1132,1168,29,45,410,1051,1087,758,poisson-block-composition-pa
2418,sp_workloads,1690805680,wl_small_mem,1413,mixed:GM-LM-RR-LSVT-SGD-PATE-sub25100-defpa,3,dpk-gurobi,block-composition-pa,poisson,ncd,mixed:GM-LM-RR-LSVT-SGD-PATE,sub25100,defpa,Unlocking,0.4,GaussianMechanism,{'Optimal': 40},3014106,221031,21056,1713042,174126,19008,1301064,46905,2048,1094,1113,1104,623,867,1004,471,246,100,poisson-block-composition-pa
2419,sp_workloads,1690805680,wl_small_mem,1413,mixed:GM-LM-RR-LSVT-SGD-PATE-sub25100-defpa,3,dpk-gurobi,block-composition-pa,poisson,ncd,mixed:GM-LM-RR-LSVT-SGD-PATE,sub25100,defpa,Unlocking,0.4,LaplaceMechanism,{'Optimal': 40},3356641,218178,20864,1173601,97364,19088,2183040,120814,1776,1169,1154,1119,453,624,1031,716,530,88,poisson-block-composition-pa
2420,sp_workloads,1690805680,wl_small_mem,1413,mixed:GM-LM-RR-LSVT-SGD-PATE-sub25100-defpa,3,dpk-gurobi,block-composition-pa,poisson,ncd,mixed:GM-LM-RR-LSVT-SGD-PATE,sub25100,defpa,Unlocking,0.4,MLNoisySGDMechanism,{'Optimal': 40},2886113,212328,21728,286213,45140,10448,2599900,167188,11280,1057,1087,1124,108,246,611,949,841,513,poisson-block-composition-pa
2421,sp_workloads,1690805680,wl_small_mem,1413,mixed:GM-LM-RR-LSVT-SGD-PATE-sub25100-defpa,3,dpk-gurobi,block-composition-pa,poisson,ncd,mixed:GM-LM-RR-LSVT-SGD-PATE,sub25100,defpa,Unlocking,0.4,MLPateGaussianMechanism,{'Optimal': 40},3286989,218751,22304,197283,38090,11232,3089706,180661,11072,1114,1105,1168,106,255,654,1008,850,514,poisson-block-composition-pa
2422,sp_workloads,1690805680,wl_small_mem,1413,mixed:GM-LM-RR-LSVT-SGD-PATE-sub25100-defpa,3,dpk-gurobi,block-composition-pa,poisson,ncd,mixed:GM-LM-RR-LSVT-SGD-PATE,sub25100,defpa,Unlocking,0.4,RandResponseMechanism,{'Optimal': 40},3304405,225397,21760,111260,8666,7216,3193145,216731,14544,1160,1175,1154,30,47,418,1130,1128,736,poisson-block-composition-pa
2423,sp_workloads,1690805680,wl_small_mem,1413,mixed:GM-LM-RR-LSVT-SGD-PATE-sub25100-defpa,3,dpk-gurobi,block-composition-pa,poisson,ncd,mixed:GM-LM-RR-LSVT-SGD-PATE,sub25100,defpa,Unlocking,0.4,SVTLaplaceMechanism,{'Optimal': 40},2975196,221951,22352,89818,9711,7552,2885378,212240,14800,1080,1132,1168,33,58,432,1047,1074,736,poisson-block-composition-pa
2424,sp_workloads,1690805680,wl_small_mem,1414,mixed:GM-LM-RR-LSVT-SGD-PATE-sub25100-defpa,3,dpk-gurobi,block-composition-pa,poisson,equal-ncd,mixed:GM-LM-RR-LSVT-SGD-PATE,sub25100,defpa,Unlocking,0.2,GaussianMechanism,{'Optimal': 40},1094,1113,1104,529,1052,1104,565,61,0,1094,1113,1104,529,1052,1104,565,61,0,poisson-block-composition-pa
2425,sp_workloads,1690805680,wl_small_mem,1414,mixed:GM-LM-RR-LSVT-SGD-PATE-sub25100-defpa,3,dpk-gurobi,block-composition-pa,poisson,equal-ncd,mixed:GM-LM-RR-LSVT-SGD-PATE,sub25100,defpa,Unlocking,0.2,LaplaceMechanism,{'Optimal': 40},1169,1154,1119,381,807,1119,788,347,0,1169,1154,1119,381,807,1119,788,347,0,poisson-block-composition-pa
2426,sp_workloads,1690805680,wl_small_mem,1414,mixed:GM-LM-RR-LSVT-SGD-PATE-sub25100-defpa,3,dpk-gurobi,block-composition-pa,poisson,equal-ncd,mixed:GM-LM-RR-LSVT-SGD-PATE,sub25100,defpa,Unlocking,0.2,MLNoisySGDMechanism,{'Optimal': 40},1057,1087,1124,125,617,1096,932,470,28,1057,1087,1124,125,617,1096,932,470,28,poisson-block-composition-pa
2427,sp_workloads,1690805680,wl_small_mem,1414,mixed:GM-LM-RR-LSVT-SGD-PATE-sub25100-defpa,3,dpk-gurobi,block-composition-pa,poisson,equal-ncd,mixed:GM-LM-RR-LSVT-SGD-PATE,sub25100,defpa,Unlocking,0.2,MLPateGaussianMechanism,{'Optimal': 40},1114,1105,1168,104,609,1134,1010,496,34,1114,1105,1168,104,609,1134,1010,496,34,poisson-block-composition-pa
2428,sp_workloads,1690805680,wl_small_mem,1414,mixed:GM-LM-RR-LSVT-SGD-PATE-sub25100-defpa,3,dpk-gurobi,block-composition-pa,poisson,equal-ncd,mixed:GM-LM-RR-LSVT-SGD-PATE,sub25100,defpa,Unlocking,0.2,RandResponseMechanism,{'Optimal': 40},1160,1175,1154,24,120,1080,1136,1055,74,1160,1175,1154,24,120,1080,1136,1055,74,poisson-block-composition-pa
2429,sp_workloads,1690805680,wl_small_mem,1414,mixed:GM-LM-RR-LSVT-SGD-PATE-sub25100-defpa,3,dpk-gurobi,block-composition-pa,poisson,equal-ncd,mixed:GM-LM-RR-LSVT-SGD-PATE,sub25100,defpa,Unlocking,0.2,SVTLaplaceMechanism,{'Optimal': 40},1080,1132,1168,26,128,1104,1054,1004,64,1080,1132,1168,26,128,1104,1054,1004,64,poisson-block-composition-pa
2430,sp_workloads,1690805680,wl_small_mem,1415,mixed:GM-LM-RR-LSVT-SGD-PATE-sub25100-defpa,3,dpk-gurobi,block-composition-pa,poisson,equal-ncd,mixed:GM-LM-RR-LSVT-SGD-PATE,sub25100,defpa,Unlocking,0.4,GaussianMechanism,{'Optimal': 40},1094,1113,1104,567,1052,1104,527,61,0,1094,1113,1104,567,1052,1104,527,61,0,poisson-block-composition-pa
2431,sp_workloads,1690805680,wl_small_mem,1415,mixed:GM-LM-RR-LSVT-SGD-PATE-sub25100-defpa,3,dpk-gurobi,block-composition-pa,poisson,equal-ncd,mixed:GM-LM-RR-LSVT-SGD-PATE,sub25100,defpa,Unlocking,0.4,LaplaceMechanism,{'Optimal': 40},1169,1154,1119,405,847,1119,764,307,0,1169,1154,1119,405,847,1119,764,307,0,poisson-block-composition-pa
2432,sp_workloads,1690805680,wl_small_mem,1415,mixed:GM-LM-RR-LSVT-SGD-PATE-sub25100-defpa,3,dpk-gurobi,block-composition-pa,poisson,equal-ncd,mixed:GM-LM-RR-LSVT-SGD-PATE,sub25100,defpa,Unlocking,0.4,MLNoisySGDMechanism,{'Optimal': 40},1057,1087,1124,122,609,1114,935,478,10,1057,1087,1124,122,609,1114,935,478,10,poisson-block-composition-pa
2433,sp_workloads,1690805680,wl_small_mem,1415,mixed:GM-LM-RR-LSVT-SGD-PATE-sub25100-defpa,3,dpk-gurobi,block-composition-pa,poisson,equal-ncd,mixed:GM-LM-RR-LSVT-SGD-PATE,sub25100,defpa,Unlocking,0.4,MLPateGaussianMechanism,{'Optimal': 40},1114,1105,1168,121,630,1147,993,475,21,1114,1105,1168,121,630,1147,993,475,21,poisson-block-composition-pa
2434,sp_workloads,1690805680,wl_small_mem,1415,mixed:GM-LM-RR-LSVT-SGD-PATE-sub25100-defpa,3,dpk-gurobi,block-composition-pa,poisson,equal-ncd,mixed:GM-LM-RR-LSVT-SGD-PATE,sub25100,defpa,Unlocking,0.4,RandResponseMechanism,{'Optimal': 40},1160,1175,1154,25,122,1079,1135,1053,75,1160,1175,1154,25,122,1079,1135,1053,75,poisson-block-composition-pa
2435,sp_workloads,1690805680,wl_small_mem,1415,mixed:GM-LM-RR-LSVT-SGD-PATE-sub25100-defpa,3,dpk-gurobi,block-composition-pa,poisson,equal-ncd,mixed:GM-LM-RR-LSVT-SGD-PATE,sub25100,defpa,Unlocking,0.4,SVTLaplaceMechanism,{'Optimal': 40},1080,1132,1168,30,139,1101,1050,993,67,1080,1132,1168,30,139,1101,1050,993,67,poisson-block-composition-pa
2436,sp_workloads,1690805680,wl_small_mem,1416,mixed:GM-LM-RR-LSVT-SGD-PATE-sub25100-defpa,4,dpk-gurobi,block-composition-pa,poisson,ncd,mixed:GM-LM-RR-LSVT-SGD-PATE,sub25100,defpa,Unlocking,0.2,GaussianMechanism,{'Optimal': 40},3164159,212016,19356,1594476,156660,17743,1569683,55356,1613,1113,1088,1060,575,844,977,538,244,83,poisson-block-composition-pa
2437,sp_workloads,1690805680,wl_small_mem,1416,mixed:GM-LM-RR-LSVT-SGD-PATE-sub25100-defpa,4,dpk-gurobi,block-composition-pa,poisson,ncd,mixed:GM-LM-RR-LSVT-SGD-PATE,sub25100,defpa,Unlocking,0.2,LaplaceMechanism,{'Optimal': 40},2854575,215653,19585,802557,107116,18156,2052018,108537,1429,1062,1115,1087,375,612,1012,687,503,75,poisson-block-composition-pa
2438,sp_workloads,1690805680,wl_small_mem,1416,mixed:GM-LM-RR-LSVT-SGD-PATE-sub25100-defpa,4,dpk-gurobi,block-composition-pa,poisson,ncd,mixed:GM-LM-RR-LSVT-SGD-PATE,sub25100,defpa,Unlocking,0.2,MLNoisySGDMechanism,{'Optimal': 40},3215801,221736,20277,276805,37091,9298,2938996,184645,10979,1144,1128,1131,115,221,574,1029,907,557,poisson-block-composition-pa
2439,sp_workloads,1690805680,wl_small_mem,1416,mixed:GM-LM-RR-LSVT-SGD-PATE-sub25100-defpa,4,dpk-gurobi,block-composition-pa,poisson,ncd,mixed:GM-LM-RR-LSVT-SGD-PATE,sub25100,defpa,Unlocking,0.2,MLPateGaussianMechanism,{'Optimal': 40},3246364,219077,18914,180932,39148,9603,3065432,179929,9311,1154,1099,1070,86,260,605,1068,839,465,poisson-block-composition-pa
2440,sp_workloads,1690805680,wl_small_mem,1416,mixed:GM-LM-RR-LSVT-SGD-PATE-sub25100-defpa,4,dpk-gurobi,block-composition-pa,poisson,ncd,mixed:GM-LM-RR-LSVT-SGD-PATE,sub25100,defpa,Unlocking,0.2,RandResponseMechanism,{'Optimal': 40},3086084,218125,20774,62779,9187,6612,3023305,208938,14162,1149,1123,1162,34,61,412,1115,1062,750,poisson-block-composition-pa
2441,sp_workloads,1690805680,wl_small_mem,1416,mixed:GM-LM-RR-LSVT-SGD-PATE-sub25100-defpa,4,dpk-gurobi,block-composition-pa,poisson,ncd,mixed:GM-LM-RR-LSVT-SGD-PATE,sub25100,defpa,Unlocking,0.2,SVTLaplaceMechanism,{'Optimal': 40},3076541,223346,21123,54165,9904,6440,3022376,213442,14683,1073,1134,1197,28,64,408,1045,1070,789,poisson-block-composition-pa
2442,sp_workloads,1690805680,wl_small_mem,1417,mixed:GM-LM-RR-LSVT-SGD-PATE-sub25100-defpa,4,dpk-gurobi,block-composition-pa,poisson,ncd,mixed:GM-LM-RR-LSVT-SGD-PATE,sub25100,defpa,Unlocking,0.4,GaussianMechanism,{'Optimal': 40},3164159,212016,19356,1729176,164582,17846,1434983,47434,1510,1113,1088,1060,639,858,986,474,230,74,poisson-block-composition-pa
2443,sp_workloads,1690805680,wl_small_mem,1417,mixed:GM-LM-RR-LSVT-SGD-PATE-sub25100-defpa,4,dpk-gurobi,block-composition-pa,poisson,ncd,mixed:GM-LM-RR-LSVT-SGD-PATE,sub25100,defpa,Unlocking,0.4,LaplaceMechanism,{'Optimal': 40},2854575,215653,19585,1078288,106621,17896,1776287,109032,1689,1062,1115,1087,436,611,1000,626,504,87,poisson-block-composition-pa
2444,sp_workloads,1690805680,wl_small_mem,1417,mixed:GM-LM-RR-LSVT-SGD-PATE-sub25100-defpa,4,dpk-gurobi,block-composition-pa,poisson,ncd,mixed:GM-LM-RR-LSVT-SGD-PATE,sub25100,defpa,Unlocking,0.4,MLNoisySGDMechanism,{'Optimal': 40},3215801,221736,20277,283822,40779,9369,2931979,180957,10908,1144,1128,1131,129,245,567,1015,883,564,poisson-block-composition-pa
2445,sp_workloads,1690805680,wl_small_mem,1417,mixed:GM-LM-RR-LSVT-SGD-PATE-sub25100-defpa,4,dpk-gurobi,block-composition-pa,poisson,ncd,mixed:GM-LM-RR-LSVT-SGD-PATE,sub25100,defpa,Unlocking,0.4,MLPateGaussianMechanism,{'Optimal': 40},3246364,219077,18914,193822,42776,9547,3052542,176301,9367,1154,1099,1070,93,280,597,1061,819,473,poisson-block-composition-pa
2446,sp_workloads,1690805680,wl_small_mem,1417,mixed:GM-LM-RR-LSVT-SGD-PATE-sub25100-defpa,4,dpk-gurobi,block-composition-pa,poisson,ncd,mixed:GM-LM-RR-LSVT-SGD-PATE,sub25100,defpa,Unlocking,0.4,RandResponseMechanism,{'Optimal': 40},3086084,218125,20774,75838,7675,6583,3010246,210450,14191,1149,1123,1162,36,53,409,1113,1070,753,poisson-block-composition-pa
2447,sp_workloads,1690805680,wl_small_mem,1417,mixed:GM-LM-RR-LSVT-SGD-PATE-sub25100-defpa,4,dpk-gurobi,block-composition-pa,poisson,ncd,mixed:GM-LM-RR-LSVT-SGD-PATE,sub25100,defpa,Unlocking,0.4,SVTLaplaceMechanism,{'Optimal': 40},3076541,223346,21123,91201,9809,6989,2985340,213537,14134,1073,1134,1197,35,63,435,1038,1071,762,poisson-block-composition-pa
2448,sp_workloads,1690805680,wl_small_mem,1418,mixed:GM-LM-RR-LSVT-SGD-PATE-sub25100-defpa,4,dpk-gurobi,block-composition-pa,poisson,equal-ncd,mixed:GM-LM-RR-LSVT-SGD-PATE,sub25100,defpa,Unlocking,0.2,GaussianMechanism,{'Optimal': 40},1113,1088,1060,540,1041,1060,573,47,0,1113,1088,1060,540,1041,1060,573,47,0,poisson-block-composition-pa
2449,sp_workloads,1690805680,wl_small_mem,1418,mixed:GM-LM-RR-LSVT-SGD-PATE-sub25100-defpa,4,dpk-gurobi,block-composition-pa,poisson,equal-ncd,mixed:GM-LM-RR-LSVT-SGD-PATE,sub25100,defpa,Unlocking,0.2,LaplaceMechanism,{'Optimal': 40},1062,1115,1087,388,781,1087,674,334,0,1062,1115,1087,388,781,1087,674,334,0,poisson-block-composition-pa
2450,sp_workloads,1690805680,wl_small_mem,1418,mixed:GM-LM-RR-LSVT-SGD-PATE-sub25100-defpa,4,dpk-gurobi,block-composition-pa,poisson,equal-ncd,mixed:GM-LM-RR-LSVT-SGD-PATE,sub25100,defpa,Unlocking,0.2,MLNoisySGDMechanism,{'Optimal': 40},1144,1128,1131,152,614,1104,992,514,27,1144,1128,1131,152,614,1104,992,514,27,poisson-block-composition-pa
2451,sp_workloads,1690805680,wl_small_mem,1418,mixed:GM-LM-RR-LSVT-SGD-PATE-sub25100-defpa,4,dpk-gurobi,block-composition-pa,poisson,equal-ncd,mixed:GM-LM-RR-LSVT-SGD-PATE,sub25100,defpa,Unlocking,0.2,MLPateGaussianMechanism,{'Optimal': 40},1154,1099,1070,87,608,1041,1067,491,29,1154,1099,1070,87,608,1041,1067,491,29,poisson-block-composition-pa
2452,sp_workloads,1690805680,wl_small_mem,1418,mixed:GM-LM-RR-LSVT-SGD-PATE-sub25100-defpa,4,dpk-gurobi,block-composition-pa,poisson,equal-ncd,mixed:GM-LM-RR-LSVT-SGD-PATE,sub25100,defpa,Unlocking,0.2,RandResponseMechanism,{'Optimal': 40},1149,1123,1162,35,120,1061,1114,1003,101,1149,1123,1162,35,120,1061,1114,1003,101,poisson-block-composition-pa
2453,sp_workloads,1690805680,wl_small_mem,1418,mixed:GM-LM-RR-LSVT-SGD-PATE-sub25100-defpa,4,dpk-gurobi,block-composition-pa,poisson,equal-ncd,mixed:GM-LM-RR-LSVT-SGD-PATE,sub25100,defpa,Unlocking,0.2,SVTLaplaceMechanism,{'Optimal': 40},1073,1134,1197,34,133,1105,1039,1001,92,1073,1134,1197,34,133,1105,1039,1001,92,poisson-block-composition-pa
2454,sp_workloads,1690805680,wl_small_mem,1419,mixed:GM-LM-RR-LSVT-SGD-PATE-sub25100-defpa,4,dpk-gurobi,block-composition-pa,poisson,equal-ncd,mixed:GM-LM-RR-LSVT-SGD-PATE,sub25100,defpa,Unlocking,0.4,GaussianMechanism,{'Optimal': 40},1113,1088,1060,562,1028,1060,551,60,0,1113,1088,1060,562,1028,1060,551,60,0,poisson-block-composition-pa
2455,sp_workloads,1690805680,wl_small_mem,1419,mixed:GM-LM-RR-LSVT-SGD-PATE-sub25100-defpa,4,dpk-gurobi,block-composition-pa,poisson,equal-ncd,mixed:GM-LM-RR-LSVT-SGD-PATE,sub25100,defpa,Unlocking,0.4,LaplaceMechanism,{'Optimal': 40},1062,1115,1087,396,816,1087,666,299,0,1062,1115,1087,396,816,1087,666,299,0,poisson-block-composition-pa
2456,sp_workloads,1690805680,wl_small_mem,1419,mixed:GM-LM-RR-LSVT-SGD-PATE-sub25100-defpa,4,dpk-gurobi,block-composition-pa,poisson,equal-ncd,mixed:GM-LM-RR-LSVT-SGD-PATE,sub25100,defpa,Unlocking,0.4,MLNoisySGDMechanism,{'Optimal': 40},1144,1128,1131,161,635,1124,983,493,7,1144,1128,1131,161,635,1124,983,493,7,poisson-block-composition-pa
2457,sp_workloads,1690805680,wl_small_mem,1419,mixed:GM-LM-RR-LSVT-SGD-PATE-sub25100-defpa,4,dpk-gurobi,block-composition-pa,poisson,equal-ncd,mixed:GM-LM-RR-LSVT-SGD-PATE,sub25100,defpa,Unlocking,0.4,MLPateGaussianMechanism,{'Optimal': 40},1154,1099,1070,114,613,1055,1040,486,15,1154,1099,1070,114,613,1055,1040,486,15,poisson-block-composition-pa
2458,sp_workloads,1690805680,wl_small_mem,1419,mixed:GM-LM-RR-LSVT-SGD-PATE-sub25100-defpa,4,dpk-gurobi,block-composition-pa,poisson,equal-ncd,mixed:GM-LM-RR-LSVT-SGD-PATE,sub25100,defpa,Unlocking,0.4,RandResponseMechanism,{'Optimal': 40},1149,1123,1162,37,127,1096,1112,996,66,1149,1123,1162,37,127,1096,1112,996,66,poisson-block-composition-pa
2459,sp_workloads,1690805680,wl_small_mem,1419,mixed:GM-LM-RR-LSVT-SGD-PATE-sub25100-defpa,4,dpk-gurobi,block-composition-pa,poisson,equal-ncd,mixed:GM-LM-RR-LSVT-SGD-PATE,sub25100,defpa,Unlocking,0.4,SVTLaplaceMechanism,{'Optimal': 40},1073,1134,1197,38,137,1142,1035,997,55,1073,1134,1197,38,137,1142,1035,997,55,poisson-block-composition-pa
2460,sp_workloads,1690805680,wl_small_mem,1420,basic:GM-LM-RR-LSVT-sub25100-defpa,0,dpk-gurobi,block-composition-pa,poisson,ncd,basic:GM-LM-RR-LSVT,sub25100,defpa,Unlocking,0.2,GaussianMechanism,{'Optimal': 40},4847751,317174,28905,2193641,216785,26016,2654110,100389,2889,1760,1618,1607,856,1174,1456,904,444,151,poisson-block-composition-pa
2461,sp_workloads,1690805680,wl_small_mem,1420,basic:GM-LM-RR-LSVT-sub25100-defpa,0,dpk-gurobi,block-composition-pa,poisson,ncd,basic:GM-LM-RR-LSVT,sub25100,defpa,Unlocking,0.2,LaplaceMechanism,{'Optimal': 40},4580618,310999,29482,1205547,136564,26817,3375071,174435,2665,1690,1679,1654,527,832,1519,1163,847,135,poisson-block-composition-pa
2462,sp_workloads,1690805680,wl_small_mem,1420,basic:GM-LM-RR-LSVT-sub25100-defpa,0,dpk-gurobi,block-composition-pa,poisson,ncd,basic:GM-LM-RR-LSVT,sub25100,defpa,Unlocking,0.2,RandResponseMechanism,{'Optimal': 40},4834309,320190,30099,76429,9150,10442,4757880,311040,19657,1752,1677,1693,32,69,646,1720,1608,1047,poisson-block-composition-pa
2463,sp_workloads,1690805680,wl_small_mem,1420,basic:GM-LM-RR-LSVT-sub25100-defpa,0,dpk-gurobi,block-composition-pa,poisson,ncd,basic:GM-LM-RR-LSVT,sub25100,defpa,Unlocking,0.2,SVTLaplaceMechanism,{'Optimal': 40},4502539,307841,30348,88971,10784,10650,4413568,297057,19698,1685,1652,1684,46,64,646,1639,1588,1038,poisson-block-composition-pa
2464,sp_workloads,1690805680,wl_small_mem,1421,basic:GM-LM-RR-LSVT-sub25100-defpa,0,dpk-gurobi,block-composition-pa,poisson,ncd,basic:GM-LM-RR-LSVT,sub25100,defpa,Unlocking,0.4,GaussianMechanism,{'Optimal': 40},4847751,317174,28905,2376455,233252,26566,2471296,83922,2339,1760,1618,1607,914,1233,1482,846,385,125,poisson-block-composition-pa
2465,sp_workloads,1690805680,wl_small_mem,1421,basic:GM-LM-RR-LSVT-sub25100-defpa,0,dpk-gurobi,block-composition-pa,poisson,ncd,basic:GM-LM-RR-LSVT,sub25100,defpa,Unlocking,0.4,LaplaceMechanism,{'Optimal': 40},4580618,310999,29482,1673229,133943,27478,2907389,177056,2004,1690,1679,1654,629,841,1546,1061,838,108,poisson-block-composition-pa
2466,sp_workloads,1690805680,wl_small_mem,1421,basic:GM-LM-RR-LSVT-sub25100-defpa,0,dpk-gurobi,block-composition-pa,poisson,ncd,basic:GM-LM-RR-LSVT,sub25100,defpa,Unlocking,0.4,RandResponseMechanism,{'Optimal': 40},4834309,320190,30099,126298,8155,11900,4708011,312035,18199,1752,1677,1693,52,72,740,1700,1605,953,poisson-block-composition-pa
2467,sp_workloads,1690805680,wl_small_mem,1421,basic:GM-LM-RR-LSVT-sub25100-defpa,0,dpk-gurobi,block-composition-pa,poisson,ncd,basic:GM-LM-RR-LSVT,sub25100,defpa,Unlocking,0.4,SVTLaplaceMechanism,{'Optimal': 40},4502539,307841,30348,84870,10585,11972,4417669,297256,18376,1685,1652,1684,37,61,732,1648,1591,952,poisson-block-composition-pa
2468,sp_workloads,1690805680,wl_small_mem,1422,basic:GM-LM-RR-LSVT-sub25100-defpa,0,dpk-gurobi,block-composition-pa,poisson,equal-ncd,basic:GM-LM-RR-LSVT,sub25100,defpa,Unlocking,0.2,GaussianMechanism,{'Optimal': 40},1760,1618,1607,840,1501,1606,920,117,1,1760,1618,1607,840,1501,1606,920,117,1,poisson-block-composition-pa
2469,sp_workloads,1690805680,wl_small_mem,1422,basic:GM-LM-RR-LSVT-sub25100-defpa,0,dpk-gurobi,block-composition-pa,poisson,equal-ncd,basic:GM-LM-RR-LSVT,sub25100,defpa,Unlocking,0.2,LaplaceMechanism,{'Optimal': 40},1690,1679,1654,567,1177,1654,1123,502,0,1690,1679,1654,567,1177,1654,1123,502,0,poisson-block-composition-pa
2470,sp_workloads,1690805680,wl_small_mem,1422,basic:GM-LM-RR-LSVT-sub25100-defpa,0,dpk-gurobi,block-composition-pa,poisson,equal-ncd,basic:GM-LM-RR-LSVT,sub25100,defpa,Unlocking,0.2,RandResponseMechanism,{'Optimal': 40},1752,1677,1693,35,158,1506,1717,1519,187,1752,1677,1693,35,158,1506,1717,1519,187,poisson-block-composition-pa
2471,sp_workloads,1690805680,wl_small_mem,1422,basic:GM-LM-RR-LSVT-sub25100-defpa,0,dpk-gurobi,block-composition-pa,poisson,equal-ncd,basic:GM-LM-RR-LSVT,sub25100,defpa,Unlocking,0.2,SVTLaplaceMechanism,{'Optimal': 40},1685,1652,1684,32,162,1515,1653,1490,169,1685,1652,1684,32,162,1515,1653,1490,169,poisson-block-composition-pa
2472,sp_workloads,1690805680,wl_small_mem,1423,basic:GM-LM-RR-LSVT-sub25100-defpa,0,dpk-gurobi,block-composition-pa,poisson,equal-ncd,basic:GM-LM-RR-LSVT,sub25100,defpa,Unlocking,0.4,GaussianMechanism,{'Optimal': 40},1760,1618,1607,894,1491,1607,866,127,0,1760,1618,1607,894,1491,1607,866,127,0,poisson-block-composition-pa
2473,sp_workloads,1690805680,wl_small_mem,1423,basic:GM-LM-RR-LSVT-sub25100-defpa,0,dpk-gurobi,block-composition-pa,poisson,equal-ncd,basic:GM-LM-RR-LSVT,sub25100,defpa,Unlocking,0.4,LaplaceMechanism,{'Optimal': 40},1690,1679,1654,598,1221,1654,1092,458,0,1690,1679,1654,598,1221,1654,1092,458,0,poisson-block-composition-pa
2474,sp_workloads,1690805680,wl_small_mem,1423,basic:GM-LM-RR-LSVT-sub25100-defpa,0,dpk-gurobi,block-composition-pa,poisson,equal-ncd,basic:GM-LM-RR-LSVT,sub25100,defpa,Unlocking,0.4,RandResponseMechanism,{'Optimal': 40},1752,1677,1693,43,170,1617,1709,1507,76,1752,1677,1693,43,170,1617,1709,1507,76,poisson-block-composition-pa
2475,sp_workloads,1690805680,wl_small_mem,1423,basic:GM-LM-RR-LSVT-sub25100-defpa,0,dpk-gurobi,block-composition-pa,poisson,equal-ncd,basic:GM-LM-RR-LSVT,sub25100,defpa,Unlocking,0.4,SVTLaplaceMechanism,{'Optimal': 40},1685,1652,1684,37,160,1603,1648,1492,81,1685,1652,1684,37,160,1603,1648,1492,81,poisson-block-composition-pa
2476,sp_workloads,1690805680,wl_small_mem,1424,basic:GM-LM-RR-LSVT-sub25100-defpa,1,dpk-gurobi,block-composition-pa,poisson,ncd,basic:GM-LM-RR-LSVT,sub25100,defpa,Unlocking,0.2,GaussianMechanism,{'Optimal': 40},4674135,351804,29818,2115508,245614,27124,2558627,106190,2694,1725,1745,1670,815,1290,1532,910,455,138,poisson-block-composition-pa
2477,sp_workloads,1690805680,wl_small_mem,1424,basic:GM-LM-RR-LSVT-sub25100-defpa,1,dpk-gurobi,block-composition-pa,poisson,ncd,basic:GM-LM-RR-LSVT,sub25100,defpa,Unlocking,0.2,LaplaceMechanism,{'Optimal': 40},4701336,316959,30901,1048057,134250,28587,3653279,182709,2314,1705,1659,1707,504,816,1589,1201,843,118,poisson-block-composition-pa
2478,sp_workloads,1690805680,wl_small_mem,1424,basic:GM-LM-RR-LSVT-sub25100-defpa,1,dpk-gurobi,block-composition-pa,poisson,ncd,basic:GM-LM-RR-LSVT,sub25100,defpa,Unlocking,0.2,RandResponseMechanism,{'Optimal': 40},4751311,334074,30363,55342,11191,10954,4695969,322883,19409,1634,1678,1701,34,70,678,1600,1608,1023,poisson-block-composition-pa
2479,sp_workloads,1690805680,wl_small_mem,1424,basic:GM-LM-RR-LSVT-sub25100-defpa,1,dpk-gurobi,block-composition-pa,poisson,ncd,basic:GM-LM-RR-LSVT,sub25100,defpa,Unlocking,0.2,SVTLaplaceMechanism,{'Optimal': 40},4658717,301226,29963,82011,12033,10611,4576706,289193,19352,1700,1628,1669,45,77,653,1655,1551,1016,poisson-block-composition-pa
2480,sp_workloads,1690805680,wl_small_mem,1425,basic:GM-LM-RR-LSVT-sub25100-defpa,1,dpk-gurobi,block-composition-pa,poisson,ncd,basic:GM-LM-RR-LSVT,sub25100,defpa,Unlocking,0.4,GaussianMechanism,{'Optimal': 40},4674135,351804,29818,2259398,260941,27436,2414737,90863,2382,1725,1745,1670,881,1320,1540,844,425,130,poisson-block-composition-pa
2481,sp_workloads,1690805680,wl_small_mem,1425,basic:GM-LM-RR-LSVT-sub25100-defpa,1,dpk-gurobi,block-composition-pa,poisson,ncd,basic:GM-LM-RR-LSVT,sub25100,defpa,Unlocking,0.4,LaplaceMechanism,{'Optimal': 40},4701336,316959,30901,1636049,115961,28806,3065287,200998,2095,1705,1659,1707,600,778,1594,1105,881,113,poisson-block-composition-pa
2482,sp_workloads,1690805680,wl_small_mem,1425,basic:GM-LM-RR-LSVT-sub25100-defpa,1,dpk-gurobi,block-composition-pa,poisson,ncd,basic:GM-LM-RR-LSVT,sub25100,defpa,Unlocking,0.4,RandResponseMechanism,{'Optimal': 40},4751311,334074,30363,106448,11032,11074,4644863,323042,19289,1634,1678,1701,47,76,686,1587,1602,1015,poisson-block-composition-pa
2483,sp_workloads,1690805680,wl_small_mem,1425,basic:GM-LM-RR-LSVT-sub25100-defpa,1,dpk-gurobi,block-composition-pa,poisson,ncd,basic:GM-LM-RR-LSVT,sub25100,defpa,Unlocking,0.4,SVTLaplaceMechanism,{'Optimal': 40},4658717,301226,29963,117619,11309,10495,4541098,289917,19468,1700,1628,1669,39,82,641,1661,1546,1028,poisson-block-composition-pa
2484,sp_workloads,1690805680,wl_small_mem,1426,basic:GM-LM-RR-LSVT-sub25100-defpa,1,dpk-gurobi,block-composition-pa,poisson,equal-ncd,basic:GM-LM-RR-LSVT,sub25100,defpa,Unlocking,0.2,GaussianMechanism,{'Optimal': 40},1725,1745,1670,809,1627,1670,916,118,0,1725,1745,1670,809,1627,1670,916,118,0,poisson-block-composition-pa
2485,sp_workloads,1690805680,wl_small_mem,1426,basic:GM-LM-RR-LSVT-sub25100-defpa,1,dpk-gurobi,block-composition-pa,poisson,equal-ncd,basic:GM-LM-RR-LSVT,sub25100,defpa,Unlocking,0.2,LaplaceMechanism,{'Optimal': 40},1705,1659,1707,523,1162,1707,1182,497,0,1705,1659,1707,523,1162,1707,1182,497,0,poisson-block-composition-pa
2486,sp_workloads,1690805680,wl_small_mem,1426,basic:GM-LM-RR-LSVT-sub25100-defpa,1,dpk-gurobi,block-composition-pa,poisson,equal-ncd,basic:GM-LM-RR-LSVT,sub25100,defpa,Unlocking,0.2,RandResponseMechanism,{'Optimal': 40},1634,1678,1701,39,172,1537,1595,1506,164,1634,1678,1701,39,172,1537,1595,1506,164,poisson-block-composition-pa
2487,sp_workloads,1690805680,wl_small_mem,1426,basic:GM-LM-RR-LSVT-sub25100-defpa,1,dpk-gurobi,block-composition-pa,poisson,equal-ncd,basic:GM-LM-RR-LSVT,sub25100,defpa,Unlocking,0.2,SVTLaplaceMechanism,{'Optimal': 40},1700,1628,1669,42,188,1519,1658,1440,150,1700,1628,1669,42,188,1519,1658,1440,150,poisson-block-composition-pa
2488,sp_workloads,1690805680,wl_small_mem,1427,basic:GM-LM-RR-LSVT-sub25100-defpa,1,dpk-gurobi,block-composition-pa,poisson,equal-ncd,basic:GM-LM-RR-LSVT,sub25100,defpa,Unlocking,0.4,GaussianMechanism,{'Optimal': 40},1725,1745,1670,859,1622,1670,866,123,0,1725,1745,1670,859,1622,1670,866,123,0,poisson-block-composition-pa
2489,sp_workloads,1690805680,wl_small_mem,1427,basic:GM-LM-RR-LSVT-sub25100-defpa,1,dpk-gurobi,block-composition-pa,poisson,equal-ncd,basic:GM-LM-RR-LSVT,sub25100,defpa,Unlocking,0.4,LaplaceMechanism,{'Optimal': 40},1705,1659,1707,561,1199,1707,1144,460,0,1705,1659,1707,561,1199,1707,1144,460,0,poisson-block-composition-pa
2490,sp_workloads,1690805680,wl_small_mem,1427,basic:GM-LM-RR-LSVT-sub25100-defpa,1,dpk-gurobi,block-composition-pa,poisson,equal-ncd,basic:GM-LM-RR-LSVT,sub25100,defpa,Unlocking,0.4,RandResponseMechanism,{'Optimal': 40},1634,1678,1701,39,186,1623,1595,1492,78,1634,1678,1701,39,186,1623,1595,1492,78,poisson-block-composition-pa
2491,sp_workloads,1690805680,wl_small_mem,1427,basic:GM-LM-RR-LSVT-sub25100-defpa,1,dpk-gurobi,block-composition-pa,poisson,equal-ncd,basic:GM-LM-RR-LSVT,sub25100,defpa,Unlocking,0.4,SVTLaplaceMechanism,{'Optimal': 40},1700,1628,1669,49,183,1571,1651,1445,98,1700,1628,1669,49,183,1571,1651,1445,98,poisson-block-composition-pa
2492,sp_workloads,1690805680,wl_small_mem,1428,basic:GM-LM-RR-LSVT-sub25100-defpa,2,dpk-gurobi,block-composition-pa,poisson,ncd,basic:GM-LM-RR-LSVT,sub25100,defpa,Unlocking,0.2,GaussianMechanism,{'Optimal': 40},4344073,336565,33248,1904150,247929,30096,2439923,88636,3152,1647,1671,1731,751,1279,1582,896,392,149,poisson-block-composition-pa
2493,sp_workloads,1690805680,wl_small_mem,1428,basic:GM-LM-RR-LSVT-sub25100-defpa,2,dpk-gurobi,block-composition-pa,poisson,ncd,basic:GM-LM-RR-LSVT,sub25100,defpa,Unlocking,0.2,LaplaceMechanism,{'Optimal': 40},4548967,333299,30800,1211862,161579,28224,3337105,171720,2576,1660,1661,1646,557,862,1519,1103,799,127,poisson-block-composition-pa
2494,sp_workloads,1690805680,wl_small_mem,1428,basic:GM-LM-RR-LSVT-sub25100-defpa,2,dpk-gurobi,block-composition-pa,poisson,ncd,basic:GM-LM-RR-LSVT,sub25100,defpa,Unlocking,0.2,RandResponseMechanism,{'Optimal': 40},5016525,328891,32448,104881,12804,12416,4911644,316087,20032,1714,1690,1723,47,81,734,1667,1609,989,poisson-block-composition-pa
2495,sp_workloads,1690805680,wl_small_mem,1428,basic:GM-LM-RR-LSVT-sub25100-defpa,2,dpk-gurobi,block-composition-pa,poisson,ncd,basic:GM-LM-RR-LSVT,sub25100,defpa,Unlocking,0.2,SVTLaplaceMechanism,{'Optimal': 40},4781610,327880,32576,60404,14617,12208,4721206,313263,20368,1631,1679,1700,34,96,705,1597,1583,995,poisson-block-composition-pa
2496,sp_workloads,1690805680,wl_small_mem,1429,basic:GM-LM-RR-LSVT-sub25100-defpa,2,dpk-gurobi,block-composition-pa,poisson,ncd,basic:GM-LM-RR-LSVT,sub25100,defpa,Unlocking,0.4,GaussianMechanism,{'Optimal': 40},4344073,336565,33248,2056005,257880,30032,2288068,78685,3216,1647,1671,1731,811,1281,1579,836,390,152,poisson-block-composition-pa
2497,sp_workloads,1690805680,wl_small_mem,1429,basic:GM-LM-RR-LSVT-sub25100-defpa,2,dpk-gurobi,block-composition-pa,poisson,ncd,basic:GM-LM-RR-LSVT,sub25100,defpa,Unlocking,0.4,LaplaceMechanism,{'Optimal': 40},4548967,333299,30800,1726355,154499,28912,2822612,178800,1888,1660,1661,1646,647,844,1543,1013,817,103,poisson-block-composition-pa
2498,sp_workloads,1690805680,wl_small_mem,1429,basic:GM-LM-RR-LSVT-sub25100-defpa,2,dpk-gurobi,block-composition-pa,poisson,ncd,basic:GM-LM-RR-LSVT,sub25100,defpa,Unlocking,0.4,RandResponseMechanism,{'Optimal': 40},5016525,328891,32448,101508,13124,12336,4915017,315767,20112,1714,1690,1723,48,86,726,1666,1604,997,poisson-block-composition-pa
2499,sp_workloads,1690805680,wl_small_mem,1429,basic:GM-LM-RR-LSVT-sub25100-defpa,2,dpk-gurobi,block-composition-pa,poisson,ncd,basic:GM-LM-RR-LSVT,sub25100,defpa,Unlocking,0.4,SVTLaplaceMechanism,{'Optimal': 40},4781610,327880,32576,123230,13813,12320,4658380,314067,20256,1631,1679,1700,38,83,711,1593,1596,989,poisson-block-composition-pa
2500,sp_workloads,1690805680,wl_small_mem,1430,basic:GM-LM-RR-LSVT-sub25100-defpa,2,dpk-gurobi,block-composition-pa,poisson,equal-ncd,basic:GM-LM-RR-LSVT,sub25100,defpa,Unlocking,0.2,GaussianMechanism,{'Optimal': 40},1647,1671,1731,764,1562,1729,883,109,2,1647,1671,1731,764,1562,1729,883,109,2,poisson-block-composition-pa
2501,sp_workloads,1690805680,wl_small_mem,1430,basic:GM-LM-RR-LSVT-sub25100-defpa,2,dpk-gurobi,block-composition-pa,poisson,equal-ncd,basic:GM-LM-RR-LSVT,sub25100,defpa,Unlocking,0.2,LaplaceMechanism,{'Optimal': 40},1660,1661,1646,578,1126,1645,1082,535,1,1660,1661,1646,578,1126,1645,1082,535,1,poisson-block-composition-pa
2502,sp_workloads,1690805680,wl_small_mem,1430,basic:GM-LM-RR-LSVT-sub25100-defpa,2,dpk-gurobi,block-composition-pa,poisson,equal-ncd,basic:GM-LM-RR-LSVT,sub25100,defpa,Unlocking,0.2,RandResponseMechanism,{'Optimal': 40},1714,1690,1723,33,216,1564,1681,1474,159,1714,1690,1723,33,216,1564,1681,1474,159,poisson-block-composition-pa
2503,sp_workloads,1690805680,wl_small_mem,1430,basic:GM-LM-RR-LSVT-sub25100-defpa,2,dpk-gurobi,block-composition-pa,poisson,equal-ncd,basic:GM-LM-RR-LSVT,sub25100,defpa,Unlocking,0.2,SVTLaplaceMechanism,{'Optimal': 40},1631,1679,1700,30,188,1538,1601,1491,162,1631,1679,1700,30,188,1538,1601,1491,162,poisson-block-composition-pa
2504,sp_workloads,1690805680,wl_small_mem,1431,basic:GM-LM-RR-LSVT-sub25100-defpa,2,dpk-gurobi,block-composition-pa,poisson,equal-ncd,basic:GM-LM-RR-LSVT,sub25100,defpa,Unlocking,0.4,GaussianMechanism,{'Optimal': 40},1647,1671,1731,811,1574,1731,836,97,0,1647,1671,1731,811,1574,1731,836,97,0,poisson-block-composition-pa
2505,sp_workloads,1690805680,wl_small_mem,1431,basic:GM-LM-RR-LSVT-sub25100-defpa,2,dpk-gurobi,block-composition-pa,poisson,equal-ncd,basic:GM-LM-RR-LSVT,sub25100,defpa,Unlocking,0.4,LaplaceMechanism,{'Optimal': 40},1660,1661,1646,606,1181,1646,1054,480,0,1660,1661,1646,606,1181,1646,1054,480,0,poisson-block-composition-pa
2506,sp_workloads,1690805680,wl_small_mem,1431,basic:GM-LM-RR-LSVT-sub25100-defpa,2,dpk-gurobi,block-composition-pa,poisson,equal-ncd,basic:GM-LM-RR-LSVT,sub25100,defpa,Unlocking,0.4,RandResponseMechanism,{'Optimal': 40},1714,1690,1723,37,217,1602,1677,1473,121,1714,1690,1723,37,217,1602,1677,1473,121,poisson-block-composition-pa
2507,sp_workloads,1690805680,wl_small_mem,1431,basic:GM-LM-RR-LSVT-sub25100-defpa,2,dpk-gurobi,block-composition-pa,poisson,equal-ncd,basic:GM-LM-RR-LSVT,sub25100,defpa,Unlocking,0.4,SVTLaplaceMechanism,{'Optimal': 40},1631,1679,1700,40,207,1567,1591,1472,133,1631,1679,1700,40,207,1567,1591,1472,133,poisson-block-composition-pa
2508,sp_workloads,1690805680,wl_small_mem,1432,basic:GM-LM-RR-LSVT-sub25100-defpa,3,dpk-gurobi,block-composition-pa,poisson,ncd,basic:GM-LM-RR-LSVT,sub25100,defpa,Unlocking,0.2,GaussianMechanism,{'Optimal': 40},4431438,335185,30243,2065470,238119,27796,2365968,97066,2447,1636,1707,1661,765,1261,1532,871,446,129,poisson-block-composition-pa
2509,sp_workloads,1690805680,wl_small_mem,1432,basic:GM-LM-RR-LSVT-sub25100-defpa,3,dpk-gurobi,block-composition-pa,poisson,ncd,basic:GM-LM-RR-LSVT,sub25100,defpa,Unlocking,0.2,LaplaceMechanism,{'Optimal': 40},4614241,302136,30909,1177927,150611,28707,3436314,151525,2202,1669,1590,1731,536,843,1613,1133,747,118,poisson-block-composition-pa
2510,sp_workloads,1690805680,wl_small_mem,1432,basic:GM-LM-RR-LSVT-sub25100-defpa,3,dpk-gurobi,block-composition-pa,poisson,ncd,basic:GM-LM-RR-LSVT,sub25100,defpa,Unlocking,0.2,RandResponseMechanism,{'Optimal': 40},4710432,347409,29228,83513,12166,10466,4626919,335243,18762,1691,1685,1636,39,67,638,1652,1618,998,poisson-block-composition-pa
2511,sp_workloads,1690805680,wl_small_mem,1432,basic:GM-LM-RR-LSVT-sub25100-defpa,3,dpk-gurobi,block-composition-pa,poisson,ncd,basic:GM-LM-RR-LSVT,sub25100,defpa,Unlocking,0.2,SVTLaplaceMechanism,{'Optimal': 40},4781445,315437,29779,99075,13690,10382,4682370,301747,19397,1697,1624,1645,47,72,642,1650,1552,1003,poisson-block-composition-pa
2512,sp_workloads,1690805680,wl_small_mem,1433,basic:GM-LM-RR-LSVT-sub25100-defpa,3,dpk-gurobi,block-composition-pa,poisson,ncd,basic:GM-LM-RR-LSVT,sub25100,defpa,Unlocking,0.4,GaussianMechanism,{'Optimal': 40},4431438,335185,30243,2245275,244714,27782,2186163,90471,2461,1636,1707,1661,845,1267,1530,791,440,131,poisson-block-composition-pa
2513,sp_workloads,1690805680,wl_small_mem,1433,basic:GM-LM-RR-LSVT-sub25100-defpa,3,dpk-gurobi,block-composition-pa,poisson,ncd,basic:GM-LM-RR-LSVT,sub25100,defpa,Unlocking,0.4,LaplaceMechanism,{'Optimal': 40},4614241,302136,30909,1664472,133136,28739,2949769,169000,2170,1669,1590,1731,637,803,1613,1032,787,118,poisson-block-composition-pa
2514,sp_workloads,1690805680,wl_small_mem,1433,basic:GM-LM-RR-LSVT-sub25100-defpa,3,dpk-gurobi,block-composition-pa,poisson,ncd,basic:GM-LM-RR-LSVT,sub25100,defpa,Unlocking,0.4,RandResponseMechanism,{'Optimal': 40},4710432,347409,29228,122701,11748,10498,4587731,335661,18730,1691,1685,1636,46,70,654,1645,1615,982,poisson-block-composition-pa
2515,sp_workloads,1690805680,wl_small_mem,1433,basic:GM-LM-RR-LSVT-sub25100-defpa,3,dpk-gurobi,block-composition-pa,poisson,ncd,basic:GM-LM-RR-LSVT,sub25100,defpa,Unlocking,0.4,SVTLaplaceMechanism,{'Optimal': 40},4781445,315437,29779,131769,11002,10621,4649676,304435,19158,1697,1624,1645,50,66,659,1647,1558,986,poisson-block-composition-pa
2516,sp_workloads,1690805680,wl_small_mem,1434,basic:GM-LM-RR-LSVT-sub25100-defpa,3,dpk-gurobi,block-composition-pa,poisson,equal-ncd,basic:GM-LM-RR-LSVT,sub25100,defpa,Unlocking,0.2,GaussianMechanism,{'Optimal': 40},1636,1707,1661,766,1579,1661,870,128,0,1636,1707,1661,766,1579,1661,870,128,0,poisson-block-composition-pa
2517,sp_workloads,1690805680,wl_small_mem,1434,basic:GM-LM-RR-LSVT-sub25100-defpa,3,dpk-gurobi,block-composition-pa,poisson,equal-ncd,basic:GM-LM-RR-LSVT,sub25100,defpa,Unlocking,0.2,LaplaceMechanism,{'Optimal': 40},1669,1590,1731,571,1105,1730,1098,485,1,1669,1590,1731,571,1105,1730,1098,485,1,poisson-block-composition-pa
2518,sp_workloads,1690805680,wl_small_mem,1434,basic:GM-LM-RR-LSVT-sub25100-defpa,3,dpk-gurobi,block-composition-pa,poisson,equal-ncd,basic:GM-LM-RR-LSVT,sub25100,defpa,Unlocking,0.2,RandResponseMechanism,{'Optimal': 40},1691,1685,1636,36,180,1479,1655,1505,157,1691,1685,1636,36,180,1479,1655,1505,157,poisson-block-composition-pa
2519,sp_workloads,1690805680,wl_small_mem,1434,basic:GM-LM-RR-LSVT-sub25100-defpa,3,dpk-gurobi,block-composition-pa,poisson,equal-ncd,basic:GM-LM-RR-LSVT,sub25100,defpa,Unlocking,0.2,SVTLaplaceMechanism,{'Optimal': 40},1697,1624,1645,38,175,1494,1659,1449,151,1697,1624,1645,38,175,1494,1659,1449,151,poisson-block-composition-pa
2520,sp_workloads,1690805680,wl_small_mem,1435,basic:GM-LM-RR-LSVT-sub25100-defpa,3,dpk-gurobi,block-composition-pa,poisson,equal-ncd,basic:GM-LM-RR-LSVT,sub25100,defpa,Unlocking,0.4,GaussianMechanism,{'Optimal': 40},1636,1707,1661,808,1574,1661,828,133,0,1636,1707,1661,808,1574,1661,828,133,0,poisson-block-composition-pa
2521,sp_workloads,1690805680,wl_small_mem,1435,basic:GM-LM-RR-LSVT-sub25100-defpa,3,dpk-gurobi,block-composition-pa,poisson,equal-ncd,basic:GM-LM-RR-LSVT,sub25100,defpa,Unlocking,0.4,LaplaceMechanism,{'Optimal': 40},1669,1590,1731,597,1133,1731,1072,457,0,1669,1590,1731,597,1133,1731,1072,457,0,poisson-block-composition-pa
2522,sp_workloads,1690805680,wl_small_mem,1435,basic:GM-LM-RR-LSVT-sub25100-defpa,3,dpk-gurobi,block-composition-pa,poisson,equal-ncd,basic:GM-LM-RR-LSVT,sub25100,defpa,Unlocking,0.4,RandResponseMechanism,{'Optimal': 40},1691,1685,1636,45,174,1525,1646,1511,111,1691,1685,1636,45,174,1525,1646,1511,111,poisson-block-composition-pa
2523,sp_workloads,1690805680,wl_small_mem,1435,basic:GM-LM-RR-LSVT-sub25100-defpa,3,dpk-gurobi,block-composition-pa,poisson,equal-ncd,basic:GM-LM-RR-LSVT,sub25100,defpa,Unlocking,0.4,SVTLaplaceMechanism,{'Optimal': 40},1697,1624,1645,45,181,1548,1652,1443,97,1697,1624,1645,45,181,1548,1652,1443,97,poisson-block-composition-pa
2524,sp_workloads,1690805680,wl_small_mem,1436,basic:GM-LM-RR-LSVT-sub25100-defpa,4,dpk-gurobi,block-composition-pa,poisson,ncd,basic:GM-LM-RR-LSVT,sub25100,defpa,Unlocking,0.2,GaussianMechanism,{'Optimal': 40},4571824,341651,31424,2095501,247217,29024,2476323,94434,2400,1667,1683,1652,784,1268,1530,883,415,122,poisson-block-composition-pa
2525,sp_workloads,1690805680,wl_small_mem,1436,basic:GM-LM-RR-LSVT-sub25100-defpa,4,dpk-gurobi,block-composition-pa,poisson,ncd,basic:GM-LM-RR-LSVT,sub25100,defpa,Unlocking,0.2,LaplaceMechanism,{'Optimal': 40},4559498,310728,31904,1235462,140677,29520,3324036,170051,2384,1705,1675,1674,589,851,1558,1116,824,116,poisson-block-composition-pa
2526,sp_workloads,1690805680,wl_small_mem,1436,basic:GM-LM-RR-LSVT-sub25100-defpa,4,dpk-gurobi,block-composition-pa,poisson,ncd,basic:GM-LM-RR-LSVT,sub25100,defpa,Unlocking,0.2,RandResponseMechanism,{'Optimal': 40},4915555,321907,33248,95477,7413,12064,4820078,314494,21184,1732,1682,1739,42,61,700,1690,1621,1039,poisson-block-composition-pa
2527,sp_workloads,1690805680,wl_small_mem,1436,basic:GM-LM-RR-LSVT-sub25100-defpa,4,dpk-gurobi,block-composition-pa,poisson,ncd,basic:GM-LM-RR-LSVT,sub25100,defpa,Unlocking,0.2,SVTLaplaceMechanism,{'Optimal': 40},4827443,310825,33008,74171,10951,11520,4753272,299874,21488,1701,1631,1753,37,74,679,1664,1557,1074,poisson-block-composition-pa
2528,sp_workloads,1690805680,wl_small_mem,1437,basic:GM-LM-RR-LSVT-sub25100-defpa,4,dpk-gurobi,block-composition-pa,poisson,ncd,basic:GM-LM-RR-LSVT,sub25100,defpa,Unlocking,0.4,GaussianMechanism,{'Optimal': 40},4571824,341651,31424,2312098,259491,29104,2259726,82160,2320,1667,1683,1652,873,1312,1537,794,371,115,poisson-block-composition-pa
2529,sp_workloads,1690805680,wl_small_mem,1437,basic:GM-LM-RR-LSVT-sub25100-defpa,4,dpk-gurobi,block-composition-pa,poisson,ncd,basic:GM-LM-RR-LSVT,sub25100,defpa,Unlocking,0.4,LaplaceMechanism,{'Optimal': 40},4559498,310728,31904,1676497,130985,30176,2883001,179743,1728,1705,1675,1674,639,807,1588,1066,868,86,poisson-block-composition-pa
2530,sp_workloads,1690805680,wl_small_mem,1437,basic:GM-LM-RR-LSVT-sub25100-defpa,4,dpk-gurobi,block-composition-pa,poisson,ncd,basic:GM-LM-RR-LSVT,sub25100,defpa,Unlocking,0.4,RandResponseMechanism,{'Optimal': 40},4915555,321907,33248,134137,7349,13728,4781418,314558,19520,1732,1682,1739,54,58,803,1678,1624,936,poisson-block-composition-pa
2531,sp_workloads,1690805680,wl_small_mem,1437,basic:GM-LM-RR-LSVT-sub25100-defpa,4,dpk-gurobi,block-composition-pa,poisson,ncd,basic:GM-LM-RR-LSVT,sub25100,defpa,Unlocking,0.4,SVTLaplaceMechanism,{'Optimal': 40},4827443,310825,33008,123792,11032,13392,4703651,299793,19616,1701,1631,1753,43,68,793,1658,1563,960,poisson-block-composition-pa
2532,sp_workloads,1690805680,wl_small_mem,1438,basic:GM-LM-RR-LSVT-sub25100-defpa,4,dpk-gurobi,block-composition-pa,poisson,equal-ncd,basic:GM-LM-RR-LSVT,sub25100,defpa,Unlocking,0.2,GaussianMechanism,{'Optimal': 40},1667,1683,1652,782,1568,1652,885,115,0,1667,1683,1652,782,1568,1652,885,115,0,poisson-block-composition-pa
2533,sp_workloads,1690805680,wl_small_mem,1438,basic:GM-LM-RR-LSVT-sub25100-defpa,4,dpk-gurobi,block-composition-pa,poisson,equal-ncd,basic:GM-LM-RR-LSVT,sub25100,defpa,Unlocking,0.2,LaplaceMechanism,{'Optimal': 40},1705,1675,1674,581,1132,1674,1124,543,0,1705,1675,1674,581,1132,1674,1124,543,0,poisson-block-composition-pa
2534,sp_workloads,1690805680,wl_small_mem,1438,basic:GM-LM-RR-LSVT-sub25100-defpa,4,dpk-gurobi,block-composition-pa,poisson,equal-ncd,basic:GM-LM-RR-LSVT,sub25100,defpa,Unlocking,0.2,RandResponseMechanism,{'Optimal': 40},1732,1682,1739,36,169,1601,1696,1513,138,1732,1682,1739,36,169,1601,1696,1513,138,poisson-block-composition-pa
2535,sp_workloads,1690805680,wl_small_mem,1438,basic:GM-LM-RR-LSVT-sub25100-defpa,4,dpk-gurobi,block-composition-pa,poisson,equal-ncd,basic:GM-LM-RR-LSVT,sub25100,defpa,Unlocking,0.2,SVTLaplaceMechanism,{'Optimal': 40},1701,1631,1753,32,166,1600,1669,1465,153,1701,1631,1753,32,166,1600,1669,1465,153,poisson-block-composition-pa
2536,sp_workloads,1690805680,wl_small_mem,1439,basic:GM-LM-RR-LSVT-sub25100-defpa,4,dpk-gurobi,block-composition-pa,poisson,equal-ncd,basic:GM-LM-RR-LSVT,sub25100,defpa,Unlocking,0.4,GaussianMechanism,{'Optimal': 40},1667,1683,1652,832,1577,1652,835,106,0,1667,1683,1652,832,1577,1652,835,106,0,poisson-block-composition-pa
2537,sp_workloads,1690805680,wl_small_mem,1439,basic:GM-LM-RR-LSVT-sub25100-defpa,4,dpk-gurobi,block-composition-pa,poisson,equal-ncd,basic:GM-LM-RR-LSVT,sub25100,defpa,Unlocking,0.4,LaplaceMechanism,{'Optimal': 40},1705,1675,1674,620,1173,1674,1085,502,0,1705,1675,1674,620,1173,1674,1085,502,0,poisson-block-composition-pa
2538,sp_workloads,1690805680,wl_small_mem,1439,basic:GM-LM-RR-LSVT-sub25100-defpa,4,dpk-gurobi,block-composition-pa,poisson,equal-ncd,basic:GM-LM-RR-LSVT,sub25100,defpa,Unlocking,0.4,RandResponseMechanism,{'Optimal': 40},1732,1682,1739,38,179,1687,1694,1503,52,1732,1682,1739,38,179,1687,1694,1503,52,poisson-block-composition-pa
2539,sp_workloads,1690805680,wl_small_mem,1439,basic:GM-LM-RR-LSVT-sub25100-defpa,4,dpk-gurobi,block-composition-pa,poisson,equal-ncd,basic:GM-LM-RR-LSVT,sub25100,defpa,Unlocking,0.4,SVTLaplaceMechanism,{'Optimal': 40},1701,1631,1753,37,190,1694,1664,1441,59,1701,1631,1753,37,190,1694,1664,1441,59,poisson-block-composition-pa
2540,sp_workloads,1690805680,wl_small_mem,1440,gm:GM-sub25100-defpa,0,ilp,block-composition,poisson,ncd,gm:GM,sub25100,nopa,Unlocking,0.2,GaussianMechanism,{'Optimal': 40},18864461,1345041,130912,1391541,30429,52912,17472920,1314612,78000,6716,6728,6904,612,207,3307,6104,6521,3597,poisson-block-composition
2541,sp_workloads,1690805680,wl_small_mem,1441,gm:GM-sub25100-defpa,0,ilp,block-composition,poisson,ncd,gm:GM,sub25100,nopa,Unlocking,0.4,GaussianMechanism,{'Optimal': 40},18864461,1345041,130912,1410437,33957,52416,17454024,1311084,78496,6716,6728,6904,623,231,3276,6093,6497,3628,poisson-block-composition
2542,sp_workloads,1690805680,wl_small_mem,1442,gm:GM-sub25100-defpa,0,ilp,block-composition,poisson,equal-ncd,gm:GM,sub25100,nopa,Unlocking,0.2,GaussianMechanism,{'Optimal': 40},6716,6728,6904,95,3315,6812,6621,3413,92,6716,6728,6904,95,3315,6812,6621,3413,92,poisson-block-composition
2543,sp_workloads,1690805680,wl_small_mem,1443,gm:GM-sub25100-defpa,0,ilp,block-composition,poisson,equal-ncd,gm:GM,sub25100,nopa,Unlocking,0.4,GaussianMechanism,{'Optimal': 40},6716,6728,6904,161,3323,6177,6555,3405,727,6716,6728,6904,161,3323,6177,6555,3405,727,poisson-block-composition
2544,sp_workloads,1690805680,wl_small_mem,1444,gm:GM-sub25100-defpa,1,ilp,block-composition,poisson,ncd,gm:GM,sub25100,nopa,Unlocking,0.2,GaussianMechanism,{'Optimal': 40},18715267,1320958,128176,1367311,30816,51184,17347956,1290142,76992,6673,6765,6731,612,214,3199,6061,6551,3532,poisson-block-composition
2545,sp_workloads,1690805680,wl_small_mem,1445,gm:GM-sub25100-defpa,1,ilp,block-composition,poisson,ncd,gm:GM,sub25100,nopa,Unlocking,0.4,GaussianMechanism,{'Optimal': 40},18715267,1320958,128176,1385149,35552,51472,17330118,1285406,76704,6673,6765,6731,622,248,3217,6051,6517,3514,poisson-block-composition
2546,sp_workloads,1690805680,wl_small_mem,1446,gm:GM-sub25100-defpa,1,ilp,block-composition,poisson,equal-ncd,gm:GM,sub25100,nopa,Unlocking,0.2,GaussianMechanism,{'Optimal': 40},6673,6765,6731,111,3374,6495,6562,3391,236,6673,6765,6731,111,3374,6495,6562,3391,236,poisson-block-composition
2547,sp_workloads,1690805680,wl_small_mem,1447,gm:GM-sub25100-defpa,1,ilp,block-composition,poisson,equal-ncd,gm:GM,sub25100,nopa,Unlocking,0.4,GaussianMechanism,{'Optimal': 40},6673,6765,6731,175,3374,5874,6498,3391,857,6673,6765,6731,175,3374,5874,6498,3391,857,poisson-block-composition
2548,sp_workloads,1690805680,wl_small_mem,1448,gm:GM-sub25100-defpa,2,ilp,block-composition,poisson,ncd,gm:GM,sub25100,nopa,Unlocking,0.2,GaussianMechanism,{'Optimal': 40},18806374,1355979,126784,1367748,30544,51552,17438626,1325435,75232,6783,6833,6678,612,212,3222,6171,6621,3456,poisson-block-composition
2549,sp_workloads,1690805680,wl_small_mem,1449,gm:GM-sub25100-defpa,2,ilp,block-composition,poisson,ncd,gm:GM,sub25100,nopa,Unlocking,0.4,GaussianMechanism,{'Optimal': 40},18806374,1355979,126784,1392149,29968,51312,17414225,1326011,75472,6783,6833,6678,625,208,3207,6158,6625,3471,poisson-block-composition
2550,sp_workloads,1690805680,wl_small_mem,1450,gm:GM-sub25100-defpa,2,ilp,block-composition,poisson,equal-ncd,gm:GM,sub25100,nopa,Unlocking,0.2,GaussianMechanism,{'Optimal': 40},6783,6833,6678,104,3376,6560,6679,3457,118,6783,6833,6678,104,3376,6560,6679,3457,118,poisson-block-composition
2551,sp_workloads,1690805680,wl_small_mem,1451,gm:GM-sub25100-defpa,2,ilp,block-composition,poisson,equal-ncd,gm:GM,sub25100,nopa,Unlocking,0.4,GaussianMechanism,{'Optimal': 40},6783,6833,6678,172,3374,5907,6611,3459,771,6783,6833,6678,172,3374,5907,6611,3459,771,poisson-block-composition
2552,sp_workloads,1690805680,wl_small_mem,1452,gm:GM-sub25100-defpa,3,ilp,block-composition,poisson,ncd,gm:GM,sub25100,nopa,Unlocking,0.2,GaussianMechanism,{'Optimal': 40},18672541,1292482,118587,1319954,30858,49155,17352587,1261624,69432,6771,6693,6629,611,222,3277,6160,6471,3352,poisson-block-composition
2553,sp_workloads,1690805680,wl_small_mem,1453,gm:GM-sub25100-defpa,3,ilp,block-composition,poisson,ncd,gm:GM,sub25100,nopa,Unlocking,0.4,GaussianMechanism,{'Optimal': 40},18672541,1292482,118587,1346742,28356,46305,17325799,1264126,72282,6771,6693,6629,626,204,3087,6145,6489,3542,poisson-block-composition
2554,sp_workloads,1690805680,wl_small_mem,1454,gm:GM-sub25100-defpa,3,ilp,block-composition,poisson,equal-ncd,gm:GM,sub25100,nopa,Unlocking,0.2,GaussianMechanism,{'Optimal': 40},6771,6693,6629,112,3320,6553,6659,3373,76,6771,6693,6629,112,3320,6553,6659,3373,76,poisson-block-composition
2555,sp_workloads,1690805680,wl_small_mem,1455,gm:GM-sub25100-defpa,3,ilp,block-composition,poisson,equal-ncd,gm:GM,sub25100,nopa,Unlocking,0.4,GaussianMechanism,{'Optimal': 40},6771,6693,6629,181,3315,5917,6590,3378,712,6771,6693,6629,181,3315,5917,6590,3378,712,poisson-block-composition
2556,sp_workloads,1690805680,wl_small_mem,1456,gm:GM-sub25100-defpa,4,ilp,block-composition,poisson,ncd,gm:GM,sub25100,nopa,Unlocking,0.2,GaussianMechanism,{'Optimal': 40},18857452,1277663,120343,1330630,30100,47685,17526822,1247563,72658,6862,6691,6713,612,215,3179,6250,6476,3534,poisson-block-composition
2557,sp_workloads,1690805680,wl_small_mem,1457,gm:GM-sub25100-defpa,4,ilp,block-composition,poisson,ncd,gm:GM,sub25100,nopa,Unlocking,0.4,GaussianMechanism,{'Optimal': 40},18857452,1277663,120343,1355534,29120,45405,17501918,1248543,74938,6862,6691,6713,626,208,3027,6236,6483,3686,poisson-block-composition
2558,sp_workloads,1690805680,wl_small_mem,1458,gm:GM-sub25100-defpa,4,ilp,block-composition,poisson,equal-ncd,gm:GM,sub25100,nopa,Unlocking,0.2,GaussianMechanism,{'Optimal': 40},6862,6691,6713,102,3327,6604,6760,3364,109,6862,6691,6713,102,3327,6604,6760,3364,109,poisson-block-composition
2559,sp_workloads,1690805680,wl_small_mem,1459,gm:GM-sub25100-defpa,4,ilp,block-composition,poisson,equal-ncd,gm:GM,sub25100,nopa,Unlocking,0.4,GaussianMechanism,{'Optimal': 40},6862,6691,6713,173,3324,5943,6689,3367,770,6862,6691,6713,173,3324,5943,6689,3367,770,poisson-block-composition
2560,sp_workloads,1690805680,wl_small_mem,1460,ml:SGD-PATE-sub25100-defpa,0,ilp,block-composition,poisson,ncd,ml:SGD-PATE,sub25100,nopa,Unlocking,0.2,MLNoisySGDMechanism,{'Optimal': 40},9320337,647144,60780,1246429,0,15180,8073908,647144,45600,3347,3348,3392,595,0,1012,2752,3348,2380,poisson-block-composition
2561,sp_workloads,1690805680,wl_small_mem,1460,ml:SGD-PATE-sub25100-defpa,0,ilp,block-composition,poisson,ncd,ml:SGD-PATE,sub25100,nopa,Unlocking,0.2,MLPateGaussianMechanism,{'Optimal': 40},9560711,630849,59490,304723,8201,24090,9255988,622648,35400,3488,3389,3328,141,59,1606,3347,3330,1722,poisson-block-composition
2562,sp_workloads,1690805680,wl_small_mem,1461,ml:SGD-PATE-sub25100-defpa,0,ilp,block-composition,poisson,ncd,ml:SGD-PATE,sub25100,nopa,Unlocking,0.4,MLNoisySGDMechanism,{'Optimal': 40},9320337,647144,60780,1153059,0,19575,8167278,647144,41205,3347,3348,3392,551,0,1305,2796,3348,2087,poisson-block-composition
2563,sp_workloads,1690805680,wl_small_mem,1461,ml:SGD-PATE-sub25100-defpa,0,ilp,block-composition,poisson,ncd,ml:SGD-PATE,sub25100,nopa,Unlocking,0.4,MLPateGaussianMechanism,{'Optimal': 40},9560711,630849,59490,399765,10703,24375,9160946,620146,35115,3488,3389,3328,186,77,1625,3302,3312,1703,poisson-block-composition
2564,sp_workloads,1690805680,wl_small_mem,1462,ml:SGD-PATE-sub25100-defpa,0,ilp,block-composition,poisson,equal-ncd,ml:SGD-PATE,sub25100,nopa,Unlocking,0.2,MLNoisySGDMechanism,{'Optimal': 40},3347,3348,3392,113,1459,3391,3234,1889,1,3347,3348,3392,113,1459,3391,3234,1889,1,poisson-block-composition
2565,sp_workloads,1690805680,wl_small_mem,1462,ml:SGD-PATE-sub25100-defpa,0,ilp,block-composition,poisson,equal-ncd,ml:SGD-PATE,sub25100,nopa,Unlocking,0.2,MLPateGaussianMechanism,{'Optimal': 40},3488,3389,3328,0,1696,3324,3488,1693,4,3488,3389,3328,0,1696,3324,3488,1693,4,poisson-block-composition
2566,sp_workloads,1690805680,wl_small_mem,1463,ml:SGD-PATE-sub25100-defpa,0,ilp,block-composition,poisson,equal-ncd,ml:SGD-PATE,sub25100,nopa,Unlocking,0.4,MLNoisySGDMechanism,{'Optimal': 40},3347,3348,3392,193,1025,3388,3154,2323,4,3347,3348,3392,193,1025,3388,3154,2323,4,poisson-block-composition
2567,sp_workloads,1690805680,wl_small_mem,1463,ml:SGD-PATE-sub25100-defpa,0,ilp,block-composition,poisson,equal-ncd,ml:SGD-PATE,sub25100,nopa,Unlocking,0.4,MLPateGaussianMechanism,{'Optimal': 40},3488,3389,3328,0,1695,3189,3488,1694,139,3488,3389,3328,0,1695,3189,3488,1694,139,poisson-block-composition
2568,sp_workloads,1690805680,wl_small_mem,1464,ml:SGD-PATE-sub25100-defpa,1,ilp,block-composition,poisson,ncd,ml:SGD-PATE,sub25100,nopa,Unlocking,0.2,MLNoisySGDMechanism,{'Optimal': 40},9612014,638642,60437,1313164,140,17385,8298850,638502,43052,3436,3336,3371,625,1,1159,2811,3335,2212,poisson-block-composition
2569,sp_workloads,1690805680,wl_small_mem,1464,ml:SGD-PATE-sub25100-defpa,1,ilp,block-composition,poisson,ncd,ml:SGD-PATE,sub25100,nopa,Unlocking,0.2,MLPateGaussianMechanism,{'Optimal': 40},9101816,660711,61026,249849,8960,24495,8851967,651751,36531,3337,3307,3358,115,64,1633,3222,3243,1725,poisson-block-composition
2570,sp_workloads,1690805680,wl_small_mem,1465,ml:SGD-PATE-sub25100-defpa,1,ilp,block-composition,poisson,ncd,ml:SGD-PATE,sub25100,nopa,Unlocking,0.4,MLNoisySGDMechanism,{'Optimal': 40},9612014,638642,60437,1230698,1540,17550,8381316,637102,42887,3436,3336,3371,586,11,1170,2850,3325,2201,poisson-block-composition
2571,sp_workloads,1690805680,wl_small_mem,1465,ml:SGD-PATE-sub25100-defpa,1,ilp,block-composition,poisson,ncd,ml:SGD-PATE,sub25100,nopa,Unlocking,0.4,MLPateGaussianMechanism,{'Optimal': 40},9101816,660711,61026,342709,7902,24045,8759107,652809,36981,3337,3307,3358,159,57,1603,3178,3250,1755,poisson-block-composition
2572,sp_workloads,1690805680,wl_small_mem,1466,ml:SGD-PATE-sub25100-defpa,1,ilp,block-composition,poisson,equal-ncd,ml:SGD-PATE,sub25100,nopa,Unlocking,0.2,MLNoisySGDMechanism,{'Optimal': 40},3436,3336,3371,136,1375,3371,3300,1961,0,3436,3336,3371,136,1375,3371,3300,1961,0,poisson-block-composition
2573,sp_workloads,1690805680,wl_small_mem,1466,ml:SGD-PATE-sub25100-defpa,1,ilp,block-composition,poisson,equal-ncd,ml:SGD-PATE,sub25100,nopa,Unlocking,0.2,MLPateGaussianMechanism,{'Optimal': 40},3337,3307,3358,0,1605,3357,3337,1702,1,3337,3307,3358,0,1605,3357,3337,1702,1,poisson-block-composition
2574,sp_workloads,1690805680,wl_small_mem,1467,ml:SGD-PATE-sub25100-defpa,1,ilp,block-composition,poisson,equal-ncd,ml:SGD-PATE,sub25100,nopa,Unlocking,0.4,MLNoisySGDMechanism,{'Optimal': 40},3436,3336,3371,219,940,3369,3217,2396,2,3436,3336,3371,219,940,3369,3217,2396,2,poisson-block-composition
2575,sp_workloads,1690805680,wl_small_mem,1467,ml:SGD-PATE-sub25100-defpa,1,ilp,block-composition,poisson,equal-ncd,ml:SGD-PATE,sub25100,nopa,Unlocking,0.4,MLPateGaussianMechanism,{'Optimal': 40},3337,3307,3358,0,1604,3204,3337,1703,154,3337,3307,3358,0,1604,3204,3337,1703,154,poisson-block-composition
2576,sp_workloads,1690805680,wl_small_mem,1468,ml:SGD-PATE-sub25100-defpa,2,ilp,block-composition,poisson,ncd,ml:SGD-PATE,sub25100,nopa,Unlocking,0.2,MLNoisySGDMechanism,{'Optimal': 40},9102086,650387,61289,1257116,15,16605,7844970,650372,44684,3387,3344,3399,587,1,1107,2800,3343,2292,poisson-block-composition
2577,sp_workloads,1690805680,wl_small_mem,1468,ml:SGD-PATE-sub25100-defpa,2,ilp,block-composition,poisson,ncd,ml:SGD-PATE,sub25100,nopa,Unlocking,0.2,MLPateGaussianMechanism,{'Optimal': 40},9667159,651460,60587,323404,7737,25140,9343755,643723,35447,3356,3340,3381,146,55,1676,3210,3285,1705,poisson-block-composition
2578,sp_workloads,1690805680,wl_small_mem,1469,ml:SGD-PATE-sub25100-defpa,2,ilp,block-composition,poisson,ncd,ml:SGD-PATE,sub25100,nopa,Unlocking,0.4,MLNoisySGDMechanism,{'Optimal': 40},9102086,650387,61289,1187279,715,18090,7914807,649672,43199,3387,3344,3399,556,5,1206,2831,3339,2193,poisson-block-composition
2579,sp_workloads,1690805680,wl_small_mem,1469,ml:SGD-PATE-sub25100-defpa,2,ilp,block-composition,poisson,ncd,ml:SGD-PATE,sub25100,nopa,Unlocking,0.4,MLPateGaussianMechanism,{'Optimal': 40},9667159,651460,60587,403414,8388,25515,9263745,643072,35072,3356,3340,3381,183,60,1701,3173,3280,1680,poisson-block-composition
2580,sp_workloads,1690805680,wl_small_mem,1470,ml:SGD-PATE-sub25100-defpa,2,ilp,block-composition,poisson,equal-ncd,ml:SGD-PATE,sub25100,nopa,Unlocking,0.2,MLNoisySGDMechanism,{'Optimal': 40},3387,3344,3399,108,1527,3398,3279,1817,1,3387,3344,3399,108,1527,3398,3279,1817,1,poisson-block-composition
2581,sp_workloads,1690805680,wl_small_mem,1470,ml:SGD-PATE-sub25100-defpa,2,ilp,block-composition,poisson,equal-ncd,ml:SGD-PATE,sub25100,nopa,Unlocking,0.2,MLPateGaussianMechanism,{'Optimal': 40},3356,3340,3381,0,1706,3379,3356,1634,2,3356,3340,3381,0,1706,3379,3356,1634,2,poisson-block-composition
2582,sp_workloads,1690805680,wl_small_mem,1471,ml:SGD-PATE-sub25100-defpa,2,ilp,block-composition,poisson,equal-ncd,ml:SGD-PATE,sub25100,nopa,Unlocking,0.4,MLNoisySGDMechanism,{'Optimal': 40},3387,3344,3399,192,1009,3398,3195,2335,1,3387,3344,3399,192,1009,3398,3195,2335,1,poisson-block-composition
2583,sp_workloads,1690805680,wl_small_mem,1471,ml:SGD-PATE-sub25100-defpa,2,ilp,block-composition,poisson,equal-ncd,ml:SGD-PATE,sub25100,nopa,Unlocking,0.4,MLPateGaussianMechanism,{'Optimal': 40},3356,3340,3381,0,1701,3306,3356,1639,75,3356,3340,3381,0,1701,3306,3356,1639,75,poisson-block-composition
2584,sp_workloads,1690805680,wl_small_mem,1472,ml:SGD-PATE-sub25100-defpa,3,ilp,block-composition,poisson,ncd,ml:SGD-PATE,sub25100,nopa,Unlocking,0.2,MLNoisySGDMechanism,{'Optimal': 40},9538338,661542,60462,1200933,0,14895,8337405,661542,45567,3432,3504,3362,567,0,993,2865,3504,2369,poisson-block-composition
2585,sp_workloads,1690805680,wl_small_mem,1472,ml:SGD-PATE-sub25100-defpa,3,ilp,block-composition,poisson,ncd,ml:SGD-PATE,sub25100,nopa,Unlocking,0.2,MLPateGaussianMechanism,{'Optimal': 40},9431567,656376,60193,360547,7191,22635,9071020,649185,37558,3379,3400,3343,165,51,1509,3214,3349,1834,poisson-block-composition
2586,sp_workloads,1690805680,wl_small_mem,1473,ml:SGD-PATE-sub25100-defpa,3,ilp,block-composition,poisson,ncd,ml:SGD-PATE,sub25100,nopa,Unlocking,0.4,MLNoisySGDMechanism,{'Optimal': 40},9538338,661542,60462,1125742,0,18405,8412596,661542,42057,3432,3504,3362,531,0,1227,2901,3504,2135,poisson-block-composition
2587,sp_workloads,1690805680,wl_small_mem,1473,ml:SGD-PATE-sub25100-defpa,3,ilp,block-composition,poisson,ncd,ml:SGD-PATE,sub25100,nopa,Unlocking,0.4,MLPateGaussianMechanism,{'Optimal': 40},9431567,656376,60193,440795,10574,24210,8990772,645802,35983,3379,3400,3343,203,75,1614,3176,3325,1729,poisson-block-composition
2588,sp_workloads,1690805680,wl_small_mem,1474,ml:SGD-PATE-sub25100-defpa,3,ilp,block-composition,poisson,equal-ncd,ml:SGD-PATE,sub25100,nopa,Unlocking,0.2,MLNoisySGDMechanism,{'Optimal': 40},3432,3504,3362,115,1504,3362,3317,2000,0,3432,3504,3362,115,1504,3362,3317,2000,0,poisson-block-composition
2589,sp_workloads,1690805680,wl_small_mem,1474,ml:SGD-PATE-sub25100-defpa,3,ilp,block-composition,poisson,equal-ncd,ml:SGD-PATE,sub25100,nopa,Unlocking,0.2,MLPateGaussianMechanism,{'Optimal': 40},3379,3400,3343,0,1698,3339,3379,1702,4,3379,3400,3343,0,1698,3339,3379,1702,4,poisson-block-composition
2590,sp_workloads,1690805680,wl_small_mem,1475,ml:SGD-PATE-sub25100-defpa,3,ilp,block-composition,poisson,equal-ncd,ml:SGD-PATE,sub25100,nopa,Unlocking,0.4,MLNoisySGDMechanism,{'Optimal': 40},3432,3504,3362,198,1083,3360,3234,2421,2,3432,3504,3362,198,1083,3360,3234,2421,2,poisson-block-composition
2591,sp_workloads,1690805680,wl_small_mem,1475,ml:SGD-PATE-sub25100-defpa,3,ilp,block-composition,poisson,equal-ncd,ml:SGD-PATE,sub25100,nopa,Unlocking,0.4,MLPateGaussianMechanism,{'Optimal': 40},3379,3400,3343,0,1695,3170,3379,1705,173,3379,3400,3343,0,1695,3170,3379,1705,173,poisson-block-composition
2592,sp_workloads,1690805680,wl_small_mem,1476,ml:SGD-PATE-sub25100-defpa,4,ilp,block-composition,poisson,ncd,ml:SGD-PATE,sub25100,nopa,Unlocking,0.2,MLNoisySGDMechanism,{'Optimal': 40},9619476,680600,63408,1329234,0,15968,8290242,680600,47440,3443,3381,3350,610,0,998,2833,3381,2352,poisson-block-composition
2593,sp_workloads,1690805680,wl_small_mem,1476,ml:SGD-PATE-sub25100-defpa,4,ilp,block-composition,poisson,ncd,ml:SGD-PATE,sub25100,nopa,Unlocking,0.2,MLPateGaussianMechanism,{'Optimal': 40},9087643,650021,64528,290961,5472,27072,8796682,644549,37456,3245,3345,3408,130,38,1692,3115,3307,1716,poisson-block-composition
2594,sp_workloads,1690805680,wl_small_mem,1477,ml:SGD-PATE-sub25100-defpa,4,ilp,block-composition,poisson,ncd,ml:SGD-PATE,sub25100,nopa,Unlocking,0.4,MLNoisySGDMechanism,{'Optimal': 40},9619476,680600,63408,1216957,0,19216,8402519,680600,44192,3443,3381,3350,558,0,1201,2885,3381,2149,poisson-block-composition
2595,sp_workloads,1690805680,wl_small_mem,1477,ml:SGD-PATE-sub25100-defpa,4,ilp,block-composition,poisson,ncd,ml:SGD-PATE,sub25100,nopa,Unlocking,0.4,MLPateGaussianMechanism,{'Optimal': 40},9087643,650021,64528,402663,10080,27616,8684980,639941,36912,3245,3345,3408,181,70,1726,3064,3275,1682,poisson-block-composition
2596,sp_workloads,1690805680,wl_small_mem,1478,ml:SGD-PATE-sub25100-defpa,4,ilp,block-composition,poisson,equal-ncd,ml:SGD-PATE,sub25100,nopa,Unlocking,0.2,MLNoisySGDMechanism,{'Optimal': 40},3443,3381,3350,125,1437,3349,3318,1944,1,3443,3381,3350,125,1437,3349,3318,1944,1,poisson-block-composition
2597,sp_workloads,1690805680,wl_small_mem,1478,ml:SGD-PATE-sub25100-defpa,4,ilp,block-composition,poisson,equal-ncd,ml:SGD-PATE,sub25100,nopa,Unlocking,0.2,MLPateGaussianMechanism,{'Optimal': 40},3245,3345,3408,0,1648,3407,3245,1697,1,3245,3345,3408,0,1648,3407,3245,1697,1,poisson-block-composition
2598,sp_workloads,1690805680,wl_small_mem,1479,ml:SGD-PATE-sub25100-defpa,4,ilp,block-composition,poisson,equal-ncd,ml:SGD-PATE,sub25100,nopa,Unlocking,0.4,MLNoisySGDMechanism,{'Optimal': 40},3443,3381,3350,202,1032,3348,3241,2349,2,3443,3381,3350,202,1032,3348,3241,2349,2,poisson-block-composition
2599,sp_workloads,1690805680,wl_small_mem,1479,ml:SGD-PATE-sub25100-defpa,4,ilp,block-composition,poisson,equal-ncd,ml:SGD-PATE,sub25100,nopa,Unlocking,0.4,MLPateGaussianMechanism,{'Optimal': 40},3245,3345,3408,0,1646,3267,3245,1699,141,3245,3345,3408,0,1646,3267,3245,1699,141,poisson-block-composition
2600,sp_workloads,1690805680,wl_small_mem,1480,mixed:GM-LM-RR-LSVT-SGD-PATE-sub25100-defpa,0,ilp,block-composition,poisson,ncd,mixed:GM-LM-RR-LSVT-SGD-PATE,sub25100,nopa,Unlocking,0.2,GaussianMechanism,{'Optimal': 40},3326864,216518,19768,408640,15782,8280,2918224,200736,11488,1098,1121,1112,196,121,552,902,1000,560,poisson-block-composition
2601,sp_workloads,1690805680,wl_small_mem,1480,mixed:GM-LM-RR-LSVT-SGD-PATE-sub25100-defpa,0,ilp,block-composition,poisson,ncd,mixed:GM-LM-RR-LSVT-SGD-PATE,sub25100,nopa,Unlocking,0.2,LaplaceMechanism,{'Optimal': 40},3160262,214484,19740,2193,15,8296,3158069,214469,11444,1133,1141,1092,1,1,552,1132,1140,540,poisson-block-composition
2602,sp_workloads,1690805680,wl_small_mem,1480,mixed:GM-LM-RR-LSVT-SGD-PATE-sub25100-defpa,0,ilp,block-composition,poisson,ncd,mixed:GM-LM-RR-LSVT-SGD-PATE,sub25100,nopa,Unlocking,0.2,MLNoisySGDMechanism,{'Optimal': 40},3049683,202901,20644,520892,9065,7515,2528791,193836,13129,1124,1132,1148,265,69,501,859,1063,647,poisson-block-composition
2603,sp_workloads,1690805680,wl_small_mem,1480,mixed:GM-LM-RR-LSVT-SGD-PATE-sub25100-defpa,0,ilp,block-composition,poisson,ncd,mixed:GM-LM-RR-LSVT-SGD-PATE,sub25100,nopa,Unlocking,0.2,MLPateGaussianMechanism,{'Optimal': 40},3104776,219595,19804,377675,19772,8250,2727101,199823,11554,1159,1162,1108,185,149,550,974,1013,558,poisson-block-composition
2604,sp_workloads,1690805680,wl_small_mem,1480,mixed:GM-LM-RR-LSVT-SGD-PATE-sub25100-defpa,0,ilp,block-composition,poisson,ncd,mixed:GM-LM-RR-LSVT-SGD-PATE,sub25100,nopa,Unlocking,0.2,RandResponseMechanism,{'Optimal': 40},3027994,204361,19932,0,0,6960,3027994,204361,12972,1129,1138,1140,0,0,464,1129,1138,676,poisson-block-composition
2605,sp_workloads,1690805680,wl_small_mem,1480,mixed:GM-LM-RR-LSVT-SGD-PATE-sub25100-defpa,0,ilp,block-composition,poisson,ncd,mixed:GM-LM-RR-LSVT-SGD-PATE,sub25100,nopa,Unlocking,0.2,SVTLaplaceMechanism,{'Optimal': 40},3254745,215442,20539,0,0,5310,3254745,215442,15229,1155,1111,1125,0,0,354,1155,1111,771,poisson-block-composition
2606,sp_workloads,1690805680,wl_small_mem,1481,mixed:GM-LM-RR-LSVT-SGD-PATE-sub25100-defpa,0,ilp,block-composition,poisson,ncd,mixed:GM-LM-RR-LSVT-SGD-PATE,sub25100,nopa,Unlocking,0.4,GaussianMechanism,{'Optimal': 40},3326864,216518,19768,333735,12930,7965,2993129,203588,11803,1098,1121,1112,161,100,531,937,1021,581,poisson-block-composition
2607,sp_workloads,1690805680,wl_small_mem,1481,mixed:GM-LM-RR-LSVT-SGD-PATE-sub25100-defpa,0,ilp,block-composition,poisson,ncd,mixed:GM-LM-RR-LSVT-SGD-PATE,sub25100,nopa,Unlocking,0.4,LaplaceMechanism,{'Optimal': 40},3160262,214484,19740,15179,1110,8572,3145083,213374,11168,1133,1141,1092,7,11,564,1126,1130,528,poisson-block-composition
2608,sp_workloads,1690805680,wl_small_mem,1481,mixed:GM-LM-RR-LSVT-SGD-PATE-sub25100-defpa,0,ilp,block-composition,poisson,ncd,mixed:GM-LM-RR-LSVT-SGD-PATE,sub25100,nopa,Unlocking,0.4,MLNoisySGDMechanism,{'Optimal': 40},3049683,202901,20644,462920,3575,7113,2586763,199326,13531,1124,1132,1148,300,41,471,824,1091,677,poisson-block-composition
2609,sp_workloads,1690805680,wl_small_mem,1481,mixed:GM-LM-RR-LSVT-SGD-PATE-sub25100-defpa,0,ilp,block-composition,poisson,ncd,mixed:GM-LM-RR-LSVT-SGD-PATE,sub25100,nopa,Unlocking,0.4,MLPateGaussianMechanism,{'Optimal': 40},3104776,219595,19804,305213,18129,8100,2799563,201466,11704,1159,1162,1108,151,135,540,1008,1027,568,poisson-block-composition
2610,sp_workloads,1690805680,wl_small_mem,1481,mixed:GM-LM-RR-LSVT-SGD-PATE-sub25100-defpa,0,ilp,block-composition,poisson,ncd,mixed:GM-LM-RR-LSVT-SGD-PATE,sub25100,nopa,Unlocking,0.4,RandResponseMechanism,{'Optimal': 40},3027994,204361,19932,0,1220,6453,3027994,203141,13479,1129,1138,1140,0,10,427,1129,1128,713,poisson-block-composition
2611,sp_workloads,1690805680,wl_small_mem,1481,mixed:GM-LM-RR-LSVT-SGD-PATE-sub25100-defpa,0,ilp,block-composition,poisson,ncd,mixed:GM-LM-RR-LSVT-SGD-PATE,sub25100,nopa,Unlocking,0.4,SVTLaplaceMechanism,{'Optimal': 40},3254745,215442,20539,0,752,5585,3254745,214690,14954,1155,1111,1125,0,6,367,1155,1105,758,poisson-block-composition
2612,sp_workloads,1690805680,wl_small_mem,1482,mixed:GM-LM-RR-LSVT-SGD-PATE-sub25100-defpa,0,ilp,block-composition,poisson,equal-ncd,mixed:GM-LM-RR-LSVT-SGD-PATE,sub25100,nopa,Unlocking,0.2,GaussianMechanism,{'Optimal': 40},1098,1121,1112,0,569,1103,1098,552,9,1098,1121,1112,0,569,1103,1098,552,9,poisson-block-composition
2613,sp_workloads,1690805680,wl_small_mem,1482,mixed:GM-LM-RR-LSVT-SGD-PATE-sub25100-defpa,0,ilp,block-composition,poisson,equal-ncd,mixed:GM-LM-RR-LSVT-SGD-PATE,sub25100,nopa,Unlocking,0.2,LaplaceMechanism,{'Optimal': 40},1133,1141,1092,0,363,1079,1133,778,13,1133,1141,1092,0,363,1079,1133,778,13,poisson-block-composition
2614,sp_workloads,1690805680,wl_small_mem,1482,mixed:GM-LM-RR-LSVT-SGD-PATE-sub25100-defpa,0,ilp,block-composition,poisson,equal-ncd,mixed:GM-LM-RR-LSVT-SGD-PATE,sub25100,nopa,Unlocking,0.2,MLNoisySGDMechanism,{'Optimal': 40},1124,1132,1148,0,582,1135,1124,550,13,1124,1132,1148,0,582,1135,1124,550,13,poisson-block-composition
2615,sp_workloads,1690805680,wl_small_mem,1482,mixed:GM-LM-RR-LSVT-SGD-PATE-sub25100-defpa,0,ilp,block-composition,poisson,equal-ncd,mixed:GM-LM-RR-LSVT-SGD-PATE,sub25100,nopa,Unlocking,0.2,MLPateGaussianMechanism,{'Optimal': 40},1159,1162,1108,0,597,1095,1159,565,13,1159,1162,1108,0,597,1095,1159,565,13,poisson-block-composition
2616,sp_workloads,1690805680,wl_small_mem,1482,mixed:GM-LM-RR-LSVT-SGD-PATE-sub25100-defpa,0,ilp,block-composition,poisson,equal-ncd,mixed:GM-LM-RR-LSVT-SGD-PATE,sub25100,nopa,Unlocking,0.2,RandResponseMechanism,{'Optimal': 40},1129,1138,1140,0,5,1130,1129,1133,10,1129,1138,1140,0,5,1130,1129,1133,10,poisson-block-composition
2617,sp_workloads,1690805680,wl_small_mem,1482,mixed:GM-LM-RR-LSVT-SGD-PATE-sub25100-defpa,0,ilp,block-composition,poisson,equal-ncd,mixed:GM-LM-RR-LSVT-SGD-PATE,sub25100,nopa,Unlocking,0.2,SVTLaplaceMechanism,{'Optimal': 40},1155,1111,1125,0,62,1115,1155,1049,10,1155,1111,1125,0,62,1115,1155,1049,10,poisson-block-composition
2618,sp_workloads,1690805680,wl_small_mem,1483,mixed:GM-LM-RR-LSVT-SGD-PATE-sub25100-defpa,0,ilp,block-composition,poisson,equal-ncd,mixed:GM-LM-RR-LSVT-SGD-PATE,sub25100,nopa,Unlocking,0.4,GaussianMechanism,{'Optimal': 40},1098,1121,1112,0,577,1103,1098,544,9,1098,1121,1112,0,577,1103,1098,544,9,poisson-block-composition
2619,sp_workloads,1690805680,wl_small_mem,1483,mixed:GM-LM-RR-LSVT-SGD-PATE-sub25100-defpa,0,ilp,block-composition,poisson,equal-ncd,mixed:GM-LM-RR-LSVT-SGD-PATE,sub25100,nopa,Unlocking,0.4,LaplaceMechanism,{'Optimal': 40},1133,1141,1092,0,302,1091,1133,839,1,1133,1141,1092,0,302,1091,1133,839,1,poisson-block-composition
2620,sp_workloads,1690805680,wl_small_mem,1483,mixed:GM-LM-RR-LSVT-SGD-PATE-sub25100-defpa,0,ilp,block-composition,poisson,equal-ncd,mixed:GM-LM-RR-LSVT-SGD-PATE,sub25100,nopa,Unlocking,0.4,MLNoisySGDMechanism,{'Optimal': 40},1124,1132,1148,2,399,1147,1122,733,1,1124,1132,1148,2,399,1147,1122,733,1,poisson-block-composition
2621,sp_workloads,1690805680,wl_small_mem,1483,mixed:GM-LM-RR-LSVT-SGD-PATE-sub25100-defpa,0,ilp,block-composition,poisson,equal-ncd,mixed:GM-LM-RR-LSVT-SGD-PATE,sub25100,nopa,Unlocking,0.4,MLPateGaussianMechanism,{'Optimal': 40},1159,1162,1108,0,601,1067,1159,561,41,1159,1162,1108,0,601,1067,1159,561,41,poisson-block-composition
2622,sp_workloads,1690805680,wl_small_mem,1483,mixed:GM-LM-RR-LSVT-SGD-PATE-sub25100-defpa,0,ilp,block-composition,poisson,equal-ncd,mixed:GM-LM-RR-LSVT-SGD-PATE,sub25100,nopa,Unlocking,0.4,RandResponseMechanism,{'Optimal': 40},1129,1138,1140,0,0,1138,1129,1138,2,1129,1138,1140,0,0,1138,1129,1138,2,poisson-block-composition
2623,sp_workloads,1690805680,wl_small_mem,1483,mixed:GM-LM-RR-LSVT-SGD-PATE-sub25100-defpa,0,ilp,block-composition,poisson,equal-ncd,mixed:GM-LM-RR-LSVT-SGD-PATE,sub25100,nopa,Unlocking,0.4,SVTLaplaceMechanism,{'Optimal': 40},1155,1111,1125,0,148,1120,1155,963,5,1155,1111,1125,0,148,1120,1155,963,5,poisson-block-composition
2624,sp_workloads,1690805680,wl_small_mem,1484,mixed:GM-LM-RR-LSVT-SGD-PATE-sub25100-defpa,1,ilp,block-composition,poisson,ncd,mixed:GM-LM-RR-LSVT-SGD-PATE,sub25100,nopa,Unlocking,0.2,GaussianMechanism,{'Optimal': 40},3139319,215782,21216,373287,19115,8816,2766032,196667,12400,1075,1140,1126,171,137,551,904,1003,575,poisson-block-composition
2625,sp_workloads,1690805680,wl_small_mem,1484,mixed:GM-LM-RR-LSVT-SGD-PATE-sub25100-defpa,1,ilp,block-composition,poisson,ncd,mixed:GM-LM-RR-LSVT-SGD-PATE,sub25100,nopa,Unlocking,0.2,LaplaceMechanism,{'Optimal': 40},3080200,239601,21344,2266,842,9312,3077934,238759,12032,1140,1163,1130,1,11,579,1139,1152,551,poisson-block-composition
2626,sp_workloads,1690805680,wl_small_mem,1484,mixed:GM-LM-RR-LSVT-SGD-PATE-sub25100-defpa,1,ilp,block-composition,poisson,ncd,mixed:GM-LM-RR-LSVT-SGD-PATE,sub25100,nopa,Unlocking,0.2,MLNoisySGDMechanism,{'Optimal': 40},3197047,217314,22128,544121,4527,7840,2652926,212787,14288,1145,1089,1161,251,33,490,894,1056,671,poisson-block-composition
2627,sp_workloads,1690805680,wl_small_mem,1484,mixed:GM-LM-RR-LSVT-SGD-PATE-sub25100-defpa,1,ilp,block-composition,poisson,ncd,mixed:GM-LM-RR-LSVT-SGD-PATE,sub25100,nopa,Unlocking,0.2,MLPateGaussianMechanism,{'Optimal': 40},3203621,231498,21632,407335,23395,8800,2796286,208103,12832,1163,1144,1138,189,166,550,974,978,588,poisson-block-composition
2628,sp_workloads,1690805680,wl_small_mem,1484,mixed:GM-LM-RR-LSVT-SGD-PATE-sub25100-defpa,1,ilp,block-composition,poisson,ncd,mixed:GM-LM-RR-LSVT-SGD-PATE,sub25100,nopa,Unlocking,0.2,RandResponseMechanism,{'Optimal': 40},3122577,243521,22560,0,307,7360,3122577,243214,15200,1093,1164,1181,0,6,451,1093,1158,730,poisson-block-composition
2629,sp_workloads,1690805680,wl_small_mem,1484,mixed:GM-LM-RR-LSVT-SGD-PATE-sub25100-defpa,1,ilp,block-composition,poisson,ncd,mixed:GM-LM-RR-LSVT-SGD-PATE,sub25100,nopa,Unlocking,0.2,SVTLaplaceMechanism,{'Optimal': 40},3189411,227364,20784,0,712,6288,3189411,226652,14496,1178,1127,1089,0,8,388,1178,1119,701,poisson-block-composition
2630,sp_workloads,1690805680,wl_small_mem,1485,mixed:GM-LM-RR-LSVT-SGD-PATE-sub25100-defpa,1,ilp,block-composition,poisson,ncd,mixed:GM-LM-RR-LSVT-SGD-PATE,sub25100,nopa,Unlocking,0.4,GaussianMechanism,{'Optimal': 40},3139319,215782,21216,347087,18482,8944,2792232,197300,12272,1075,1140,1126,168,139,559,907,1001,567,poisson-block-composition
2631,sp_workloads,1690805680,wl_small_mem,1485,mixed:GM-LM-RR-LSVT-SGD-PATE-sub25100-defpa,1,ilp,block-composition,poisson,ncd,mixed:GM-LM-RR-LSVT-SGD-PATE,sub25100,nopa,Unlocking,0.4,LaplaceMechanism,{'Optimal': 40},3080200,239601,21344,8932,858,9600,3071268,238743,11744,1140,1163,1130,4,12,589,1136,1151,541,poisson-block-composition
2632,sp_workloads,1690805680,wl_small_mem,1485,mixed:GM-LM-RR-LSVT-SGD-PATE-sub25100-defpa,1,ilp,block-composition,poisson,ncd,mixed:GM-LM-RR-LSVT-SGD-PATE,sub25100,nopa,Unlocking,0.4,MLNoisySGDMechanism,{'Optimal': 40},3197047,217314,22128,433232,3564,7360,2763815,213750,14768,1145,1089,1161,244,48,460,901,1041,701,poisson-block-composition
2633,sp_workloads,1690805680,wl_small_mem,1485,mixed:GM-LM-RR-LSVT-SGD-PATE-sub25100-defpa,1,ilp,block-composition,poisson,ncd,mixed:GM-LM-RR-LSVT-SGD-PATE,sub25100,nopa,Unlocking,0.4,MLPateGaussianMechanism,{'Optimal': 40},3203621,231498,21632,388851,24545,8720,2814770,206953,12912,1163,1144,1138,187,183,545,976,961,593,poisson-block-composition
2634,sp_workloads,1690805680,wl_small_mem,1485,mixed:GM-LM-RR-LSVT-SGD-PATE-sub25100-defpa,1,ilp,block-composition,poisson,ncd,mixed:GM-LM-RR-LSVT-SGD-PATE,sub25100,nopa,Unlocking,0.4,RandResponseMechanism,{'Optimal': 40},3122577,243521,22560,0,339,7344,3122577,243182,15216,1093,1164,1181,0,8,450,1093,1156,731,poisson-block-composition
2635,sp_workloads,1690805680,wl_small_mem,1485,mixed:GM-LM-RR-LSVT-SGD-PATE-sub25100-defpa,1,ilp,block-composition,poisson,ncd,mixed:GM-LM-RR-LSVT-SGD-PATE,sub25100,nopa,Unlocking,0.4,SVTLaplaceMechanism,{'Optimal': 40},3189411,227364,20784,0,598,7120,3189411,226766,13664,1178,1127,1089,0,9,440,1178,1118,649,poisson-block-composition
2636,sp_workloads,1690805680,wl_small_mem,1486,mixed:GM-LM-RR-LSVT-SGD-PATE-sub25100-defpa,1,ilp,block-composition,poisson,equal-ncd,mixed:GM-LM-RR-LSVT-SGD-PATE,sub25100,nopa,Unlocking,0.2,GaussianMechanism,{'Optimal': 40},1075,1140,1126,0,598,1126,1075,542,0,1075,1140,1126,0,598,1126,1075,542,0,poisson-block-composition
2637,sp_workloads,1690805680,wl_small_mem,1486,mixed:GM-LM-RR-LSVT-SGD-PATE-sub25100-defpa,1,ilp,block-composition,poisson,equal-ncd,mixed:GM-LM-RR-LSVT-SGD-PATE,sub25100,nopa,Unlocking,0.2,LaplaceMechanism,{'Optimal': 40},1140,1163,1130,0,380,1130,1140,783,0,1140,1163,1130,0,380,1130,1140,783,0,poisson-block-composition
2638,sp_workloads,1690805680,wl_small_mem,1486,mixed:GM-LM-RR-LSVT-SGD-PATE-sub25100-defpa,1,ilp,block-composition,poisson,equal-ncd,mixed:GM-LM-RR-LSVT-SGD-PATE,sub25100,nopa,Unlocking,0.2,MLNoisySGDMechanism,{'Optimal': 40},1145,1089,1161,0,554,1161,1145,535,0,1145,1089,1161,0,554,1161,1145,535,0,poisson-block-composition
2639,sp_workloads,1690805680,wl_small_mem,1486,mixed:GM-LM-RR-LSVT-SGD-PATE-sub25100-defpa,1,ilp,block-composition,poisson,equal-ncd,mixed:GM-LM-RR-LSVT-SGD-PATE,sub25100,nopa,Unlocking,0.2,MLPateGaussianMechanism,{'Optimal': 40},1163,1144,1138,0,580,1138,1163,564,0,1163,1144,1138,0,580,1138,1163,564,0,poisson-block-composition
2640,sp_workloads,1690805680,wl_small_mem,1486,mixed:GM-LM-RR-LSVT-SGD-PATE-sub25100-defpa,1,ilp,block-composition,poisson,equal-ncd,mixed:GM-LM-RR-LSVT-SGD-PATE,sub25100,nopa,Unlocking,0.2,RandResponseMechanism,{'Optimal': 40},1093,1164,1181,0,0,1180,1093,1164,1,1093,1164,1181,0,0,1180,1093,1164,1,poisson-block-composition
2641,sp_workloads,1690805680,wl_small_mem,1486,mixed:GM-LM-RR-LSVT-SGD-PATE-sub25100-defpa,1,ilp,block-composition,poisson,equal-ncd,mixed:GM-LM-RR-LSVT-SGD-PATE,sub25100,nopa,Unlocking,0.2,SVTLaplaceMechanism,{'Optimal': 40},1178,1127,1089,0,45,1089,1178,1082,0,1178,1127,1089,0,45,1089,1178,1082,0,poisson-block-composition
2642,sp_workloads,1690805680,wl_small_mem,1487,mixed:GM-LM-RR-LSVT-SGD-PATE-sub25100-defpa,1,ilp,block-composition,poisson,equal-ncd,mixed:GM-LM-RR-LSVT-SGD-PATE,sub25100,nopa,Unlocking,0.4,GaussianMechanism,{'Optimal': 40},1075,1140,1126,0,589,1107,1075,551,19,1075,1140,1126,0,589,1107,1075,551,19,poisson-block-composition
2643,sp_workloads,1690805680,wl_small_mem,1487,mixed:GM-LM-RR-LSVT-SGD-PATE-sub25100-defpa,1,ilp,block-composition,poisson,equal-ncd,mixed:GM-LM-RR-LSVT-SGD-PATE,sub25100,nopa,Unlocking,0.4,LaplaceMechanism,{'Optimal': 40},1140,1163,1130,0,331,1128,1140,832,2,1140,1163,1130,0,331,1128,1140,832,2,poisson-block-composition
2644,sp_workloads,1690805680,wl_small_mem,1487,mixed:GM-LM-RR-LSVT-SGD-PATE-sub25100-defpa,1,ilp,block-composition,poisson,equal-ncd,mixed:GM-LM-RR-LSVT-SGD-PATE,sub25100,nopa,Unlocking,0.4,MLNoisySGDMechanism,{'Optimal': 40},1145,1089,1161,0,374,1157,1145,715,4,1145,1089,1161,0,374,1157,1145,715,4,poisson-block-composition
2645,sp_workloads,1690805680,wl_small_mem,1487,mixed:GM-LM-RR-LSVT-SGD-PATE-sub25100-defpa,1,ilp,block-composition,poisson,equal-ncd,mixed:GM-LM-RR-LSVT-SGD-PATE,sub25100,nopa,Unlocking,0.4,MLPateGaussianMechanism,{'Optimal': 40},1163,1144,1138,0,579,1052,1163,565,86,1163,1144,1138,0,579,1052,1163,565,86,poisson-block-composition
2646,sp_workloads,1690805680,wl_small_mem,1487,mixed:GM-LM-RR-LSVT-SGD-PATE-sub25100-defpa,1,ilp,block-composition,poisson,equal-ncd,mixed:GM-LM-RR-LSVT-SGD-PATE,sub25100,nopa,Unlocking,0.4,RandResponseMechanism,{'Optimal': 40},1093,1164,1181,0,5,1167,1093,1159,14,1093,1164,1181,0,5,1167,1093,1159,14,poisson-block-composition
2647,sp_workloads,1690805680,wl_small_mem,1487,mixed:GM-LM-RR-LSVT-SGD-PATE-sub25100-defpa,1,ilp,block-composition,poisson,equal-ncd,mixed:GM-LM-RR-LSVT-SGD-PATE,sub25100,nopa,Unlocking,0.4,SVTLaplaceMechanism,{'Optimal': 40},1178,1127,1089,0,130,1082,1178,997,7,1178,1127,1089,0,130,1082,1178,997,7,poisson-block-composition
2648,sp_workloads,1690805680,wl_small_mem,1488,mixed:GM-LM-RR-LSVT-SGD-PATE-sub25100-defpa,2,ilp,block-composition,poisson,ncd,mixed:GM-LM-RR-LSVT-SGD-PATE,sub25100,nopa,Unlocking,0.2,GaussianMechanism,{'Optimal': 40},3297557,222693,20889,418161,17598,8220,2879396,205095,12669,1107,1156,1159,199,130,548,908,1026,611,poisson-block-composition
2649,sp_workloads,1690805680,wl_small_mem,1488,mixed:GM-LM-RR-LSVT-SGD-PATE-sub25100-defpa,2,ilp,block-composition,poisson,ncd,mixed:GM-LM-RR-LSVT-SGD-PATE,sub25100,nopa,Unlocking,0.2,LaplaceMechanism,{'Optimal': 40},2847135,226653,20024,0,348,8585,2847135,226305,11439,1061,1136,1112,0,4,567,1061,1132,545,poisson-block-composition
2650,sp_workloads,1690805680,wl_small_mem,1488,mixed:GM-LM-RR-LSVT-SGD-PATE-sub25100-defpa,2,ilp,block-composition,poisson,ncd,mixed:GM-LM-RR-LSVT-SGD-PATE,sub25100,nopa,Unlocking,0.2,MLNoisySGDMechanism,{'Optimal': 40},3065470,217531,20600,505659,8034,7710,2559811,209497,12890,1088,1113,1144,241,62,514,847,1051,630,poisson-block-composition
2651,sp_workloads,1690805680,wl_small_mem,1488,mixed:GM-LM-RR-LSVT-SGD-PATE-sub25100-defpa,2,ilp,block-composition,poisson,ncd,mixed:GM-LM-RR-LSVT-SGD-PATE,sub25100,nopa,Unlocking,0.2,MLPateGaussianMechanism,{'Optimal': 40},3183074,228777,19443,368919,22920,8325,2814155,205857,11118,1123,1178,1085,176,168,555,947,1010,530,poisson-block-composition
2652,sp_workloads,1690805680,wl_small_mem,1488,mixed:GM-LM-RR-LSVT-SGD-PATE-sub25100-defpa,2,ilp,block-composition,poisson,ncd,mixed:GM-LM-RR-LSVT-SGD-PATE,sub25100,nopa,Unlocking,0.2,RandResponseMechanism,{'Optimal': 40},3253029,217115,19830,0,1015,6903,3253029,216100,12927,1136,1135,1114,0,9,457,1136,1126,657,poisson-block-composition
2653,sp_workloads,1690805680,wl_small_mem,1488,mixed:GM-LM-RR-LSVT-SGD-PATE-sub25100-defpa,2,ilp,block-composition,poisson,ncd,mixed:GM-LM-RR-LSVT-SGD-PATE,sub25100,nopa,Unlocking,0.2,SVTLaplaceMechanism,{'Optimal': 40},3041723,217557,19755,0,677,6083,3041723,216880,13672,1106,1092,1109,0,11,397,1106,1081,712,poisson-block-composition
2654,sp_workloads,1690805680,wl_small_mem,1489,mixed:GM-LM-RR-LSVT-SGD-PATE-sub25100-defpa,2,ilp,block-composition,poisson,ncd,mixed:GM-LM-RR-LSVT-SGD-PATE,sub25100,nopa,Unlocking,0.4,GaussianMechanism,{'Optimal': 40},3297557,222693,20889,386185,16450,7965,2911372,206243,12924,1107,1156,1159,186,126,531,921,1030,628,poisson-block-composition
2655,sp_workloads,1690805680,wl_small_mem,1489,mixed:GM-LM-RR-LSVT-SGD-PATE-sub25100-defpa,2,ilp,block-composition,poisson,ncd,mixed:GM-LM-RR-LSVT-SGD-PATE,sub25100,nopa,Unlocking,0.4,LaplaceMechanism,{'Optimal': 40},2847135,226653,20024,23806,348,8420,2823329,226305,11604,1061,1136,1112,11,4,556,1050,1132,556,poisson-block-composition
2656,sp_workloads,1690805680,wl_small_mem,1489,mixed:GM-LM-RR-LSVT-SGD-PATE-sub25100-defpa,2,ilp,block-composition,poisson,ncd,mixed:GM-LM-RR-LSVT-SGD-PATE,sub25100,nopa,Unlocking,0.4,MLNoisySGDMechanism,{'Optimal': 40},3065470,217531,20600,388278,4567,6976,2677192,212964,13624,1088,1113,1144,233,57,464,855,1056,680,poisson-block-composition
2657,sp_workloads,1690805680,wl_small_mem,1489,mixed:GM-LM-RR-LSVT-SGD-PATE-sub25100-defpa,2,ilp,block-composition,poisson,ncd,mixed:GM-LM-RR-LSVT-SGD-PATE,sub25100,nopa,Unlocking,0.4,MLPateGaussianMechanism,{'Optimal': 40},3183074,228777,19443,353663,19754,8205,2829411,209023,11238,1123,1178,1085,172,150,547,951,1028,538,poisson-block-composition
2658,sp_workloads,1690805680,wl_small_mem,1489,mixed:GM-LM-RR-LSVT-SGD-PATE-sub25100-defpa,2,ilp,block-composition,poisson,ncd,mixed:GM-LM-RR-LSVT-SGD-PATE,sub25100,nopa,Unlocking,0.4,RandResponseMechanism,{'Optimal': 40},3253029,217115,19830,0,1045,6573,3253029,216070,13257,1136,1135,1114,0,11,435,1136,1124,679,poisson-block-composition
2659,sp_workloads,1690805680,wl_small_mem,1489,mixed:GM-LM-RR-LSVT-SGD-PATE-sub25100-defpa,2,ilp,block-composition,poisson,ncd,mixed:GM-LM-RR-LSVT-SGD-PATE,sub25100,nopa,Unlocking,0.4,SVTLaplaceMechanism,{'Optimal': 40},3041723,217557,19755,0,692,5811,3041723,216865,13944,1106,1092,1109,0,12,381,1106,1080,728,poisson-block-composition
2660,sp_workloads,1690805680,wl_small_mem,1490,mixed:GM-LM-RR-LSVT-SGD-PATE-sub25100-defpa,2,ilp,block-composition,poisson,equal-ncd,mixed:GM-LM-RR-LSVT-SGD-PATE,sub25100,nopa,Unlocking,0.2,GaussianMechanism,{'Optimal': 40},1107,1156,1159,0,600,1156,1107,556,3,1107,1156,1159,0,600,1156,1107,556,3,poisson-block-composition
2661,sp_workloads,1690805680,wl_small_mem,1490,mixed:GM-LM-RR-LSVT-SGD-PATE-sub25100-defpa,2,ilp,block-composition,poisson,equal-ncd,mixed:GM-LM-RR-LSVT-SGD-PATE,sub25100,nopa,Unlocking,0.2,LaplaceMechanism,{'Optimal': 40},1061,1136,1112,0,371,1109,1061,765,3,1061,1136,1112,0,371,1109,1061,765,3,poisson-block-composition
2662,sp_workloads,1690805680,wl_small_mem,1490,mixed:GM-LM-RR-LSVT-SGD-PATE-sub25100-defpa,2,ilp,block-composition,poisson,equal-ncd,mixed:GM-LM-RR-LSVT-SGD-PATE,sub25100,nopa,Unlocking,0.2,MLNoisySGDMechanism,{'Optimal': 40},1088,1113,1144,0,553,1141,1088,560,3,1088,1113,1144,0,553,1141,1088,560,3,poisson-block-composition
2663,sp_workloads,1690805680,wl_small_mem,1490,mixed:GM-LM-RR-LSVT-SGD-PATE-sub25100-defpa,2,ilp,block-composition,poisson,equal-ncd,mixed:GM-LM-RR-LSVT-SGD-PATE,sub25100,nopa,Unlocking,0.2,MLPateGaussianMechanism,{'Optimal': 40},1123,1178,1085,0,600,1084,1123,578,1,1123,1178,1085,0,600,1084,1123,578,1,poisson-block-composition
2664,sp_workloads,1690805680,wl_small_mem,1490,mixed:GM-LM-RR-LSVT-SGD-PATE-sub25100-defpa,2,ilp,block-composition,poisson,equal-ncd,mixed:GM-LM-RR-LSVT-SGD-PATE,sub25100,nopa,Unlocking,0.2,RandResponseMechanism,{'Optimal': 40},1136,1135,1114,0,1,1112,1136,1134,2,1136,1135,1114,0,1,1112,1136,1134,2,poisson-block-composition
2665,sp_workloads,1690805680,wl_small_mem,1490,mixed:GM-LM-RR-LSVT-SGD-PATE-sub25100-defpa,2,ilp,block-composition,poisson,equal-ncd,mixed:GM-LM-RR-LSVT-SGD-PATE,sub25100,nopa,Unlocking,0.2,SVTLaplaceMechanism,{'Optimal': 40},1106,1092,1109,0,53,1106,1106,1039,3,1106,1092,1109,0,53,1106,1106,1039,3,poisson-block-composition
2666,sp_workloads,1690805680,wl_small_mem,1491,mixed:GM-LM-RR-LSVT-SGD-PATE-sub25100-defpa,2,ilp,block-composition,poisson,equal-ncd,mixed:GM-LM-RR-LSVT-SGD-PATE,sub25100,nopa,Unlocking,0.4,GaussianMechanism,{'Optimal': 40},1107,1156,1159,0,596,1154,1107,560,5,1107,1156,1159,0,596,1154,1107,560,5,poisson-block-composition
2667,sp_workloads,1690805680,wl_small_mem,1491,mixed:GM-LM-RR-LSVT-SGD-PATE-sub25100-defpa,2,ilp,block-composition,poisson,equal-ncd,mixed:GM-LM-RR-LSVT-SGD-PATE,sub25100,nopa,Unlocking,0.4,LaplaceMechanism,{'Optimal': 40},1061,1136,1112,0,303,1112,1061,833,0,1061,1136,1112,0,303,1112,1061,833,0,poisson-block-composition
2668,sp_workloads,1690805680,wl_small_mem,1491,mixed:GM-LM-RR-LSVT-SGD-PATE-sub25100-defpa,2,ilp,block-composition,poisson,equal-ncd,mixed:GM-LM-RR-LSVT-SGD-PATE,sub25100,nopa,Unlocking,0.4,MLNoisySGDMechanism,{'Optimal': 40},1088,1113,1144,0,422,1141,1088,691,3,1088,1113,1144,0,422,1141,1088,691,3,poisson-block-composition
2669,sp_workloads,1690805680,wl_small_mem,1491,mixed:GM-LM-RR-LSVT-SGD-PATE-sub25100-defpa,2,ilp,block-composition,poisson,equal-ncd,mixed:GM-LM-RR-LSVT-SGD-PATE,sub25100,nopa,Unlocking,0.4,MLPateGaussianMechanism,{'Optimal': 40},1123,1178,1085,0,596,1019,1123,582,66,1123,1178,1085,0,596,1019,1123,582,66,poisson-block-composition
2670,sp_workloads,1690805680,wl_small_mem,1491,mixed:GM-LM-RR-LSVT-SGD-PATE-sub25100-defpa,2,ilp,block-composition,poisson,equal-ncd,mixed:GM-LM-RR-LSVT-SGD-PATE,sub25100,nopa,Unlocking,0.4,RandResponseMechanism,{'Optimal': 40},1136,1135,1114,0,23,1109,1136,1112,5,1136,1135,1114,0,23,1109,1136,1112,5,poisson-block-composition
2671,sp_workloads,1690805680,wl_small_mem,1491,mixed:GM-LM-RR-LSVT-SGD-PATE-sub25100-defpa,2,ilp,block-composition,poisson,equal-ncd,mixed:GM-LM-RR-LSVT-SGD-PATE,sub25100,nopa,Unlocking,0.4,SVTLaplaceMechanism,{'Optimal': 40},1106,1092,1109,0,125,1108,1106,967,1,1106,1092,1109,0,125,1108,1106,967,1,poisson-block-composition
2672,sp_workloads,1690805680,wl_small_mem,1492,mixed:GM-LM-RR-LSVT-SGD-PATE-sub25100-defpa,3,ilp,block-composition,poisson,ncd,mixed:GM-LM-RR-LSVT-SGD-PATE,sub25100,nopa,Unlocking,0.2,GaussianMechanism,{'Optimal': 40},3014106,221031,21056,391713,16874,8528,2622393,204157,12528,1094,1113,1104,185,123,533,909,990,571,poisson-block-composition
2673,sp_workloads,1690805680,wl_small_mem,1492,mixed:GM-LM-RR-LSVT-SGD-PATE-sub25100-defpa,3,ilp,block-composition,poisson,ncd,mixed:GM-LM-RR-LSVT-SGD-PATE,sub25100,nopa,Unlocking,0.2,LaplaceMechanism,{'Optimal': 40},3356641,218178,20864,2258,707,9664,3354383,217471,11200,1169,1154,1119,1,6,601,1168,1148,518,poisson-block-composition
2674,sp_workloads,1690805680,wl_small_mem,1492,mixed:GM-LM-RR-LSVT-SGD-PATE-sub25100-defpa,3,ilp,block-composition,poisson,ncd,mixed:GM-LM-RR-LSVT-SGD-PATE,sub25100,nopa,Unlocking,0.2,MLNoisySGDMechanism,{'Optimal': 40},2886113,212328,21728,477214,13383,7440,2408899,198945,14288,1057,1087,1124,232,94,463,825,993,661,poisson-block-composition
2675,sp_workloads,1690805680,wl_small_mem,1492,mixed:GM-LM-RR-LSVT-SGD-PATE-sub25100-defpa,3,ilp,block-composition,poisson,ncd,mixed:GM-LM-RR-LSVT-SGD-PATE,sub25100,nopa,Unlocking,0.2,MLPateGaussianMechanism,{'Optimal': 40},3286989,218751,22304,405409,18082,8672,2881580,200669,13632,1114,1105,1168,194,133,542,920,972,626,poisson-block-composition
2676,sp_workloads,1690805680,wl_small_mem,1492,mixed:GM-LM-RR-LSVT-SGD-PATE-sub25100-defpa,3,ilp,block-composition,poisson,ncd,mixed:GM-LM-RR-LSVT-SGD-PATE,sub25100,nopa,Unlocking,0.2,RandResponseMechanism,{'Optimal': 40},3304405,225397,21760,0,740,8000,3304405,224657,13760,1160,1175,1154,0,9,497,1160,1166,657,poisson-block-composition
2677,sp_workloads,1690805680,wl_small_mem,1492,mixed:GM-LM-RR-LSVT-SGD-PATE-sub25100-defpa,3,ilp,block-composition,poisson,ncd,mixed:GM-LM-RR-LSVT-SGD-PATE,sub25100,nopa,Unlocking,0.2,SVTLaplaceMechanism,{'Optimal': 40},2975196,221951,22352,0,741,7696,2975196,221210,14656,1080,1132,1168,0,9,476,1080,1123,692,poisson-block-composition
2678,sp_workloads,1690805680,wl_small_mem,1493,mixed:GM-LM-RR-LSVT-SGD-PATE-sub25100-defpa,3,ilp,block-composition,poisson,ncd,mixed:GM-LM-RR-LSVT-SGD-PATE,sub25100,nopa,Unlocking,0.4,GaussianMechanism,{'Optimal': 40},3014106,221031,21056,374845,13696,8464,2639261,207335,12592,1094,1113,1104,179,103,529,915,1010,575,poisson-block-composition
2679,sp_workloads,1690805680,wl_small_mem,1493,mixed:GM-LM-RR-LSVT-SGD-PATE-sub25100-defpa,3,ilp,block-composition,poisson,ncd,mixed:GM-LM-RR-LSVT-SGD-PATE,sub25100,nopa,Unlocking,0.4,LaplaceMechanism,{'Optimal': 40},3356641,218178,20864,18064,0,9552,3338577,218178,11312,1169,1154,1119,8,0,591,1161,1154,528,poisson-block-composition
2680,sp_workloads,1690805680,wl_small_mem,1493,mixed:GM-LM-RR-LSVT-SGD-PATE-sub25100-defpa,3,ilp,block-composition,poisson,ncd,mixed:GM-LM-RR-LSVT-SGD-PATE,sub25100,nopa,Unlocking,0.4,MLNoisySGDMechanism,{'Optimal': 40},2886113,212328,21728,407912,2926,7488,2478201,209402,14240,1057,1087,1124,258,37,468,799,1050,656,poisson-block-composition
2681,sp_workloads,1690805680,wl_small_mem,1493,mixed:GM-LM-RR-LSVT-SGD-PATE-sub25100-defpa,3,ilp,block-composition,poisson,ncd,mixed:GM-LM-RR-LSVT-SGD-PATE,sub25100,nopa,Unlocking,0.4,MLPateGaussianMechanism,{'Optimal': 40},3286989,218751,22304,377668,17333,8800,2909321,201418,13504,1114,1105,1168,183,133,549,931,972,619,poisson-block-composition
2682,sp_workloads,1690805680,wl_small_mem,1493,mixed:GM-LM-RR-LSVT-SGD-PATE-sub25100-defpa,3,ilp,block-composition,poisson,ncd,mixed:GM-LM-RR-LSVT-SGD-PATE,sub25100,nopa,Unlocking,0.4,RandResponseMechanism,{'Optimal': 40},3304405,225397,21760,0,0,7840,3304405,225397,13920,1160,1175,1154,0,0,483,1160,1175,671,poisson-block-composition
2683,sp_workloads,1690805680,wl_small_mem,1493,mixed:GM-LM-RR-LSVT-SGD-PATE-sub25100-defpa,3,ilp,block-composition,poisson,ncd,mixed:GM-LM-RR-LSVT-SGD-PATE,sub25100,nopa,Unlocking,0.4,SVTLaplaceMechanism,{'Optimal': 40},2975196,221951,22352,0,0,7024,2975196,221951,15328,1080,1132,1168,0,0,438,1080,1132,730,poisson-block-composition
2684,sp_workloads,1690805680,wl_small_mem,1494,mixed:GM-LM-RR-LSVT-SGD-PATE-sub25100-defpa,3,ilp,block-composition,poisson,equal-ncd,mixed:GM-LM-RR-LSVT-SGD-PATE,sub25100,nopa,Unlocking,0.2,GaussianMechanism,{'Optimal': 40},1094,1113,1104,0,549,1104,1094,564,0,1094,1113,1104,0,549,1104,1094,564,0,poisson-block-composition
2685,sp_workloads,1690805680,wl_small_mem,1494,mixed:GM-LM-RR-LSVT-SGD-PATE-sub25100-defpa,3,ilp,block-composition,poisson,equal-ncd,mixed:GM-LM-RR-LSVT-SGD-PATE,sub25100,nopa,Unlocking,0.2,LaplaceMechanism,{'Optimal': 40},1169,1154,1119,0,418,1119,1169,736,0,1169,1154,1119,0,418,1119,1169,736,0,poisson-block-composition
2686,sp_workloads,1690805680,wl_small_mem,1494,mixed:GM-LM-RR-LSVT-SGD-PATE-sub25100-defpa,3,ilp,block-composition,poisson,equal-ncd,mixed:GM-LM-RR-LSVT-SGD-PATE,sub25100,nopa,Unlocking,0.2,MLNoisySGDMechanism,{'Optimal': 40},1057,1087,1124,0,548,1124,1057,539,0,1057,1087,1124,0,548,1124,1057,539,0,poisson-block-composition
2687,sp_workloads,1690805680,wl_small_mem,1494,mixed:GM-LM-RR-LSVT-SGD-PATE-sub25100-defpa,3,ilp,block-composition,poisson,equal-ncd,mixed:GM-LM-RR-LSVT-SGD-PATE,sub25100,nopa,Unlocking,0.2,MLPateGaussianMechanism,{'Optimal': 40},1114,1105,1168,0,555,1168,1114,550,0,1114,1105,1168,0,555,1168,1114,550,0,poisson-block-composition
2688,sp_workloads,1690805680,wl_small_mem,1494,mixed:GM-LM-RR-LSVT-SGD-PATE-sub25100-defpa,3,ilp,block-composition,poisson,equal-ncd,mixed:GM-LM-RR-LSVT-SGD-PATE,sub25100,nopa,Unlocking,0.2,RandResponseMechanism,{'Optimal': 40},1160,1175,1154,0,0,1154,1160,1175,0,1160,1175,1154,0,0,1154,1160,1175,0,poisson-block-composition
2689,sp_workloads,1690805680,wl_small_mem,1494,mixed:GM-LM-RR-LSVT-SGD-PATE-sub25100-defpa,3,ilp,block-composition,poisson,equal-ncd,mixed:GM-LM-RR-LSVT-SGD-PATE,sub25100,nopa,Unlocking,0.2,SVTLaplaceMechanism,{'Optimal': 40},1080,1132,1168,0,34,1168,1080,1098,0,1080,1132,1168,0,34,1168,1080,1098,0,poisson-block-composition
2690,sp_workloads,1690805680,wl_small_mem,1495,mixed:GM-LM-RR-LSVT-SGD-PATE-sub25100-defpa,3,ilp,block-composition,poisson,equal-ncd,mixed:GM-LM-RR-LSVT-SGD-PATE,sub25100,nopa,Unlocking,0.4,GaussianMechanism,{'Optimal': 40},1094,1113,1104,0,546,1098,1094,567,6,1094,1113,1104,0,546,1098,1094,567,6,poisson-block-composition
2691,sp_workloads,1690805680,wl_small_mem,1495,mixed:GM-LM-RR-LSVT-SGD-PATE-sub25100-defpa,3,ilp,block-composition,poisson,equal-ncd,mixed:GM-LM-RR-LSVT-SGD-PATE,sub25100,nopa,Unlocking,0.4,LaplaceMechanism,{'Optimal': 40},1169,1154,1119,0,364,1110,1169,790,9,1169,1154,1119,0,364,1110,1169,790,9,poisson-block-composition
2692,sp_workloads,1690805680,wl_small_mem,1495,mixed:GM-LM-RR-LSVT-SGD-PATE-sub25100-defpa,3,ilp,block-composition,poisson,equal-ncd,mixed:GM-LM-RR-LSVT-SGD-PATE,sub25100,nopa,Unlocking,0.4,MLNoisySGDMechanism,{'Optimal': 40},1057,1087,1124,0,434,1117,1057,653,7,1057,1087,1124,0,434,1117,1057,653,7,poisson-block-composition
2693,sp_workloads,1690805680,wl_small_mem,1495,mixed:GM-LM-RR-LSVT-SGD-PATE-sub25100-defpa,3,ilp,block-composition,poisson,equal-ncd,mixed:GM-LM-RR-LSVT-SGD-PATE,sub25100,nopa,Unlocking,0.4,MLPateGaussianMechanism,{'Optimal': 40},1114,1105,1168,0,548,1126,1114,557,42,1114,1105,1168,0,548,1126,1114,557,42,poisson-block-composition
2694,sp_workloads,1690805680,wl_small_mem,1495,mixed:GM-LM-RR-LSVT-SGD-PATE-sub25100-defpa,3,ilp,block-composition,poisson,equal-ncd,mixed:GM-LM-RR-LSVT-SGD-PATE,sub25100,nopa,Unlocking,0.4,RandResponseMechanism,{'Optimal': 40},1160,1175,1154,0,8,1151,1160,1167,3,1160,1175,1154,0,8,1151,1160,1167,3,poisson-block-composition
2695,sp_workloads,1690805680,wl_small_mem,1495,mixed:GM-LM-RR-LSVT-SGD-PATE-sub25100-defpa,3,ilp,block-composition,poisson,equal-ncd,mixed:GM-LM-RR-LSVT-SGD-PATE,sub25100,nopa,Unlocking,0.4,SVTLaplaceMechanism,{'Optimal': 40},1080,1132,1168,0,103,1156,1080,1029,12,1080,1132,1168,0,103,1156,1080,1029,12,poisson-block-composition
2696,sp_workloads,1690805680,wl_small_mem,1496,mixed:GM-LM-RR-LSVT-SGD-PATE-sub25100-defpa,4,ilp,block-composition,poisson,ncd,mixed:GM-LM-RR-LSVT-SGD-PATE,sub25100,nopa,Unlocking,0.2,GaussianMechanism,{'Optimal': 40},3164159,212016,19356,396568,18013,7245,2767591,194003,12111,1113,1088,1060,190,131,483,923,957,577,poisson-block-composition
2697,sp_workloads,1690805680,wl_small_mem,1496,mixed:GM-LM-RR-LSVT-SGD-PATE-sub25100-defpa,4,ilp,block-composition,poisson,ncd,mixed:GM-LM-RR-LSVT-SGD-PATE,sub25100,nopa,Unlocking,0.2,LaplaceMechanism,{'Optimal': 40},2854575,215653,19585,2238,841,8222,2852337,214812,11363,1062,1115,1087,1,7,546,1061,1108,541,poisson-block-composition
2698,sp_workloads,1690805680,wl_small_mem,1496,mixed:GM-LM-RR-LSVT-SGD-PATE-sub25100-defpa,4,ilp,block-composition,poisson,ncd,mixed:GM-LM-RR-LSVT-SGD-PATE,sub25100,nopa,Unlocking,0.2,MLNoisySGDMechanism,{'Optimal': 40},3215801,221736,20277,487158,8337,7290,2728643,213399,12987,1144,1128,1131,239,63,486,905,1065,645,poisson-block-composition
2699,sp_workloads,1690805680,wl_small_mem,1496,mixed:GM-LM-RR-LSVT-SGD-PATE-sub25100-defpa,4,ilp,block-composition,poisson,ncd,mixed:GM-LM-RR-LSVT-SGD-PATE,sub25100,nopa,Unlocking,0.2,MLPateGaussianMechanism,{'Optimal': 40},3246364,219077,18914,407597,18613,7980,2838767,200464,10934,1154,1099,1070,195,139,532,959,960,538,poisson-block-composition
2700,sp_workloads,1690805680,wl_small_mem,1496,mixed:GM-LM-RR-LSVT-SGD-PATE-sub25100-defpa,4,ilp,block-composition,poisson,ncd,mixed:GM-LM-RR-LSVT-SGD-PATE,sub25100,nopa,Unlocking,0.2,RandResponseMechanism,{'Optimal': 40},3086084,218125,20774,0,489,7249,3086084,217636,13525,1149,1123,1162,0,7,479,1149,1116,683,poisson-block-composition
2701,sp_workloads,1690805680,wl_small_mem,1496,mixed:GM-LM-RR-LSVT-SGD-PATE-sub25100-defpa,4,ilp,block-composition,poisson,ncd,mixed:GM-LM-RR-LSVT-SGD-PATE,sub25100,nopa,Unlocking,0.2,SVTLaplaceMechanism,{'Optimal': 40},3076541,223346,21123,0,967,6816,3076541,222379,14307,1073,1134,1197,0,9,448,1073,1125,749,poisson-block-composition
2702,sp_workloads,1690805680,wl_small_mem,1497,mixed:GM-LM-RR-LSVT-SGD-PATE-sub25100-defpa,4,ilp,block-composition,poisson,ncd,mixed:GM-LM-RR-LSVT-SGD-PATE,sub25100,nopa,Unlocking,0.4,GaussianMechanism,{'Optimal': 40},3164159,212016,19356,337452,19117,7341,2826707,192899,12015,1113,1088,1060,167,147,483,946,941,577,poisson-block-composition
2703,sp_workloads,1690805680,wl_small_mem,1497,mixed:GM-LM-RR-LSVT-SGD-PATE-sub25100-defpa,4,ilp,block-composition,poisson,ncd,mixed:GM-LM-RR-LSVT-SGD-PATE,sub25100,nopa,Unlocking,0.4,LaplaceMechanism,{'Optimal': 40},2854575,215653,19585,15666,887,8152,2838909,214766,11433,1062,1115,1087,7,9,536,1055,1106,551,poisson-block-composition
2704,sp_workloads,1690805680,wl_small_mem,1497,mixed:GM-LM-RR-LSVT-SGD-PATE-sub25100-defpa,4,ilp,block-composition,poisson,ncd,mixed:GM-LM-RR-LSVT-SGD-PATE,sub25100,nopa,Unlocking,0.4,MLNoisySGDMechanism,{'Optimal': 40},3215801,221736,20277,435823,5213,7038,2779978,216523,13239,1144,1128,1131,278,67,466,866,1061,665,poisson-block-composition
2705,sp_workloads,1690805680,wl_small_mem,1497,mixed:GM-LM-RR-LSVT-SGD-PATE-sub25100-defpa,4,ilp,block-composition,poisson,ncd,mixed:GM-LM-RR-LSVT-SGD-PATE,sub25100,nopa,Unlocking,0.4,MLPateGaussianMechanism,{'Optimal': 40},3246364,219077,18914,345923,19290,7620,2900441,199787,11294,1154,1099,1070,169,150,508,985,949,562,poisson-block-composition
2706,sp_workloads,1690805680,wl_small_mem,1497,mixed:GM-LM-RR-LSVT-SGD-PATE-sub25100-defpa,4,ilp,block-composition,poisson,ncd,mixed:GM-LM-RR-LSVT-SGD-PATE,sub25100,nopa,Unlocking,0.4,RandResponseMechanism,{'Optimal': 40},3086084,218125,20774,0,632,6665,3086084,217493,14109,1149,1123,1162,0,8,439,1149,1115,723,poisson-block-composition
2707,sp_workloads,1690805680,wl_small_mem,1497,mixed:GM-LM-RR-LSVT-SGD-PATE-sub25100-defpa,4,ilp,block-composition,poisson,ncd,mixed:GM-LM-RR-LSVT-SGD-PATE,sub25100,nopa,Unlocking,0.4,SVTLaplaceMechanism,{'Optimal': 40},3076541,223346,21123,0,1045,6296,3076541,222301,14827,1073,1134,1197,0,11,408,1073,1123,789,poisson-block-composition
2708,sp_workloads,1690805680,wl_small_mem,1498,mixed:GM-LM-RR-LSVT-SGD-PATE-sub25100-defpa,4,ilp,block-composition,poisson,equal-ncd,mixed:GM-LM-RR-LSVT-SGD-PATE,sub25100,nopa,Unlocking,0.2,GaussianMechanism,{'Optimal': 40},1113,1088,1060,0,565,1060,1113,523,0,1113,1088,1060,0,565,1060,1113,523,0,poisson-block-composition
2709,sp_workloads,1690805680,wl_small_mem,1498,mixed:GM-LM-RR-LSVT-SGD-PATE-sub25100-defpa,4,ilp,block-composition,poisson,equal-ncd,mixed:GM-LM-RR-LSVT-SGD-PATE,sub25100,nopa,Unlocking,0.2,LaplaceMechanism,{'Optimal': 40},1062,1115,1087,0,392,1087,1062,723,0,1062,1115,1087,0,392,1087,1062,723,0,poisson-block-composition
2710,sp_workloads,1690805680,wl_small_mem,1498,mixed:GM-LM-RR-LSVT-SGD-PATE-sub25100-defpa,4,ilp,block-composition,poisson,equal-ncd,mixed:GM-LM-RR-LSVT-SGD-PATE,sub25100,nopa,Unlocking,0.2,MLNoisySGDMechanism,{'Optimal': 40},1144,1128,1131,0,574,1131,1144,554,0,1144,1128,1131,0,574,1131,1144,554,0,poisson-block-composition
2711,sp_workloads,1690805680,wl_small_mem,1498,mixed:GM-LM-RR-LSVT-SGD-PATE-sub25100-defpa,4,ilp,block-composition,poisson,equal-ncd,mixed:GM-LM-RR-LSVT-SGD-PATE,sub25100,nopa,Unlocking,0.2,MLPateGaussianMechanism,{'Optimal': 40},1154,1099,1070,0,539,1070,1154,560,0,1154,1099,1070,0,539,1070,1154,560,0,poisson-block-composition
2712,sp_workloads,1690805680,wl_small_mem,1498,mixed:GM-LM-RR-LSVT-SGD-PATE-sub25100-defpa,4,ilp,block-composition,poisson,equal-ncd,mixed:GM-LM-RR-LSVT-SGD-PATE,sub25100,nopa,Unlocking,0.2,RandResponseMechanism,{'Optimal': 40},1149,1123,1162,0,0,1162,1149,1123,0,1149,1123,1162,0,0,1162,1149,1123,0,poisson-block-composition
2713,sp_workloads,1690805680,wl_small_mem,1498,mixed:GM-LM-RR-LSVT-SGD-PATE-sub25100-defpa,4,ilp,block-composition,poisson,equal-ncd,mixed:GM-LM-RR-LSVT-SGD-PATE,sub25100,nopa,Unlocking,0.2,SVTLaplaceMechanism,{'Optimal': 40},1073,1134,1197,0,50,1197,1073,1084,0,1073,1134,1197,0,50,1197,1073,1084,0,poisson-block-composition
2714,sp_workloads,1690805680,wl_small_mem,1499,mixed:GM-LM-RR-LSVT-SGD-PATE-sub25100-defpa,4,ilp,block-composition,poisson,equal-ncd,mixed:GM-LM-RR-LSVT-SGD-PATE,sub25100,nopa,Unlocking,0.4,GaussianMechanism,{'Optimal': 40},1113,1088,1060,0,564,1059,1113,524,1,1113,1088,1060,0,564,1059,1113,524,1,poisson-block-composition
2715,sp_workloads,1690805680,wl_small_mem,1499,mixed:GM-LM-RR-LSVT-SGD-PATE-sub25100-defpa,4,ilp,block-composition,poisson,equal-ncd,mixed:GM-LM-RR-LSVT-SGD-PATE,sub25100,nopa,Unlocking,0.4,LaplaceMechanism,{'Optimal': 40},1062,1115,1087,0,322,1087,1062,793,0,1062,1115,1087,0,322,1087,1062,793,0,poisson-block-composition
2716,sp_workloads,1690805680,wl_small_mem,1499,mixed:GM-LM-RR-LSVT-SGD-PATE-sub25100-defpa,4,ilp,block-composition,poisson,equal-ncd,mixed:GM-LM-RR-LSVT-SGD-PATE,sub25100,nopa,Unlocking,0.4,MLNoisySGDMechanism,{'Optimal': 40},1144,1128,1131,0,441,1130,1144,687,1,1144,1128,1131,0,441,1130,1144,687,1,poisson-block-composition
2717,sp_workloads,1690805680,wl_small_mem,1499,mixed:GM-LM-RR-LSVT-SGD-PATE-sub25100-defpa,4,ilp,block-composition,poisson,equal-ncd,mixed:GM-LM-RR-LSVT-SGD-PATE,sub25100,nopa,Unlocking,0.4,MLPateGaussianMechanism,{'Optimal': 40},1154,1099,1070,0,537,1033,1154,562,37,1154,1099,1070,0,537,1033,1154,562,37,poisson-block-composition
2718,sp_workloads,1690805680,wl_small_mem,1499,mixed:GM-LM-RR-LSVT-SGD-PATE-sub25100-defpa,4,ilp,block-composition,poisson,equal-ncd,mixed:GM-LM-RR-LSVT-SGD-PATE,sub25100,nopa,Unlocking,0.4,RandResponseMechanism,{'Optimal': 40},1149,1123,1162,0,0,1160,1149,1123,2,1149,1123,1162,0,0,1160,1149,1123,2,poisson-block-composition
2719,sp_workloads,1690805680,wl_small_mem,1499,mixed:GM-LM-RR-LSVT-SGD-PATE-sub25100-defpa,4,ilp,block-composition,poisson,equal-ncd,mixed:GM-LM-RR-LSVT-SGD-PATE,sub25100,nopa,Unlocking,0.4,SVTLaplaceMechanism,{'Optimal': 40},1073,1134,1197,0,136,1196,1073,998,1,1073,1134,1197,0,136,1196,1073,998,1,poisson-block-composition
2720,sp_workloads,1690805680,wl_small_mem,1500,basic:GM-LM-RR-LSVT-sub25100-defpa,0,ilp,block-composition,poisson,ncd,basic:GM-LM-RR-LSVT,sub25100,nopa,Unlocking,0.2,GaussianMechanism,{'Optimal': 40},4847751,317174,28905,797309,46415,12211,4050442,270759,16694,1760,1618,1607,426,381,797,1334,1237,810,poisson-block-composition
2721,sp_workloads,1690805680,wl_small_mem,1500,basic:GM-LM-RR-LSVT-sub25100-defpa,0,ilp,block-composition,poisson,ncd,basic:GM-LM-RR-LSVT,sub25100,nopa,Unlocking,0.2,LaplaceMechanism,{'Optimal': 40},4580618,310999,29482,119501,726,13498,4461117,310273,15984,1690,1679,1654,55,8,870,1635,1671,784,poisson-block-composition
2722,sp_workloads,1690805680,wl_small_mem,1500,basic:GM-LM-RR-LSVT-sub25100-defpa,0,ilp,block-composition,poisson,ncd,basic:GM-LM-RR-LSVT,sub25100,nopa,Unlocking,0.2,RandResponseMechanism,{'Optimal': 40},4834309,320190,30099,0,958,13269,4834309,319232,16830,1752,1677,1693,0,7,859,1752,1670,834,poisson-block-composition
2723,sp_workloads,1690805680,wl_small_mem,1500,basic:GM-LM-RR-LSVT-sub25100-defpa,0,ilp,block-composition,poisson,ncd,basic:GM-LM-RR-LSVT,sub25100,nopa,Unlocking,0.2,SVTLaplaceMechanism,{'Optimal': 40},4502539,307841,30348,0,788,13180,4502539,307053,17168,1685,1652,1684,0,7,852,1685,1645,832,poisson-block-composition
2724,sp_workloads,1690805680,wl_small_mem,1501,basic:GM-LM-RR-LSVT-sub25100-defpa,0,ilp,block-composition,poisson,ncd,basic:GM-LM-RR-LSVT,sub25100,nopa,Unlocking,0.4,GaussianMechanism,{'Optimal': 40},4847751,317174,28905,741586,38849,11900,4106165,278325,17005,1760,1618,1607,391,313,788,1369,1305,819,poisson-block-composition
2725,sp_workloads,1690805680,wl_small_mem,1501,basic:GM-LM-RR-LSVT-sub25100-defpa,0,ilp,block-composition,poisson,ncd,basic:GM-LM-RR-LSVT,sub25100,nopa,Unlocking,0.4,LaplaceMechanism,{'Optimal': 40},4580618,310999,29482,166414,15,13518,4414204,310984,15964,1690,1679,1654,77,1,866,1613,1678,788,poisson-block-composition
2726,sp_workloads,1690805680,wl_small_mem,1501,basic:GM-LM-RR-LSVT-sub25100-defpa,0,ilp,block-composition,poisson,ncd,basic:GM-LM-RR-LSVT,sub25100,nopa,Unlocking,0.4,RandResponseMechanism,{'Optimal': 40},4834309,320190,30099,0,0,12472,4834309,320190,17627,1752,1677,1693,0,0,824,1752,1677,869,poisson-block-composition
2727,sp_workloads,1690805680,wl_small_mem,1501,basic:GM-LM-RR-LSVT-sub25100-defpa,0,ilp,block-composition,poisson,ncd,basic:GM-LM-RR-LSVT,sub25100,nopa,Unlocking,0.4,SVTLaplaceMechanism,{'Optimal': 40},4502539,307841,30348,6531,15,12051,4496008,307826,18297,1685,1652,1684,3,1,797,1682,1651,887,poisson-block-composition
2728,sp_workloads,1690805680,wl_small_mem,1502,basic:GM-LM-RR-LSVT-sub25100-defpa,0,ilp,block-composition,poisson,equal-ncd,basic:GM-LM-RR-LSVT,sub25100,nopa,Unlocking,0.2,GaussianMechanism,{'Optimal': 40},1760,1618,1607,0,776,1607,1760,842,0,1760,1618,1607,0,776,1607,1760,842,0,poisson-block-composition
2729,sp_workloads,1690805680,wl_small_mem,1502,basic:GM-LM-RR-LSVT-sub25100-defpa,0,ilp,block-composition,poisson,equal-ncd,basic:GM-LM-RR-LSVT,sub25100,nopa,Unlocking,0.2,LaplaceMechanism,{'Optimal': 40},1690,1679,1654,0,614,1654,1690,1065,0,1690,1679,1654,0,614,1654,1690,1065,0,poisson-block-composition
2730,sp_workloads,1690805680,wl_small_mem,1502,basic:GM-LM-RR-LSVT-sub25100-defpa,0,ilp,block-composition,poisson,equal-ncd,basic:GM-LM-RR-LSVT,sub25100,nopa,Unlocking,0.2,RandResponseMechanism,{'Optimal': 40},1752,1677,1693,0,0,1693,1752,1677,0,1752,1677,1693,0,0,1693,1752,1677,0,poisson-block-composition
2731,sp_workloads,1690805680,wl_small_mem,1502,basic:GM-LM-RR-LSVT-sub25100-defpa,0,ilp,block-composition,poisson,equal-ncd,basic:GM-LM-RR-LSVT,sub25100,nopa,Unlocking,0.2,SVTLaplaceMechanism,{'Optimal': 40},1685,1652,1684,0,17,1684,1685,1635,0,1685,1652,1684,0,17,1684,1685,1635,0,poisson-block-composition
2732,sp_workloads,1690805680,wl_small_mem,1503,basic:GM-LM-RR-LSVT-sub25100-defpa,0,ilp,block-composition,poisson,equal-ncd,basic:GM-LM-RR-LSVT,sub25100,nopa,Unlocking,0.4,GaussianMechanism,{'Optimal': 40},1760,1618,1607,0,776,1596,1760,842,11,1760,1618,1607,0,776,1596,1760,842,11,poisson-block-composition
2733,sp_workloads,1690805680,wl_small_mem,1503,basic:GM-LM-RR-LSVT-sub25100-defpa,0,ilp,block-composition,poisson,equal-ncd,basic:GM-LM-RR-LSVT,sub25100,nopa,Unlocking,0.4,LaplaceMechanism,{'Optimal': 40},1690,1679,1654,0,540,1653,1690,1139,1,1690,1679,1654,0,540,1653,1690,1139,1,poisson-block-composition
2734,sp_workloads,1690805680,wl_small_mem,1503,basic:GM-LM-RR-LSVT-sub25100-defpa,0,ilp,block-composition,poisson,equal-ncd,basic:GM-LM-RR-LSVT,sub25100,nopa,Unlocking,0.4,RandResponseMechanism,{'Optimal': 40},1752,1677,1693,0,5,1693,1752,1672,0,1752,1677,1693,0,5,1693,1752,1672,0,poisson-block-composition
2735,sp_workloads,1690805680,wl_small_mem,1503,basic:GM-LM-RR-LSVT-sub25100-defpa,0,ilp,block-composition,poisson,equal-ncd,basic:GM-LM-RR-LSVT,sub25100,nopa,Unlocking,0.4,SVTLaplaceMechanism,{'Optimal': 40},1685,1652,1684,0,78,1684,1685,1574,0,1685,1652,1684,0,78,1684,1685,1574,0,poisson-block-composition
2736,sp_workloads,1690805680,wl_small_mem,1504,basic:GM-LM-RR-LSVT-sub25100-defpa,1,ilp,block-composition,poisson,ncd,basic:GM-LM-RR-LSVT,sub25100,nopa,Unlocking,0.2,GaussianMechanism,{'Optimal': 40},4674135,351804,29818,860197,45658,12995,3813938,306146,16823,1725,1745,1670,452,370,861,1273,1375,809,poisson-block-composition
2737,sp_workloads,1690805680,wl_small_mem,1504,basic:GM-LM-RR-LSVT-sub25100-defpa,1,ilp,block-composition,poisson,ncd,basic:GM-LM-RR-LSVT,sub25100,nopa,Unlocking,0.2,LaplaceMechanism,{'Optimal': 40},4701336,316959,30901,98103,635,13647,4603233,316324,17254,1705,1659,1707,45,9,865,1660,1650,842,poisson-block-composition
2738,sp_workloads,1690805680,wl_small_mem,1504,basic:GM-LM-RR-LSVT-sub25100-defpa,1,ilp,block-composition,poisson,ncd,basic:GM-LM-RR-LSVT,sub25100,nopa,Unlocking,0.2,RandResponseMechanism,{'Optimal': 40},4751311,334074,30363,0,745,13344,4751311,333329,17019,1634,1678,1701,0,7,864,1634,1671,837,poisson-block-composition
2739,sp_workloads,1690805680,wl_small_mem,1504,basic:GM-LM-RR-LSVT-sub25100-defpa,1,ilp,block-composition,poisson,ncd,basic:GM-LM-RR-LSVT,sub25100,nopa,Unlocking,0.2,SVTLaplaceMechanism,{'Optimal': 40},4658717,301226,29963,0,806,12148,4658717,300420,17815,1700,1628,1669,0,7,796,1700,1621,873,poisson-block-composition
2740,sp_workloads,1690805680,wl_small_mem,1505,basic:GM-LM-RR-LSVT-sub25100-defpa,1,ilp,block-composition,poisson,ncd,basic:GM-LM-RR-LSVT,sub25100,nopa,Unlocking,0.4,GaussianMechanism,{'Optimal': 40},4674135,351804,29818,813580,40961,12935,3860555,310843,16883,1725,1745,1670,424,341,857,1301,1404,813,poisson-block-composition
2741,sp_workloads,1690805680,wl_small_mem,1505,basic:GM-LM-RR-LSVT-sub25100-defpa,1,ilp,block-composition,poisson,ncd,basic:GM-LM-RR-LSVT,sub25100,nopa,Unlocking,0.4,LaplaceMechanism,{'Optimal': 40},4701336,316959,30901,132312,525,13972,4569024,316434,16929,1705,1659,1707,61,10,876,1644,1649,831,poisson-block-composition
2742,sp_workloads,1690805680,wl_small_mem,1505,basic:GM-LM-RR-LSVT-sub25100-defpa,1,ilp,block-composition,poisson,ncd,basic:GM-LM-RR-LSVT,sub25100,nopa,Unlocking,0.4,RandResponseMechanism,{'Optimal': 40},4751311,334074,30363,0,791,12791,4751311,333283,17572,1634,1678,1701,0,9,841,1634,1669,860,poisson-block-composition
2743,sp_workloads,1690805680,wl_small_mem,1505,basic:GM-LM-RR-LSVT-sub25100-defpa,1,ilp,block-composition,poisson,ncd,basic:GM-LM-RR-LSVT,sub25100,nopa,Unlocking,0.4,SVTLaplaceMechanism,{'Optimal': 40},4658717,301226,29963,0,852,11428,4658717,300374,18535,1700,1628,1669,0,9,748,1700,1619,921,poisson-block-composition
2744,sp_workloads,1690805680,wl_small_mem,1506,basic:GM-LM-RR-LSVT-sub25100-defpa,1,ilp,block-composition,poisson,equal-ncd,basic:GM-LM-RR-LSVT,sub25100,nopa,Unlocking,0.2,GaussianMechanism,{'Optimal': 40},1725,1745,1670,0,861,1670,1725,884,0,1725,1745,1670,0,861,1670,1725,884,0,poisson-block-composition
2745,sp_workloads,1690805680,wl_small_mem,1506,basic:GM-LM-RR-LSVT-sub25100-defpa,1,ilp,block-composition,poisson,equal-ncd,basic:GM-LM-RR-LSVT,sub25100,nopa,Unlocking,0.2,LaplaceMechanism,{'Optimal': 40},1705,1659,1707,0,568,1707,1705,1091,0,1705,1659,1707,0,568,1707,1705,1091,0,poisson-block-composition
2746,sp_workloads,1690805680,wl_small_mem,1506,basic:GM-LM-RR-LSVT-sub25100-defpa,1,ilp,block-composition,poisson,equal-ncd,basic:GM-LM-RR-LSVT,sub25100,nopa,Unlocking,0.2,RandResponseMechanism,{'Optimal': 40},1634,1678,1701,0,0,1701,1634,1678,0,1634,1678,1701,0,0,1701,1634,1678,0,poisson-block-composition
2747,sp_workloads,1690805680,wl_small_mem,1506,basic:GM-LM-RR-LSVT-sub25100-defpa,1,ilp,block-composition,poisson,equal-ncd,basic:GM-LM-RR-LSVT,sub25100,nopa,Unlocking,0.2,SVTLaplaceMechanism,{'Optimal': 40},1700,1628,1669,0,27,1669,1700,1601,0,1700,1628,1669,0,27,1669,1700,1601,0,poisson-block-composition
2748,sp_workloads,1690805680,wl_small_mem,1507,basic:GM-LM-RR-LSVT-sub25100-defpa,1,ilp,block-composition,poisson,equal-ncd,basic:GM-LM-RR-LSVT,sub25100,nopa,Unlocking,0.4,GaussianMechanism,{'Optimal': 40},1725,1745,1670,0,861,1643,1725,884,27,1725,1745,1670,0,861,1643,1725,884,27,poisson-block-composition
2749,sp_workloads,1690805680,wl_small_mem,1507,basic:GM-LM-RR-LSVT-sub25100-defpa,1,ilp,block-composition,poisson,equal-ncd,basic:GM-LM-RR-LSVT,sub25100,nopa,Unlocking,0.4,LaplaceMechanism,{'Optimal': 40},1705,1659,1707,0,494,1707,1705,1165,0,1705,1659,1707,0,494,1707,1705,1165,0,poisson-block-composition
2750,sp_workloads,1690805680,wl_small_mem,1507,basic:GM-LM-RR-LSVT-sub25100-defpa,1,ilp,block-composition,poisson,equal-ncd,basic:GM-LM-RR-LSVT,sub25100,nopa,Unlocking,0.4,RandResponseMechanism,{'Optimal': 40},1634,1678,1701,0,7,1700,1634,1671,1,1634,1678,1701,0,7,1700,1634,1671,1,poisson-block-composition
2751,sp_workloads,1690805680,wl_small_mem,1507,basic:GM-LM-RR-LSVT-sub25100-defpa,1,ilp,block-composition,poisson,equal-ncd,basic:GM-LM-RR-LSVT,sub25100,nopa,Unlocking,0.4,SVTLaplaceMechanism,{'Optimal': 40},1700,1628,1669,0,89,1668,1700,1539,1,1700,1628,1669,0,89,1668,1700,1539,1,poisson-block-composition
2752,sp_workloads,1690805680,wl_small_mem,1508,basic:GM-LM-RR-LSVT-sub25100-defpa,2,ilp,block-composition,poisson,ncd,basic:GM-LM-RR-LSVT,sub25100,nopa,Unlocking,0.2,GaussianMechanism,{'Optimal': 40},4344073,336565,33248,788083,50763,13632,3555990,285802,19616,1647,1671,1731,407,416,849,1240,1255,882,poisson-block-composition
2753,sp_workloads,1690805680,wl_small_mem,1508,basic:GM-LM-RR-LSVT-sub25100-defpa,2,ilp,block-composition,poisson,ncd,basic:GM-LM-RR-LSVT,sub25100,nopa,Unlocking,0.2,LaplaceMechanism,{'Optimal': 40},4548967,333299,30800,152403,0,13808,4396564,333299,16992,1660,1661,1646,68,0,836,1592,1661,810,poisson-block-composition
2754,sp_workloads,1690805680,wl_small_mem,1508,basic:GM-LM-RR-LSVT-sub25100-defpa,2,ilp,block-composition,poisson,ncd,basic:GM-LM-RR-LSVT,sub25100,nopa,Unlocking,0.2,RandResponseMechanism,{'Optimal': 40},5016525,328891,32448,0,0,14672,5016525,328891,17776,1714,1690,1723,0,0,888,1714,1690,835,poisson-block-composition
2755,sp_workloads,1690805680,wl_small_mem,1508,basic:GM-LM-RR-LSVT-sub25100-defpa,2,ilp,block-composition,poisson,ncd,basic:GM-LM-RR-LSVT,sub25100,nopa,Unlocking,0.2,SVTLaplaceMechanism,{'Optimal': 40},4781610,327880,32576,0,0,13504,4781610,327880,19072,1631,1679,1700,0,0,834,1631,1679,866,poisson-block-composition
2756,sp_workloads,1690805680,wl_small_mem,1509,basic:GM-LM-RR-LSVT-sub25100-defpa,2,ilp,block-composition,poisson,ncd,basic:GM-LM-RR-LSVT,sub25100,nopa,Unlocking,0.4,GaussianMechanism,{'Optimal': 40},4344073,336565,33248,738386,40049,13440,3605687,296516,19808,1647,1671,1731,379,335,839,1268,1336,892,poisson-block-composition
2757,sp_workloads,1690805680,wl_small_mem,1509,basic:GM-LM-RR-LSVT-sub25100-defpa,2,ilp,block-composition,poisson,ncd,basic:GM-LM-RR-LSVT,sub25100,nopa,Unlocking,0.4,LaplaceMechanism,{'Optimal': 40},4548967,333299,30800,173969,482,14464,4374998,332817,16336,1660,1661,1646,78,9,861,1582,1652,785,poisson-block-composition
2758,sp_workloads,1690805680,wl_small_mem,1509,basic:GM-LM-RR-LSVT-sub25100-defpa,2,ilp,block-composition,poisson,ncd,basic:GM-LM-RR-LSVT,sub25100,nopa,Unlocking,0.4,RandResponseMechanism,{'Optimal': 40},5016525,328891,32448,0,1190,15072,5016525,327701,17376,1714,1690,1723,0,9,920,1714,1681,803,poisson-block-composition
2759,sp_workloads,1690805680,wl_small_mem,1509,basic:GM-LM-RR-LSVT-sub25100-defpa,2,ilp,block-composition,poisson,ncd,basic:GM-LM-RR-LSVT,sub25100,nopa,Unlocking,0.4,SVTLaplaceMechanism,{'Optimal': 40},4781610,327880,32576,0,1143,12800,4781610,326737,19776,1631,1679,1700,0,9,788,1631,1670,912,poisson-block-composition
2760,sp_workloads,1690805680,wl_small_mem,1510,basic:GM-LM-RR-LSVT-sub25100-defpa,2,ilp,block-composition,poisson,equal-ncd,basic:GM-LM-RR-LSVT,sub25100,nopa,Unlocking,0.2,GaussianMechanism,{'Optimal': 40},1647,1671,1731,0,826,1731,1647,845,0,1647,1671,1731,0,826,1731,1647,845,0,poisson-block-composition
2761,sp_workloads,1690805680,wl_small_mem,1510,basic:GM-LM-RR-LSVT-sub25100-defpa,2,ilp,block-composition,poisson,equal-ncd,basic:GM-LM-RR-LSVT,sub25100,nopa,Unlocking,0.2,LaplaceMechanism,{'Optimal': 40},1660,1661,1646,0,564,1646,1660,1097,0,1660,1661,1646,0,564,1646,1660,1097,0,poisson-block-composition
2762,sp_workloads,1690805680,wl_small_mem,1510,basic:GM-LM-RR-LSVT-sub25100-defpa,2,ilp,block-composition,poisson,equal-ncd,basic:GM-LM-RR-LSVT,sub25100,nopa,Unlocking,0.2,RandResponseMechanism,{'Optimal': 40},1714,1690,1723,0,0,1723,1714,1690,0,1714,1690,1723,0,0,1723,1714,1690,0,poisson-block-composition
2763,sp_workloads,1690805680,wl_small_mem,1510,basic:GM-LM-RR-LSVT-sub25100-defpa,2,ilp,block-composition,poisson,equal-ncd,basic:GM-LM-RR-LSVT,sub25100,nopa,Unlocking,0.2,SVTLaplaceMechanism,{'Optimal': 40},1631,1679,1700,0,33,1700,1631,1646,0,1631,1679,1700,0,33,1700,1631,1646,0,poisson-block-composition
2764,sp_workloads,1690805680,wl_small_mem,1511,basic:GM-LM-RR-LSVT-sub25100-defpa,2,ilp,block-composition,poisson,equal-ncd,basic:GM-LM-RR-LSVT,sub25100,nopa,Unlocking,0.4,GaussianMechanism,{'Optimal': 40},1647,1671,1731,0,825,1710,1647,846,21,1647,1671,1731,0,825,1710,1647,846,21,poisson-block-composition
2765,sp_workloads,1690805680,wl_small_mem,1511,basic:GM-LM-RR-LSVT-sub25100-defpa,2,ilp,block-composition,poisson,equal-ncd,basic:GM-LM-RR-LSVT,sub25100,nopa,Unlocking,0.4,LaplaceMechanism,{'Optimal': 40},1660,1661,1646,0,484,1646,1660,1177,0,1660,1661,1646,0,484,1646,1660,1177,0,poisson-block-composition
2766,sp_workloads,1690805680,wl_small_mem,1511,basic:GM-LM-RR-LSVT-sub25100-defpa,2,ilp,block-composition,poisson,equal-ncd,basic:GM-LM-RR-LSVT,sub25100,nopa,Unlocking,0.4,RandResponseMechanism,{'Optimal': 40},1714,1690,1723,0,5,1723,1714,1685,0,1714,1690,1723,0,5,1723,1714,1685,0,poisson-block-composition
2767,sp_workloads,1690805680,wl_small_mem,1511,basic:GM-LM-RR-LSVT-sub25100-defpa,2,ilp,block-composition,poisson,equal-ncd,basic:GM-LM-RR-LSVT,sub25100,nopa,Unlocking,0.4,SVTLaplaceMechanism,{'Optimal': 40},1631,1679,1700,0,101,1699,1631,1578,1,1631,1679,1700,0,101,1699,1631,1578,1,poisson-block-composition
2768,sp_workloads,1690805680,wl_small_mem,1512,basic:GM-LM-RR-LSVT-sub25100-defpa,3,ilp,block-composition,poisson,ncd,basic:GM-LM-RR-LSVT,sub25100,nopa,Unlocking,0.2,GaussianMechanism,{'Optimal': 40},4431438,335185,30243,808648,43003,12066,3622790,292182,18177,1636,1707,1661,422,357,798,1214,1350,863,poisson-block-composition
2769,sp_workloads,1690805680,wl_small_mem,1512,basic:GM-LM-RR-LSVT-sub25100-defpa,3,ilp,block-composition,poisson,ncd,basic:GM-LM-RR-LSVT,sub25100,nopa,Unlocking,0.2,LaplaceMechanism,{'Optimal': 40},4614241,302136,30909,126583,599,15562,4487658,301537,15347,1669,1590,1731,57,9,966,1612,1581,765,poisson-block-composition
2770,sp_workloads,1690805680,wl_small_mem,1512,basic:GM-LM-RR-LSVT-sub25100-defpa,3,ilp,block-composition,poisson,ncd,basic:GM-LM-RR-LSVT,sub25100,nopa,Unlocking,0.2,RandResponseMechanism,{'Optimal': 40},4710432,347409,29228,0,587,12866,4710432,346822,16362,1691,1685,1636,0,5,846,1691,1680,790,poisson-block-composition
2771,sp_workloads,1690805680,wl_small_mem,1512,basic:GM-LM-RR-LSVT-sub25100-defpa,3,ilp,block-composition,poisson,ncd,basic:GM-LM-RR-LSVT,sub25100,nopa,Unlocking,0.2,SVTLaplaceMechanism,{'Optimal': 40},4781445,315437,29779,0,776,11967,4781445,314661,17812,1697,1624,1645,0,8,785,1697,1616,860,poisson-block-composition
2772,sp_workloads,1690805680,wl_small_mem,1513,basic:GM-LM-RR-LSVT-sub25100-defpa,3,ilp,block-composition,poisson,ncd,basic:GM-LM-RR-LSVT,sub25100,nopa,Unlocking,0.4,GaussianMechanism,{'Optimal': 40},4431438,335185,30243,758665,37162,12352,3672773,298023,17891,1636,1707,1661,394,290,816,1242,1417,845,poisson-block-composition
2773,sp_workloads,1690805680,wl_small_mem,1513,basic:GM-LM-RR-LSVT-sub25100-defpa,3,ilp,block-composition,poisson,ncd,basic:GM-LM-RR-LSVT,sub25100,nopa,Unlocking,0.4,LaplaceMechanism,{'Optimal': 40},4614241,302136,30909,161275,629,14615,4452966,301507,16294,1669,1590,1731,73,11,937,1596,1579,794,poisson-block-composition
2774,sp_workloads,1690805680,wl_small_mem,1513,basic:GM-LM-RR-LSVT-sub25100-defpa,3,ilp,block-composition,poisson,ncd,basic:GM-LM-RR-LSVT,sub25100,nopa,Unlocking,0.4,RandResponseMechanism,{'Optimal': 40},4710432,347409,29228,0,729,13162,4710432,346680,16066,1691,1685,1636,0,7,854,1691,1678,782,poisson-block-composition
2775,sp_workloads,1690805680,wl_small_mem,1513,basic:GM-LM-RR-LSVT-sub25100-defpa,3,ilp,block-composition,poisson,ncd,basic:GM-LM-RR-LSVT,sub25100,nopa,Unlocking,0.4,SVTLaplaceMechanism,{'Optimal': 40},4781445,315437,29779,0,663,11033,4781445,314774,18746,1697,1624,1645,0,9,727,1697,1615,918,poisson-block-composition
2776,sp_workloads,1690805680,wl_small_mem,1514,basic:GM-LM-RR-LSVT-sub25100-defpa,3,ilp,block-composition,poisson,equal-ncd,basic:GM-LM-RR-LSVT,sub25100,nopa,Unlocking,0.2,GaussianMechanism,{'Optimal': 40},1636,1707,1661,0,835,1661,1636,872,0,1636,1707,1661,0,835,1661,1636,872,0,poisson-block-composition
2777,sp_workloads,1690805680,wl_small_mem,1514,basic:GM-LM-RR-LSVT-sub25100-defpa,3,ilp,block-composition,poisson,equal-ncd,basic:GM-LM-RR-LSVT,sub25100,nopa,Unlocking,0.2,LaplaceMechanism,{'Optimal': 40},1669,1590,1731,0,548,1731,1669,1042,0,1669,1590,1731,0,548,1731,1669,1042,0,poisson-block-composition
2778,sp_workloads,1690805680,wl_small_mem,1514,basic:GM-LM-RR-LSVT-sub25100-defpa,3,ilp,block-composition,poisson,equal-ncd,basic:GM-LM-RR-LSVT,sub25100,nopa,Unlocking,0.2,RandResponseMechanism,{'Optimal': 40},1691,1685,1636,0,0,1636,1691,1685,0,1691,1685,1636,0,0,1636,1691,1685,0,poisson-block-composition
2779,sp_workloads,1690805680,wl_small_mem,1514,basic:GM-LM-RR-LSVT-sub25100-defpa,3,ilp,block-composition,poisson,equal-ncd,basic:GM-LM-RR-LSVT,sub25100,nopa,Unlocking,0.2,SVTLaplaceMechanism,{'Optimal': 40},1697,1624,1645,0,51,1645,1697,1573,0,1697,1624,1645,0,51,1645,1697,1573,0,poisson-block-composition
2780,sp_workloads,1690805680,wl_small_mem,1515,basic:GM-LM-RR-LSVT-sub25100-defpa,3,ilp,block-composition,poisson,equal-ncd,basic:GM-LM-RR-LSVT,sub25100,nopa,Unlocking,0.4,GaussianMechanism,{'Optimal': 40},1636,1707,1661,0,834,1654,1636,873,7,1636,1707,1661,0,834,1654,1636,873,7,poisson-block-composition
2781,sp_workloads,1690805680,wl_small_mem,1515,basic:GM-LM-RR-LSVT-sub25100-defpa,3,ilp,block-composition,poisson,equal-ncd,basic:GM-LM-RR-LSVT,sub25100,nopa,Unlocking,0.4,LaplaceMechanism,{'Optimal': 40},1669,1590,1731,0,467,1731,1669,1123,0,1669,1590,1731,0,467,1731,1669,1123,0,poisson-block-composition
2782,sp_workloads,1690805680,wl_small_mem,1515,basic:GM-LM-RR-LSVT-sub25100-defpa,3,ilp,block-composition,poisson,equal-ncd,basic:GM-LM-RR-LSVT,sub25100,nopa,Unlocking,0.4,RandResponseMechanism,{'Optimal': 40},1691,1685,1636,0,8,1636,1691,1677,0,1691,1685,1636,0,8,1636,1691,1677,0,poisson-block-composition
2783,sp_workloads,1690805680,wl_small_mem,1515,basic:GM-LM-RR-LSVT-sub25100-defpa,3,ilp,block-composition,poisson,equal-ncd,basic:GM-LM-RR-LSVT,sub25100,nopa,Unlocking,0.4,SVTLaplaceMechanism,{'Optimal': 40},1697,1624,1645,0,115,1645,1697,1509,0,1697,1624,1645,0,115,1645,1697,1509,0,poisson-block-composition
2784,sp_workloads,1690805680,wl_small_mem,1516,basic:GM-LM-RR-LSVT-sub25100-defpa,4,ilp,block-composition,poisson,ncd,basic:GM-LM-RR-LSVT,sub25100,nopa,Unlocking,0.2,GaussianMechanism,{'Optimal': 40},4571824,341651,31424,846743,49313,13184,3725081,292338,18240,1667,1683,1652,439,397,815,1228,1286,837,poisson-block-composition
2785,sp_workloads,1690805680,wl_small_mem,1516,basic:GM-LM-RR-LSVT-sub25100-defpa,4,ilp,block-composition,poisson,ncd,basic:GM-LM-RR-LSVT,sub25100,nopa,Unlocking,0.2,LaplaceMechanism,{'Optimal': 40},4559498,310728,31904,109171,416,14656,4450327,310312,17248,1705,1675,1674,49,7,880,1656,1668,794,poisson-block-composition
2786,sp_workloads,1690805680,wl_small_mem,1516,basic:GM-LM-RR-LSVT-sub25100-defpa,4,ilp,block-composition,poisson,ncd,basic:GM-LM-RR-LSVT,sub25100,nopa,Unlocking,0.2,RandResponseMechanism,{'Optimal': 40},4915555,321907,33248,0,480,15024,4915555,321427,18224,1732,1682,1739,0,6,913,1732,1676,826,poisson-block-composition
2787,sp_workloads,1690805680,wl_small_mem,1516,basic:GM-LM-RR-LSVT-sub25100-defpa,4,ilp,block-composition,poisson,ncd,basic:GM-LM-RR-LSVT,sub25100,nopa,Unlocking,0.2,SVTLaplaceMechanism,{'Optimal': 40},4827443,310825,33008,0,496,14672,4827443,310329,18336,1701,1631,1753,0,7,899,1701,1624,854,poisson-block-composition
2788,sp_workloads,1690805680,wl_small_mem,1517,basic:GM-LM-RR-LSVT-sub25100-defpa,4,ilp,block-composition,poisson,ncd,basic:GM-LM-RR-LSVT,sub25100,nopa,Unlocking,0.4,GaussianMechanism,{'Optimal': 40},4571824,341651,31424,828204,44099,13008,3743620,297552,18416,1667,1683,1652,424,346,808,1243,1337,844,poisson-block-composition
2789,sp_workloads,1690805680,wl_small_mem,1517,basic:GM-LM-RR-LSVT-sub25100-defpa,4,ilp,block-composition,poisson,ncd,basic:GM-LM-RR-LSVT,sub25100,nopa,Unlocking,0.4,LaplaceMechanism,{'Optimal': 40},4559498,310728,31904,151425,0,13920,4408073,310728,17984,1705,1675,1674,68,0,846,1637,1675,828,poisson-block-composition
2790,sp_workloads,1690805680,wl_small_mem,1517,basic:GM-LM-RR-LSVT-sub25100-defpa,4,ilp,block-composition,poisson,ncd,basic:GM-LM-RR-LSVT,sub25100,nopa,Unlocking,0.4,RandResponseMechanism,{'Optimal': 40},4915555,321907,33248,0,0,13968,4915555,321907,19280,1732,1682,1739,0,0,863,1732,1682,876,poisson-block-composition
2791,sp_workloads,1690805680,wl_small_mem,1517,basic:GM-LM-RR-LSVT-sub25100-defpa,4,ilp,block-composition,poisson,ncd,basic:GM-LM-RR-LSVT,sub25100,nopa,Unlocking,0.4,SVTLaplaceMechanism,{'Optimal': 40},4827443,310825,33008,0,0,12992,4827443,310825,20016,1701,1631,1753,0,0,810,1701,1631,943,poisson-block-composition
2792,sp_workloads,1690805680,wl_small_mem,1518,basic:GM-LM-RR-LSVT-sub25100-defpa,4,ilp,block-composition,poisson,equal-ncd,basic:GM-LM-RR-LSVT,sub25100,nopa,Unlocking,0.2,GaussianMechanism,{'Optimal': 40},1667,1683,1652,0,823,1652,1667,860,0,1667,1683,1652,0,823,1652,1667,860,0,poisson-block-composition
2793,sp_workloads,1690805680,wl_small_mem,1518,basic:GM-LM-RR-LSVT-sub25100-defpa,4,ilp,block-composition,poisson,equal-ncd,basic:GM-LM-RR-LSVT,sub25100,nopa,Unlocking,0.2,LaplaceMechanism,{'Optimal': 40},1705,1675,1674,0,547,1674,1705,1128,0,1705,1675,1674,0,547,1674,1705,1128,0,poisson-block-composition
2794,sp_workloads,1690805680,wl_small_mem,1518,basic:GM-LM-RR-LSVT-sub25100-defpa,4,ilp,block-composition,poisson,equal-ncd,basic:GM-LM-RR-LSVT,sub25100,nopa,Unlocking,0.2,RandResponseMechanism,{'Optimal': 40},1732,1682,1739,0,0,1739,1732,1682,0,1732,1682,1739,0,0,1739,1732,1682,0,poisson-block-composition
2795,sp_workloads,1690805680,wl_small_mem,1518,basic:GM-LM-RR-LSVT-sub25100-defpa,4,ilp,block-composition,poisson,equal-ncd,basic:GM-LM-RR-LSVT,sub25100,nopa,Unlocking,0.2,SVTLaplaceMechanism,{'Optimal': 40},1701,1631,1753,0,43,1753,1701,1588,0,1701,1631,1753,0,43,1753,1701,1588,0,poisson-block-composition
2796,sp_workloads,1690805680,wl_small_mem,1519,basic:GM-LM-RR-LSVT-sub25100-defpa,4,ilp,block-composition,poisson,equal-ncd,basic:GM-LM-RR-LSVT,sub25100,nopa,Unlocking,0.4,GaussianMechanism,{'Optimal': 40},1667,1683,1652,0,822,1645,1667,861,7,1667,1683,1652,0,822,1645,1667,861,7,poisson-block-composition
2797,sp_workloads,1690805680,wl_small_mem,1519,basic:GM-LM-RR-LSVT-sub25100-defpa,4,ilp,block-composition,poisson,equal-ncd,basic:GM-LM-RR-LSVT,sub25100,nopa,Unlocking,0.4,LaplaceMechanism,{'Optimal': 40},1705,1675,1674,0,466,1673,1705,1209,1,1705,1675,1674,0,466,1673,1705,1209,1,poisson-block-composition
2798,sp_workloads,1690805680,wl_small_mem,1519,basic:GM-LM-RR-LSVT-sub25100-defpa,4,ilp,block-composition,poisson,equal-ncd,basic:GM-LM-RR-LSVT,sub25100,nopa,Unlocking,0.4,RandResponseMechanism,{'Optimal': 40},1732,1682,1739,0,4,1739,1732,1678,0,1732,1682,1739,0,4,1739,1732,1678,0,poisson-block-composition
2799,sp_workloads,1690805680,wl_small_mem,1519,basic:GM-LM-RR-LSVT-sub25100-defpa,4,ilp,block-composition,poisson,equal-ncd,basic:GM-LM-RR-LSVT,sub25100,nopa,Unlocking,0.4,SVTLaplaceMechanism,{'Optimal': 40},1701,1631,1753,0,112,1753,1701,1519,0,1701,1631,1753,0,112,1753,1701,1519,0,poisson-block-composition
2800,sp_workloads,1690805680,wl_small_mem,1520,gm:GM-sub25100-defpa,0,ilp,block-composition-pa,poisson,ncd,gm:GM,sub25100,defpa,Unlocking,0.2,GaussianMechanism,{'Optimal': 40},18864461,1345041,130912,7575890,634103,103216,11288571,710938,27696,6716,6728,6904,2404,3774,5508,4312,2954,1396,poisson-block-composition-pa
2801,sp_workloads,1690805680,wl_small_mem,1521,gm:GM-sub25100-defpa,0,ilp,block-composition-pa,poisson,ncd,gm:GM,sub25100,defpa,Unlocking,0.4,GaussianMechanism,{'Optimal': 40},18864461,1345041,130912,7854358,803983,102176,11010103,541058,28736,6716,6728,6904,2896,4088,5484,3820,2640,1420,poisson-block-composition-pa
2802,sp_workloads,1690805680,wl_small_mem,1522,gm:GM-sub25100-defpa,0,ilp,block-composition-pa,poisson,equal-ncd,gm:GM,sub25100,defpa,Unlocking,0.2,GaussianMechanism,{'Optimal': 40},6716,6728,6904,3191,6236,6904,3525,492,0,6716,6728,6904,3191,6236,6904,3525,492,0,poisson-block-composition-pa
2803,sp_workloads,1690805680,wl_small_mem,1523,gm:GM-sub25100-defpa,0,ilp,block-composition-pa,poisson,equal-ncd,gm:GM,sub25100,defpa,Unlocking,0.4,GaussianMechanism,{'Optimal': 40},6716,6728,6904,3225,6318,6902,3491,410,2,6716,6728,6904,3225,6318,6902,3491,410,2,poisson-block-composition-pa
2804,sp_workloads,1690805680,wl_small_mem,1524,gm:GM-sub25100-defpa,1,ilp,block-composition-pa,poisson,ncd,gm:GM,sub25100,defpa,Unlocking,0.2,GaussianMechanism,{'Optimal': 40},18715267,1320958,128176,7418314,635314,101888,11296953,685644,26288,6673,6765,6731,2423,3871,5371,4250,2894,1360,poisson-block-composition-pa
2805,sp_workloads,1690805680,wl_small_mem,1525,gm:GM-sub25100-defpa,1,ilp,block-composition-pa,poisson,ncd,gm:GM,sub25100,defpa,Unlocking,0.4,GaussianMechanism,{'Optimal': 40},18715267,1320958,128176,7722259,780541,101184,10993008,540417,26992,6673,6765,6731,2880,4068,5381,3793,2697,1350,poisson-block-composition-pa
2806,sp_workloads,1690805680,wl_small_mem,1526,gm:GM-sub25100-defpa,1,ilp,block-composition-pa,poisson,equal-ncd,gm:GM,sub25100,defpa,Unlocking,0.2,GaussianMechanism,{'Optimal': 40},6673,6765,6731,3158,6254,6730,3515,511,1,6673,6765,6731,3158,6254,6730,3515,511,1,poisson-block-composition-pa
2807,sp_workloads,1690805680,wl_small_mem,1527,gm:GM-sub25100-defpa,1,ilp,block-composition-pa,poisson,equal-ncd,gm:GM,sub25100,defpa,Unlocking,0.4,GaussianMechanism,{'Optimal': 40},6673,6765,6731,3203,6326,6731,3470,439,0,6673,6765,6731,3203,6326,6731,3470,439,0,poisson-block-composition-pa
2808,sp_workloads,1690805680,wl_small_mem,1528,gm:GM-sub25100-defpa,2,ilp,block-composition-pa,poisson,ncd,gm:GM,sub25100,defpa,Unlocking,0.2,GaussianMechanism,{'Optimal': 40},18806374,1355979,126784,7457647,631414,101872,11348727,724565,24912,6783,6833,6678,2387,3831,5419,4396,3002,1259,poisson-block-composition-pa
2809,sp_workloads,1690805680,wl_small_mem,1529,gm:GM-sub25100-defpa,2,ilp,block-composition-pa,poisson,ncd,gm:GM,sub25100,defpa,Unlocking,0.4,GaussianMechanism,{'Optimal': 40},18806374,1355979,126784,7673667,804513,101232,11132707,551466,25552,6783,6833,6678,2938,4125,5417,3845,2708,1261,poisson-block-composition-pa
2810,sp_workloads,1690805680,wl_small_mem,1530,gm:GM-sub25100-defpa,2,ilp,block-composition-pa,poisson,equal-ncd,gm:GM,sub25100,defpa,Unlocking,0.2,GaussianMechanism,{'Optimal': 40},6783,6833,6678,3185,6343,6678,3598,490,0,6783,6833,6678,3185,6343,6678,3598,490,0,poisson-block-composition-pa
2811,sp_workloads,1690805680,wl_small_mem,1531,gm:GM-sub25100-defpa,2,ilp,block-composition-pa,poisson,equal-ncd,gm:GM,sub25100,defpa,Unlocking,0.4,GaussianMechanism,{'Optimal': 40},6783,6833,6678,3213,6430,6678,3570,403,0,6783,6833,6678,3213,6430,6678,3570,403,0,poisson-block-composition-pa
2812,sp_workloads,1690805680,wl_small_mem,1532,gm:GM-sub25100-defpa,3,ilp,block-composition-pa,poisson,ncd,gm:GM,sub25100,defpa,Unlocking,0.2,GaussianMechanism,{'Optimal': 40},18672541,1292482,118587,7404758,599174,96152,11267783,693308,22435,6771,6693,6629,2419,3679,5400,4352,3014,1229,poisson-block-composition-pa
2813,sp_workloads,1690805680,wl_small_mem,1533,gm:GM-sub25100-defpa,3,ilp,block-composition-pa,poisson,ncd,gm:GM,sub25100,defpa,Unlocking,0.4,GaussianMechanism,{'Optimal': 40},18672541,1292482,118587,7595540,764585,95249,11077001,527897,23338,6771,6693,6629,2865,3986,5391,3906,2707,1238,poisson-block-composition-pa
2814,sp_workloads,1690805680,wl_small_mem,1534,gm:GM-sub25100-defpa,3,ilp,block-composition-pa,poisson,equal-ncd,gm:GM,sub25100,defpa,Unlocking,0.2,GaussianMechanism,{'Optimal': 40},6771,6693,6629,3178,6195,6628,3593,498,1,6771,6693,6629,3178,6195,6628,3593,498,1,poisson-block-composition-pa
2815,sp_workloads,1690805680,wl_small_mem,1535,gm:GM-sub25100-defpa,3,ilp,block-composition-pa,poisson,equal-ncd,gm:GM,sub25100,defpa,Unlocking,0.4,GaussianMechanism,{'Optimal': 40},6771,6693,6629,3189,6273,6628,3582,420,1,6771,6693,6629,3189,6273,6628,3582,420,1,poisson-block-composition-pa
2816,sp_workloads,1690805680,wl_small_mem,1536,gm:GM-sub25100-defpa,4,ilp,block-composition-pa,poisson,ncd,gm:GM,sub25100,defpa,Unlocking,0.2,GaussianMechanism,{'Optimal': 40},18857452,1277663,120343,7485129,604149,96879,11372323,673514,23464,6862,6691,6713,2417,3663,5409,4445,3028,1304,poisson-block-composition-pa
2817,sp_workloads,1690805680,wl_small_mem,1537,gm:GM-sub25100-defpa,4,ilp,block-composition-pa,poisson,ncd,gm:GM,sub25100,defpa,Unlocking,0.4,GaussianMechanism,{'Optimal': 40},18857452,1277663,120343,7624150,767569,95904,11233302,510094,24439,6862,6691,6713,2942,4035,5424,3920,2656,1289,poisson-block-composition-pa
2818,sp_workloads,1690805680,wl_small_mem,1538,gm:GM-sub25100-defpa,4,ilp,block-composition-pa,poisson,equal-ncd,gm:GM,sub25100,defpa,Unlocking,0.2,GaussianMechanism,{'Optimal': 40},6862,6691,6713,3221,6177,6713,3641,514,0,6862,6691,6713,3221,6177,6713,3641,514,0,poisson-block-composition-pa
2819,sp_workloads,1690805680,wl_small_mem,1539,gm:GM-sub25100-defpa,4,ilp,block-composition-pa,poisson,equal-ncd,gm:GM,sub25100,defpa,Unlocking,0.4,GaussianMechanism,{'Optimal': 40},6862,6691,6713,3239,6288,6712,3623,403,1,6862,6691,6713,3239,6288,6712,3623,403,1,poisson-block-composition-pa
2820,sp_workloads,1690805680,wl_small_mem,1540,ml:SGD-PATE-sub25100-defpa,0,ilp,block-composition-pa,poisson,ncd,ml:SGD-PATE,sub25100,defpa,Unlocking,0.2,MLNoisySGDMechanism,{'Optimal': 40},9320337,647144,60780,1706419,95900,22155,7613918,551244,38625,3347,3348,3392,782,537,1383,2565,2811,2009,poisson-block-composition-pa
2821,sp_workloads,1690805680,wl_small_mem,1540,ml:SGD-PATE-sub25100-defpa,0,ilp,block-composition-pa,poisson,ncd,ml:SGD-PATE,sub25100,defpa,Unlocking,0.2,MLPateGaussianMechanism,{'Optimal': 40},9560711,630849,59490,1044615,117941,25455,8516096,512908,34035,3488,3389,3328,562,665,1621,2926,2724,1707,poisson-block-composition-pa
2822,sp_workloads,1690805680,wl_small_mem,1541,ml:SGD-PATE-sub25100-defpa,0,ilp,block-composition-pa,poisson,ncd,ml:SGD-PATE,sub25100,defpa,Unlocking,0.4,MLNoisySGDMechanism,{'Optimal': 40},9320337,647144,60780,1717295,95959,21435,7603042,551185,39345,3347,3348,3392,751,515,1339,2596,2833,2053,poisson-block-composition-pa
2823,sp_workloads,1690805680,wl_small_mem,1541,ml:SGD-PATE-sub25100-defpa,0,ilp,block-composition-pa,poisson,ncd,ml:SGD-PATE,sub25100,defpa,Unlocking,0.4,MLPateGaussianMechanism,{'Optimal': 40},9560711,630849,59490,1059347,108581,25695,8501364,522268,33795,3488,3389,3328,551,634,1638,2937,2755,1690,poisson-block-composition-pa
2824,sp_workloads,1690805680,wl_small_mem,1542,ml:SGD-PATE-sub25100-defpa,0,ilp,block-composition-pa,poisson,equal-ncd,ml:SGD-PATE,sub25100,defpa,Unlocking,0.2,MLNoisySGDMechanism,{'Optimal': 40},3347,3348,3392,572,2016,3392,2775,1332,0,3347,3348,3392,572,2016,3392,2775,1332,0,poisson-block-composition-pa
2825,sp_workloads,1690805680,wl_small_mem,1542,ml:SGD-PATE-sub25100-defpa,0,ilp,block-composition-pa,poisson,equal-ncd,ml:SGD-PATE,sub25100,defpa,Unlocking,0.2,MLPateGaussianMechanism,{'Optimal': 40},3488,3389,3328,358,1931,3326,3130,1458,2,3488,3389,3328,358,1931,3326,3130,1458,2,poisson-block-composition-pa
2826,sp_workloads,1690805680,wl_small_mem,1543,ml:SGD-PATE-sub25100-defpa,0,ilp,block-composition-pa,poisson,equal-ncd,ml:SGD-PATE,sub25100,defpa,Unlocking,0.4,MLNoisySGDMechanism,{'Optimal': 40},3347,3348,3392,561,2005,3392,2786,1343,0,3347,3348,3392,561,2005,3392,2786,1343,0,poisson-block-composition-pa
2827,sp_workloads,1690805680,wl_small_mem,1543,ml:SGD-PATE-sub25100-defpa,0,ilp,block-composition-pa,poisson,equal-ncd,ml:SGD-PATE,sub25100,defpa,Unlocking,0.4,MLPateGaussianMechanism,{'Optimal': 40},3488,3389,3328,353,1925,3328,3135,1464,0,3488,3389,3328,353,1925,3328,3135,1464,0,poisson-block-composition-pa
2828,sp_workloads,1690805680,wl_small_mem,1544,ml:SGD-PATE-sub25100-defpa,1,ilp,block-composition-pa,poisson,ncd,ml:SGD-PATE,sub25100,defpa,Unlocking,0.2,MLNoisySGDMechanism,{'Optimal': 40},9612014,638642,60437,1841122,98842,21613,7770892,539800,38824,3436,3336,3371,764,501,1347,2672,2835,2024,poisson-block-composition-pa
2829,sp_workloads,1690805680,wl_small_mem,1544,ml:SGD-PATE-sub25100-defpa,1,ilp,block-composition-pa,poisson,ncd,ml:SGD-PATE,sub25100,defpa,Unlocking,0.2,MLPateGaussianMechanism,{'Optimal': 40},9101816,660711,61026,1000124,90309,24744,8101692,570402,36282,3337,3307,3358,543,584,1576,2794,2723,1782,poisson-block-composition-pa
2830,sp_workloads,1690805680,wl_small_mem,1545,ml:SGD-PATE-sub25100-defpa,1,ilp,block-composition-pa,poisson,ncd,ml:SGD-PATE,sub25100,defpa,Unlocking,0.4,MLNoisySGDMechanism,{'Optimal': 40},9612014,638642,60437,1861472,98104,20959,7750542,540538,39478,3436,3336,3371,778,507,1297,2658,2829,2074,poisson-block-composition-pa
2831,sp_workloads,1690805680,wl_small_mem,1545,ml:SGD-PATE-sub25100-defpa,1,ilp,block-composition-pa,poisson,ncd,ml:SGD-PATE,sub25100,defpa,Unlocking,0.4,MLPateGaussianMechanism,{'Optimal': 40},9101816,660711,61026,1002575,87506,24977,8099241,573205,36049,3337,3307,3358,519,582,1583,2818,2725,1775,poisson-block-composition-pa
2832,sp_workloads,1690805680,wl_small_mem,1546,ml:SGD-PATE-sub25100-defpa,1,ilp,block-composition-pa,poisson,equal-ncd,ml:SGD-PATE,sub25100,defpa,Unlocking,0.2,MLNoisySGDMechanism,{'Optimal': 40},3436,3336,3371,600,1972,3370,2836,1364,1,3436,3336,3371,600,1972,3370,2836,1364,1,poisson-block-composition-pa
2833,sp_workloads,1690805680,wl_small_mem,1546,ml:SGD-PATE-sub25100-defpa,1,ilp,block-composition-pa,poisson,equal-ncd,ml:SGD-PATE,sub25100,defpa,Unlocking,0.2,MLPateGaussianMechanism,{'Optimal': 40},3337,3307,3358,398,1804,3358,2939,1503,0,3337,3307,3358,398,1804,3358,2939,1503,0,poisson-block-composition-pa
2834,sp_workloads,1690805680,wl_small_mem,1547,ml:SGD-PATE-sub25100-defpa,1,ilp,block-composition-pa,poisson,equal-ncd,ml:SGD-PATE,sub25100,defpa,Unlocking,0.4,MLNoisySGDMechanism,{'Optimal': 40},3436,3336,3371,589,1968,3371,2847,1368,0,3436,3336,3371,589,1968,3371,2847,1368,0,poisson-block-composition-pa
2835,sp_workloads,1690805680,wl_small_mem,1547,ml:SGD-PATE-sub25100-defpa,1,ilp,block-composition-pa,poisson,equal-ncd,ml:SGD-PATE,sub25100,defpa,Unlocking,0.4,MLPateGaussianMechanism,{'Optimal': 40},3337,3307,3358,377,1802,3355,2960,1505,3,3337,3307,3358,377,1802,3355,2960,1505,3,poisson-block-composition-pa
2836,sp_workloads,1690805680,wl_small_mem,1548,ml:SGD-PATE-sub25100-defpa,2,ilp,block-composition-pa,poisson,ncd,ml:SGD-PATE,sub25100,defpa,Unlocking,0.2,MLNoisySGDMechanism,{'Optimal': 40},9102086,650387,61289,1794981,95275,22122,7307105,555112,39167,3387,3344,3399,750,532,1382,2637,2812,2017,poisson-block-composition-pa
2837,sp_workloads,1690805680,wl_small_mem,1548,ml:SGD-PATE-sub25100-defpa,2,ilp,block-composition-pa,poisson,ncd,ml:SGD-PATE,sub25100,defpa,Unlocking,0.2,MLPateGaussianMechanism,{'Optimal': 40},9667159,651460,60587,1045333,103492,25146,8621826,547968,35441,3356,3340,3381,538,644,1606,2818,2696,1775,poisson-block-composition-pa
2838,sp_workloads,1690805680,wl_small_mem,1549,ml:SGD-PATE-sub25100-defpa,2,ilp,block-composition-pa,poisson,ncd,ml:SGD-PATE,sub25100,defpa,Unlocking,0.4,MLNoisySGDMechanism,{'Optimal': 40},9102086,650387,61289,1800055,98166,21041,7302031,552221,40248,3387,3344,3399,753,530,1311,2634,2814,2088,poisson-block-composition-pa
2839,sp_workloads,1690805680,wl_small_mem,1549,ml:SGD-PATE-sub25100-defpa,2,ilp,block-composition-pa,poisson,ncd,ml:SGD-PATE,sub25100,defpa,Unlocking,0.4,MLPateGaussianMechanism,{'Optimal': 40},9667159,651460,60587,1071100,99588,25041,8596059,551872,35546,3356,3340,3381,537,614,1599,2819,2726,1782,poisson-block-composition-pa
2840,sp_workloads,1690805680,wl_small_mem,1550,ml:SGD-PATE-sub25100-defpa,2,ilp,block-composition-pa,poisson,equal-ncd,ml:SGD-PATE,sub25100,defpa,Unlocking,0.2,MLNoisySGDMechanism,{'Optimal': 40},3387,3344,3399,584,2018,3399,2803,1326,0,3387,3344,3399,584,2018,3399,2803,1326,0,poisson-block-composition-pa
2841,sp_workloads,1690805680,wl_small_mem,1550,ml:SGD-PATE-sub25100-defpa,2,ilp,block-composition-pa,poisson,equal-ncd,ml:SGD-PATE,sub25100,defpa,Unlocking,0.2,MLPateGaussianMechanism,{'Optimal': 40},3356,3340,3381,395,1921,3380,2961,1419,1,3356,3340,3381,395,1921,3380,2961,1419,1,poisson-block-composition-pa
2842,sp_workloads,1690805680,wl_small_mem,1551,ml:SGD-PATE-sub25100-defpa,2,ilp,block-composition-pa,poisson,equal-ncd,ml:SGD-PATE,sub25100,defpa,Unlocking,0.4,MLNoisySGDMechanism,{'Optimal': 40},3387,3344,3399,581,2016,3399,2806,1328,0,3387,3344,3399,581,2016,3399,2806,1328,0,poisson-block-composition-pa
2843,sp_workloads,1690805680,wl_small_mem,1551,ml:SGD-PATE-sub25100-defpa,2,ilp,block-composition-pa,poisson,equal-ncd,ml:SGD-PATE,sub25100,defpa,Unlocking,0.4,MLPateGaussianMechanism,{'Optimal': 40},3356,3340,3381,382,1910,3381,2974,1430,0,3356,3340,3381,382,1910,3381,2974,1430,0,poisson-block-composition-pa
2844,sp_workloads,1690805680,wl_small_mem,1552,ml:SGD-PATE-sub25100-defpa,3,ilp,block-composition-pa,poisson,ncd,ml:SGD-PATE,sub25100,defpa,Unlocking,0.2,MLNoisySGDMechanism,{'Optimal': 40},9538338,661542,60462,1810341,108230,22020,7727997,553312,38442,3432,3504,3362,728,561,1372,2704,2943,1990,poisson-block-composition-pa
2845,sp_workloads,1690805680,wl_small_mem,1552,ml:SGD-PATE-sub25100-defpa,3,ilp,block-composition-pa,poisson,ncd,ml:SGD-PATE,sub25100,defpa,Unlocking,0.2,MLPateGaussianMechanism,{'Optimal': 40},9431567,656376,60193,1010531,97865,25377,8421036,558511,34816,3379,3400,3343,539,645,1615,2840,2755,1728,poisson-block-composition-pa
2846,sp_workloads,1690805680,wl_small_mem,1553,ml:SGD-PATE-sub25100-defpa,3,ilp,block-composition-pa,poisson,ncd,ml:SGD-PATE,sub25100,defpa,Unlocking,0.4,MLNoisySGDMechanism,{'Optimal': 40},9538338,661542,60462,1814667,102014,22486,7723671,559528,37976,3432,3504,3362,740,537,1402,2692,2967,1960,poisson-block-composition-pa
2847,sp_workloads,1690805680,wl_small_mem,1553,ml:SGD-PATE-sub25100-defpa,3,ilp,block-composition-pa,poisson,ncd,ml:SGD-PATE,sub25100,defpa,Unlocking,0.4,MLPateGaussianMechanism,{'Optimal': 40},9431567,656376,60193,1079595,91941,25520,8351972,564435,34673,3379,3400,3343,556,612,1616,2823,2788,1727,poisson-block-composition-pa
2848,sp_workloads,1690805680,wl_small_mem,1554,ml:SGD-PATE-sub25100-defpa,3,ilp,block-composition-pa,poisson,equal-ncd,ml:SGD-PATE,sub25100,defpa,Unlocking,0.2,MLNoisySGDMechanism,{'Optimal': 40},3432,3504,3362,589,2057,3362,2843,1447,0,3432,3504,3362,589,2057,3362,2843,1447,0,poisson-block-composition-pa
2849,sp_workloads,1690805680,wl_small_mem,1554,ml:SGD-PATE-sub25100-defpa,3,ilp,block-composition-pa,poisson,equal-ncd,ml:SGD-PATE,sub25100,defpa,Unlocking,0.2,MLPateGaussianMechanism,{'Optimal': 40},3379,3400,3343,378,1929,3343,3001,1471,0,3379,3400,3343,378,1929,3343,3001,1471,0,poisson-block-composition-pa
2850,sp_workloads,1690805680,wl_small_mem,1555,ml:SGD-PATE-sub25100-defpa,3,ilp,block-composition-pa,poisson,equal-ncd,ml:SGD-PATE,sub25100,defpa,Unlocking,0.4,MLNoisySGDMechanism,{'Optimal': 40},3432,3504,3362,542,2068,3362,2890,1436,0,3432,3504,3362,542,2068,3362,2890,1436,0,poisson-block-composition-pa
2851,sp_workloads,1690805680,wl_small_mem,1555,ml:SGD-PATE-sub25100-defpa,3,ilp,block-composition-pa,poisson,equal-ncd,ml:SGD-PATE,sub25100,defpa,Unlocking,0.4,MLPateGaussianMechanism,{'Optimal': 40},3379,3400,3343,364,1956,3343,3015,1444,0,3379,3400,3343,364,1956,3343,3015,1444,0,poisson-block-composition-pa
2852,sp_workloads,1690805680,wl_small_mem,1556,ml:SGD-PATE-sub25100-defpa,4,ilp,block-composition-pa,poisson,ncd,ml:SGD-PATE,sub25100,defpa,Unlocking,0.2,MLNoisySGDMechanism,{'Optimal': 40},9619476,680600,63408,1862628,101800,22496,7756848,578800,40912,3443,3381,3350,784,514,1331,2659,2867,2019,poisson-block-composition-pa
2853,sp_workloads,1690805680,wl_small_mem,1556,ml:SGD-PATE-sub25100-defpa,4,ilp,block-composition-pa,poisson,ncd,ml:SGD-PATE,sub25100,defpa,Unlocking,0.2,MLPateGaussianMechanism,{'Optimal': 40},9087643,650021,64528,1054218,93383,28976,8033425,556638,35552,3245,3345,3408,555,587,1726,2690,2758,1682,poisson-block-composition-pa
2854,sp_workloads,1690805680,wl_small_mem,1557,ml:SGD-PATE-sub25100-defpa,4,ilp,block-composition-pa,poisson,ncd,ml:SGD-PATE,sub25100,defpa,Unlocking,0.4,MLNoisySGDMechanism,{'Optimal': 40},9619476,680600,63408,1862925,91919,22272,7756551,588681,41136,3443,3381,3350,771,472,1311,2672,2909,2039,poisson-block-composition-pa
2855,sp_workloads,1690805680,wl_small_mem,1557,ml:SGD-PATE-sub25100-defpa,4,ilp,block-composition-pa,poisson,ncd,ml:SGD-PATE,sub25100,defpa,Unlocking,0.4,MLPateGaussianMechanism,{'Optimal': 40},9087643,650021,64528,1063402,91977,28128,8024241,558044,36400,3245,3345,3408,543,590,1689,2702,2755,1719,poisson-block-composition-pa
2856,sp_workloads,1690805680,wl_small_mem,1558,ml:SGD-PATE-sub25100-defpa,4,ilp,block-composition-pa,poisson,equal-ncd,ml:SGD-PATE,sub25100,defpa,Unlocking,0.2,MLNoisySGDMechanism,{'Optimal': 40},3443,3381,3350,608,2015,3350,2835,1366,0,3443,3381,3350,608,2015,3350,2835,1366,0,poisson-block-composition-pa
2857,sp_workloads,1690805680,wl_small_mem,1558,ml:SGD-PATE-sub25100-defpa,4,ilp,block-composition-pa,poisson,equal-ncd,ml:SGD-PATE,sub25100,defpa,Unlocking,0.2,MLPateGaussianMechanism,{'Optimal': 40},3245,3345,3408,368,1847,3408,2877,1498,0,3245,3345,3408,368,1847,3408,2877,1498,0,poisson-block-composition-pa
2858,sp_workloads,1690805680,wl_small_mem,1559,ml:SGD-PATE-sub25100-defpa,4,ilp,block-composition-pa,poisson,equal-ncd,ml:SGD-PATE,sub25100,defpa,Unlocking,0.4,MLNoisySGDMechanism,{'Optimal': 40},3443,3381,3350,588,2024,3350,2855,1357,0,3443,3381,3350,588,2024,3350,2855,1357,0,poisson-block-composition-pa
2859,sp_workloads,1690805680,wl_small_mem,1559,ml:SGD-PATE-sub25100-defpa,4,ilp,block-composition-pa,poisson,equal-ncd,ml:SGD-PATE,sub25100,defpa,Unlocking,0.4,MLPateGaussianMechanism,{'Optimal': 40},3245,3345,3408,357,1846,3407,2888,1499,1,3245,3345,3408,357,1846,3407,2888,1499,1,poisson-block-composition-pa
